index,player,total_passes,total_completed,total_uncompleted,total_percentage%,f3_passes,f3_completed,f3_uncompleted,f3_percentage%,short_passes,short_completed,short_uncompleted,short_percentage%,long_passes,long_completed,long_uncompleted,long_percentage%,average_pass_length,crosses,crosses_completed,crosses_uncompleted,crosses_percentage%,total_shot_assists,total_goal_assists,dribbles,dribbles_completed,dribbles_f3,dribbles_f3_completed,fouls_won,team,MP,competition
0,Abdoul Karim Yoda,526,392.0,134,74.52471482889734,48,30,18,62.5,295,262,33,88.8135593220339,59,19,40,32.20338983050847,17.709534917397445,27,7,20,25.925925925925924,10,0,67,40,36,23,10,Getafe,18,Spain - La Liga
1,Abdoulaye Doucouré,577,482.0,95,83.53552859618716,48,31,17,64.58333333333334,378,351,27,92.85714285714286,41,21,20,51.21951219512195,17.36005746690967,3,2,1,66.66666666666666,9,2,18,10,2,1,8,Granada,15,Spain - La Liga
2,Abraham González Casanova,531,414.0,117,77.96610169491525,66,41,25,62.121212121212125,293,264,29,90.10238907849829,74,35,39,47.2972972972973,18.88360286264,12,1,11,8.333333333333332,15,1,6,2,2,1,9,Espanyol,20,Spain - La Liga
3,Adalberto Peñaranda Maestre,381,276.0,105,72.44094488188976,32,16,16,50.0,264,214,50,81.06060606060606,18,9,9,50.0,13.72778394888,17,3,14,17.647058823529413,12,3,66,40,37,20,41,Granada,23,Spain - La Liga
4,Aderllan Leandro de Jesus Santos,657,545.0,112,82.95281582952816,46,17,29,36.95652173913043,376,361,15,96.01063829787235,74,20,54,27.027027027027028,22.013345835746847,0,0,0,0.0,1,0,9,8,0,0,6,Valencia,17,Spain - La Liga
5,Adil Rami,1099,861.0,238,78.343949044586,166,73,93,43.97590361445783,563,537,26,95.38188277087033,204,88,116,43.13725490196079,24.144540646282657,6,0,6,0.0,4,1,5,3,3,1,19,Sevilla,28,Spain - La Liga
6,Adnane Tighadouini,146,88.0,58,60.273972602739725,14,8,6,57.14285714285714,84,63,21,75.0,22,9,13,40.909090909090914,17.127779499996162,9,4,5,44.44444444444444,5,0,34,16,17,7,6,Málaga,10,Spain - La Liga
7,Adriano Correia Claro,361,326.0,35,90.30470914127424,26,23,3,88.46153846153845,239,229,10,95.81589958158996,23,14,9,60.86956521739131,17.229726512181276,10,2,8,20.0,5,1,3,3,0,0,7,Barcelona,8,Spain - La Liga
8,Adrián Embarba Blázquez,761,480.0,281,63.074901445466494,46,24,22,52.17391304347826,410,339,71,82.68292682926828,118,34,84,28.8135593220339,17.025230150399686,93,23,70,24.731182795698924,24,4,70,30,32,13,35,Rayo Vallecano,28,Spain - La Liga
9,Adrián González Morales,1030,732.0,298,71.06796116504854,167,94,73,56.287425149700596,512,441,71,86.1328125,100,37,63,37.0,17.281175552041773,29,8,21,27.586206896551722,17,0,29,12,15,4,17,Eibar,32,Spain - La Liga
10,Adrián López Álvarez,345,229.0,116,66.3768115942029,31,15,16,48.38709677419355,206,168,38,81.55339805825243,11,6,5,54.54545454545454,13.490014271455305,10,5,5,50.0,13,4,24,9,10,5,12,Villarreal,16,Spain - La Liga
11,Adrián Marín Gómez,545,412.0,133,75.59633027522936,52,30,22,57.692307692307686,277,244,33,88.08664259927798,56,20,36,35.714285714285715,18.123017474860184,14,5,9,35.714285714285715,6,0,17,8,10,3,5,Villarreal,11,Spain - La Liga
12,Ager Aketxe Barrutia,95,70.0,25,73.68421052631578,12,9,3,75.0,52,47,5,90.38461538461539,15,7,8,46.666666666666664,16.01581880743579,5,0,5,0.0,1,0,2,1,1,1,3,Athletic Club,3,Spain - La Liga
13,Alberto De La Bella Madureño,808,599.0,209,74.13366336633663,84,53,31,63.095238095238095,362,320,42,88.39779005524862,97,31,66,31.958762886597935,18.26186072253193,38,8,30,21.052631578947366,8,0,10,5,7,4,16,Real Sociedad,15,Spain - La Liga
14,Alberto García Cabrera,206,102.0,104,49.51456310679612,43,8,35,18.6046511627907,49,48,1,97.95918367346938,137,35,102,25.547445255474454,49.08030286358447,0,0,0,0.0,0,0,0,0,0,0,1,Sporting Gijón,6,Spain - La Liga
15,Alberto Guitián Ceballos,28,17.0,11,60.71428571428571,5,1,4,20.0,3,3,0,100.0,8,3,5,37.5,27.05280711456857,0,0,0,0.0,0,0,1,1,0,0,0,Sporting Gijón,1,Spain - La Liga
16,Alberto Lopo García,342,262.0,80,76.60818713450293,48,16,32,33.33333333333333,171,165,6,96.49122807017544,58,15,43,25.862068965517242,24.87828205783579,0,0,0,0.0,1,0,1,1,0,0,6,RC Deportivo La Coruña,10,Spain - La Liga
17,Alberto Lora Ramos,1333,999.0,334,74.94373593398349,177,90,87,50.847457627118644,687,633,54,92.13973799126637,171,44,127,25.730994152046783,18.617105722112317,37,12,25,32.432432432432435,17,3,19,11,10,6,27,Sporting Gijón,31,Spain - La Liga
18,Alberto Mateus Contreiras Gonçalves,241,155.0,86,64.31535269709543,36,14,22,38.88888888888889,97,91,6,93.81443298969072,7,3,4,42.857142857142854,13.716783259863236,6,1,5,16.666666666666664,8,1,12,6,9,4,18,Rayo Vallecano,28,Spain - La Liga
19,Aleix Vidal Parreu,451,386.0,65,85.58758314855875,36,25,11,69.44444444444444,292,275,17,94.17808219178082,19,9,10,47.368421052631575,16.123091703161506,12,1,11,8.333333333333332,3,1,6,2,1,0,6,Barcelona,9,Spain - La Liga
20,Alejandro Arribas Garrido,1144,841.0,303,73.51398601398601,148,49,99,33.108108108108105,528,498,30,94.31818181818183,196,48,148,24.489795918367346,23.136669260733775,1,0,1,0.0,4,0,12,7,1,0,36,RC Deportivo La Coruña,31,Spain - La Liga
21,Alejandro Barrera García,35,24.0,11,68.57142857142857,3,2,1,66.66666666666666,19,16,3,84.21052631578947,1,0,1,0.0,14.288836544516572,0,0,0,0.0,0,0,1,1,1,1,0,Sporting Gijón,5,Spain - La Liga
22,Alejandro Bergantiños García,876,687.0,189,78.42465753424658,153,97,56,63.39869281045751,481,439,42,91.26819126819127,66,33,33,50.0,16.958876743136713,2,0,2,0.0,20,0,10,7,3,3,11,RC Deportivo La Coruña,22,Spain - La Liga
23,Alejandro Menéndez Díez,392,239.0,153,60.96938775510205,43,16,27,37.2093023255814,179,147,32,82.12290502793296,80,15,65,18.75,20.335262222382244,32,7,25,21.875,12,1,31,15,17,6,5,Sporting Gijón,21,Spain - La Liga
24,Aleksandar Pantić,530,338.0,192,63.77358490566037,82,28,54,34.146341463414636,186,163,23,87.63440860215054,107,30,77,28.037383177570092,23.113933218224147,0,0,0,0.0,1,0,3,2,1,1,1,Eibar,20,Spain - La Liga
25,Alen Halilović,885,673.0,212,76.045197740113,134,99,35,73.88059701492537,559,469,90,83.89982110912342,116,66,50,56.896551724137936,18.1921612291021,34,16,18,47.05882352941176,23,5,131,71,63,28,59,Sporting Gijón,36,Spain - La Liga
26,Alexis Ruano Delgado,550,435.0,115,79.0909090909091,63,26,37,41.269841269841265,278,264,14,94.96402877697841,111,52,59,46.846846846846844,23.797333871217162,2,0,2,0.0,6,0,8,5,1,0,8,Getafe,15,Spain - La Liga
27,Alfonso Pedraza Sag,23,14.0,9,60.86956521739131,0,0,0,0.0,13,10,3,76.92307692307693,1,0,1,0.0,13.076439669422609,1,0,1,0.0,1,0,5,3,3,1,1,Villarreal,2,Spain - La Liga
28,Alfred John Momar N''Diaye,1190,945.0,245,79.41176470588235,123,71,52,57.72357723577236,727,663,64,91.19669876203577,88,37,51,42.04545454545455,17.866563164098487,8,2,6,25.0,3,0,45,26,7,2,34,Real Betis,34,Spain - La Liga
29,Alhassane Bangoura,313,201.0,112,64.21725239616613,17,11,6,64.70588235294117,183,143,40,78.14207650273224,30,9,21,30.0,15.64036673774032,50,13,37,26.0,14,1,63,31,36,17,14,Rayo Vallecano,16,Spain - La Liga
30,Alphonse Areola,861,481.0,380,55.86527293844367,86,22,64,25.581395348837212,179,178,1,99.4413407821229,591,220,371,37.22504230118444,46.5510002331763,0,0,0,0.0,0,0,1,1,0,0,8,Villarreal,32,Spain - La Liga
31,Anaitz Arbilla Zabala,421,329.0,92,78.14726840855107,57,30,27,52.63157894736842,231,200,31,86.58008658008657,52,23,29,44.230769230769226,17.848532746129596,7,2,5,28.57142857142857,7,0,10,6,2,1,8,Espanyol,7,Spain - La Liga
32,Ander Capa Rodríguez,1818,1137.0,681,62.541254125412536,337,149,188,44.21364985163205,690,561,129,81.30434782608695,352,99,253,28.125,19.96805353311295,77,21,56,27.27272727272727,16,4,59,34,27,17,32,Eibar,36,Spain - La Liga
33,Ander Gayoso Reina,6,4.0,2,66.66666666666666,1,0,1,0.0,2,2,0,100.0,2,0,2,0.0,24.9620618868,0,0,0,0.0,0,0,0,0,0,0,1,Eibar,1,Spain - La Liga
34,Ander Iturraspe Derteano,417,333.0,84,79.85611510791367,65,37,28,56.92307692307692,216,207,9,95.83333333333334,51,23,28,45.09803921568628,18.379620642241726,6,2,4,33.33333333333333,3,1,5,2,1,0,8,Athletic Club,16,Spain - La Liga
35,Andreu Fontàs Prat,468,418.0,50,89.31623931623932,57,38,19,66.66666666666666,316,305,11,96.51898734177216,42,15,27,35.714285714285715,20.274274586673847,0,0,0,0.0,3,0,0,0,0,0,2,Celta Vigo,7,Spain - La Liga
36,André Filipe Tavares Gomes,1342,1081.0,261,80.55141579731743,211,138,73,65.40284360189574,901,789,112,87.56936736958934,99,59,40,59.59595959595959,17.213626403933045,21,8,13,38.095238095238095,23,3,113,69,51,25,55,Valencia,30,Spain - La Liga
37,Andrés Eduardo Fernández Moreno,1136,644.0,492,56.690140845070424,133,30,103,22.55639097744361,251,248,3,98.80478087649402,784,304,480,38.775510204081634,45.70360547246936,0,0,0,0.0,2,0,2,1,0,0,9,Granada,37,Spain - La Liga
38,Andrés Iniesta Luján,1877,1641.0,236,87.42674480554075,297,252,45,84.84848484848484,1278,1195,83,93.5054773082942,172,118,54,68.6046511627907,18.267553767012338,25,7,18,28.000000000000004,31,2,80,54,28,14,54,Barcelona,28,Spain - La Liga
39,Andrés Pascual Santoja,6,5.0,1,83.33333333333334,0,0,0,0.0,5,4,1,80.0,0,0,0,0.0,10.412326216199999,0,0,0,0.0,0,0,2,1,0,0,2,Valencia,1,Spain - La Liga
40,Antoine Griezmann,1394,1093.0,301,78.40746054519369,150,104,46,69.33333333333334,906,776,130,85.65121412803532,68,44,24,64.70588235294117,14.162523141329096,37,15,22,40.54054054054054,49,5,82,46,37,17,45,Atlético Madrid,38,Spain - La Liga
41,Antolín Alcáraz Viveros,262,188.0,74,71.7557251908397,36,10,26,27.77777777777778,117,111,6,94.87179487179486,50,15,35,30.0,21.969212951511754,3,1,2,33.33333333333333,2,0,2,2,0,0,3,Las Palmas,6,Spain - La Liga
42,Antonio Adán Garrido,1144,496.0,648,43.35664335664335,239,52,187,21.75732217573222,157,157,0,100.0,888,256,632,28.82882882882883,50.868717983714895,0,0,0,0.0,2,0,1,1,0,0,3,Real Betis,36,Spain - La Liga
43,Antonio Amaya Carazo,515,389.0,126,75.53398058252428,44,15,29,34.090909090909086,267,249,18,93.25842696629213,68,26,42,38.23529411764706,21.138886535950135,1,0,1,0.0,0,0,6,5,0,0,6,Rayo Vallecano,17,Spain - La Liga
44,Antonio Barragán Fernández,1031,800.0,231,77.59456838021337,116,76,40,65.51724137931035,508,464,44,91.33858267716536,99,33,66,33.33333333333333,18.058323016513743,41,8,33,19.51219512195122,8,0,24,10,9,2,23,Valencia,24,Spain - La Liga
45,Antonio García Aranda,1356,981.0,375,72.34513274336283,145,72,73,49.6551724137931,582,507,75,87.11340206185567,172,60,112,34.883720930232556,17.529912968014777,92,20,72,21.73913043478261,21,2,63,35,27,15,46,Levante UD,27,Spain - La Liga
46,Antonio Jesús Cotán Pérez,50,42.0,8,84.0,5,2,3,40.0,30,28,2,93.33333333333333,9,5,4,55.55555555555556,23.268398982235198,0,0,0,0.0,1,0,3,2,0,0,2,Sevilla,1,Spain - La Liga
47,Antonio José Raillo Arenas,113,86.0,27,76.10619469026548,10,3,7,30.0,59,57,2,96.61016949152543,12,4,8,33.33333333333333,21.389981752353982,0,0,0,0.0,1,0,0,0,0,0,3,Espanyol,4,Spain - La Liga
48,Antonio Manuel Luna Rodríguez,524,374.0,150,71.37404580152672,72,41,31,56.94444444444444,223,190,33,85.20179372197309,64,29,35,45.3125,18.906744708252823,21,6,15,28.57142857142857,4,1,11,8,2,1,8,Eibar,15,Spain - La Liga
49,Antonio Rodríguez Martínez,331,242.0,89,73.1117824773414,27,10,17,37.03703703703704,110,107,3,97.27272727272728,149,68,81,45.63758389261745,37.52988028716834,0,0,0,0.0,0,0,0,0,0,0,3,Rayo Vallecano,10,Spain - La Liga
50,Antonio Rukavina,645,501.0,144,77.67441860465117,59,32,27,54.23728813559322,317,285,32,89.90536277602523,67,24,43,35.82089552238806,17.559027020413506,12,0,12,0.0,3,0,10,5,5,1,7,Villarreal,18,Spain - La Liga
51,António Alberto Bastos Pimparel,121,87.0,34,71.900826446281,11,3,8,27.27272727272727,38,38,0,100.0,65,31,34,47.69230769230769,41.379910434059504,0,0,0,0.0,0,0,0,0,0,0,2,Sevilla,4,Spain - La Liga
52,Aras Özbiliz,35,20.0,15,57.14285714285714,4,2,2,50.0,19,17,2,89.47368421052632,7,0,7,0.0,18.880693422397712,4,1,3,25.0,2,1,2,1,2,1,2,Rayo Vallecano,3,Spain - La Liga
53,Arda Turan,624,573.0,51,91.82692307692307,53,45,8,84.90566037735849,481,459,22,95.42619542619542,19,16,3,84.21052631578947,13.897887521523462,7,4,3,57.14285714285714,6,3,29,22,11,6,21,Barcelona,18,Spain - La Liga
54,Aritz Aduriz Zubeldia,759,476.0,283,62.71409749670619,113,50,63,44.24778761061947,377,292,85,77.45358090185677,15,5,10,33.33333333333333,13.484222660830671,18,6,12,33.33333333333333,26,6,64,25,47,17,69,Athletic Club,34,Spain - La Liga
55,Aritz Elustondo Irribaria,1469,1103.0,366,75.08509189925118,166,84,82,50.602409638554214,727,679,48,93.39752407152683,163,49,114,30.061349693251532,18.713531592207325,57,16,41,28.07017543859649,12,0,38,20,16,7,30,Real Sociedad,31,Spain - La Liga
56,Armindo Tué Na Bangna,679,513.0,166,75.55228276877762,38,18,20,47.368421052631575,519,441,78,84.97109826589595,30,8,22,26.666666666666668,13.678996067668098,52,17,35,32.69230769230769,22,1,99,63,68,44,27,Real Sociedad,32,Spain - La Liga
57,Arnaldo Antonio Sanabria Ayala,624,453.0,171,72.59615384615384,68,23,45,33.82352941176471,402,336,66,83.5820895522388,18,7,11,38.88888888888889,13.932557526087693,10,3,7,30.0,12,1,55,28,24,11,43,Sporting Gijón,29,Spain - La Liga
58,Arthur Etienne Boka,666,505.0,161,75.82582582582582,92,51,41,55.434782608695656,302,262,40,86.75496688741721,67,26,41,38.80597014925373,17.028340089707026,22,5,17,22.727272727272727,5,0,29,13,14,4,19,Málaga,14,Spain - La Liga
59,Asier Illarramendi Andonegi,1838,1444.0,394,78.56365614798693,278,182,96,65.46762589928058,1101,1021,80,92.7338782924614,220,106,114,48.18181818181818,19.185864277953428,29,6,23,20.689655172413794,27,1,40,29,15,12,71,Real Sociedad,33,Spain - La Liga
60,Asier Riesgo Unamuno,1066,506.0,560,47.467166979362105,188,59,129,31.382978723404253,70,69,1,98.57142857142858,910,361,549,39.67032967032967,52.42591567830056,0,0,0,0.0,1,0,0,0,0,0,10,Eibar,34,Spain - La Liga
61,Augusto Matías Fernández,1480,1305.0,175,88.17567567567568,141,95,46,67.37588652482269,1102,1036,66,94.01088929219601,78,38,40,48.717948717948715,17.580956814709783,3,2,1,66.66666666666666,6,1,32,22,4,4,27,Atlético Madrid,28,Spain - La Liga
62,Aymen Abdennour,894,736.0,158,82.32662192393735,61,26,35,42.62295081967213,526,508,18,96.57794676806084,112,39,73,34.82142857142857,21.60708707528295,0,0,0,0.0,3,0,11,11,0,0,14,Valencia,22,Spain - La Liga
63,Aymeric Laporte,1337,1093.0,244,81.75018698578907,169,93,76,55.02958579881657,718,682,36,94.98607242339833,195,89,106,45.64102564102564,22.472465025535378,7,1,6,14.285714285714285,5,1,19,11,1,0,27,Athletic Club,26,Spain - La Liga
64,Aythami Artiles Oliva,1616,1344.0,272,83.16831683168317,135,72,63,53.333333333333336,928,897,31,96.65948275862068,204,83,121,40.68627450980392,21.64411006732292,1,1,0,100.0,4,1,6,3,2,1,17,Las Palmas,31,Spain - La Liga
65,Benoît Trémoulinas,1185,867.0,318,73.16455696202532,139,76,63,54.67625899280576,563,503,60,89.34280639431617,149,50,99,33.557046979865774,18.309409441097014,78,20,58,25.64102564102564,16,3,31,13,18,6,30,Sevilla,24,Spain - La Liga
66,Bernard Mensah,42,38.0,4,90.47619047619048,7,5,2,71.42857142857143,28,26,2,92.85714285714286,3,2,1,66.66666666666666,19.057616124685712,1,0,1,0.0,0,0,6,4,2,2,2,Getafe,8,Spain - La Liga
67,Bernardo José Espinosa Zúñiga,558,396.0,162,70.96774193548387,68,24,44,35.294117647058826,218,208,10,95.41284403669725,120,40,80,33.33333333333333,23.34010567641032,0,0,0,0.0,4,0,1,1,0,0,12,Sporting Gijón,16,Spain - La Liga
68,Beñat Etxebarria Urkiaga,2157,1628.0,529,75.47519703291609,394,252,142,63.95939086294417,1147,1056,91,92.0662598081953,470,206,264,43.829787234042556,21.60777911606587,60,15,45,25.0,59,4,47,27,12,8,69,Athletic Club,36,Spain - La Liga
69,Bojan Jokić,67,49.0,18,73.13432835820896,16,7,9,43.75,32,30,2,93.75,12,2,10,16.666666666666664,20.435621133460298,2,0,2,0.0,0,0,0,0,0,0,1,Villarreal,2,Spain - La Liga
70,Borja Ekiza Imaz,98,52.0,46,53.06122448979592,20,8,12,40.0,21,15,6,71.42857142857143,15,4,11,26.666666666666668,20.118283733431838,3,0,3,0.0,0,0,1,1,0,0,1,Eibar,4,Spain - La Liga
71,Borja Fernández Fernández,62,46.0,16,74.19354838709677,5,1,4,20.0,30,29,1,96.66666666666667,8,2,6,25.0,19.445995003726452,0,0,0,0.0,1,0,2,1,1,0,0,Celta Vigo,4,Spain - La Liga
72,Borja González Tomás,647,449.0,198,69.39721792890263,58,23,35,39.6551724137931,393,326,67,82.95165394402035,14,6,8,42.857142857142854,12.815917423987328,14,3,11,21.428571428571427,16,3,26,15,12,4,35,Eibar,36,Spain - La Liga
73,Borja Mayoral Moya,84,68.0,16,80.95238095238095,3,3,0,100.0,71,61,10,85.91549295774648,0,0,0,0.0,10.765776219411428,3,1,2,33.33333333333333,1,0,8,6,5,3,3,Real Madrid,6,Spain - La Liga
74,Borja Viguera Manzanares,95,68.0,27,71.57894736842105,10,5,5,50.0,46,41,5,89.13043478260869,3,2,1,66.66666666666666,13.90702537317221,4,0,4,0.0,2,0,8,3,8,3,4,Athletic Club,9,Spain - La Liga
75,Bruno González Cabrera,1070,847.0,223,79.1588785046729,79,25,54,31.645569620253166,544,524,20,96.32352941176471,132,33,99,25.0,22.686013490719628,0,0,0,0.0,0,0,15,12,3,3,15,Real Betis,32,Spain - La Liga
76,Bruno Soriano Llido,1728,1455.0,273,84.20138888888889,259,176,83,67.95366795366795,1146,1064,82,92.84467713787086,107,57,50,53.271028037383175,18.177941439690418,5,2,3,40.0,13,1,27,20,6,4,25,Villarreal,31,Spain - La Liga
77,Carl Medjani,511,393.0,118,76.90802348336595,80,30,50,37.5,267,251,16,94.00749063670412,96,36,60,37.5,23.88364053336,1,0,1,0.0,3,0,3,2,0,0,8,Levante UD,14,Spain - La Liga
78,Carles Planas Antolínez,1157,895.0,262,77.35522904062229,142,87,55,61.267605633802816,625,585,40,93.60000000000001,130,35,95,26.923076923076923,18.73607906927668,28,7,21,25.0,6,2,8,5,4,2,10,Celta Vigo,24,Spain - La Liga
79,Carlos Alberto Vela Garrido,1174,862.0,312,73.42419080068143,130,78,52,60.0,715,618,97,86.43356643356643,144,56,88,38.88888888888889,16.935289842346712,71,20,51,28.169014084507044,48,4,121,59,60,29,98,Real Sociedad,35,Spain - La Liga
80,Carlos Carbonell Gil,2,1.0,1,50.0,0,0,0,0.0,1,1,0,100.0,0,0,0,0.0,13.238834533199999,0,0,0,0.0,0,0,1,0,0,0,0,Valencia,1,Spain - La Liga
81,Carlos Carmona Bonet,576,394.0,182,68.40277777777779,82,41,41,50.0,344,286,58,83.13953488372093,53,18,35,33.9622641509434,16.228964023941252,38,10,28,26.31578947368421,19,3,42,20,15,8,21,Sporting Gijón,20,Spain - La Liga
82,Carlos Castro García,203,159.0,44,78.32512315270937,12,5,7,41.66666666666667,151,129,22,85.43046357615894,4,1,3,25.0,11.517509734478425,2,1,1,50.0,4,0,22,10,10,4,24,Sporting Gijón,25,Spain - La Liga
83,Carlos Fernández Luna,9,8.0,1,88.88888888888889,1,0,1,0.0,7,7,0,100.0,0,0,0,0.0,10.061903828399998,0,0,0,0.0,1,0,0,0,0,0,1,Sevilla,1,Spain - La Liga
84,Carlos Gurpegi Nausia,544,433.0,111,79.59558823529412,57,25,32,43.859649122807014,260,252,8,96.92307692307692,70,21,49,30.0,21.13693125618375,3,1,2,33.33333333333333,2,0,2,2,0,0,12,Athletic Club,15,Spain - La Liga
85,Carlos Henrique Casimiro,1056,917.0,139,86.83712121212122,137,89,48,64.96350364963503,646,614,32,95.04643962848297,147,99,48,67.3469387755102,20.533804773627274,2,1,1,50.0,5,2,12,9,4,3,44,Real Madrid,23,Spain - La Liga
86,Carlos Martín Vigaray,507,383.0,124,75.54240631163708,72,39,33,54.166666666666664,243,220,23,90.53497942386831,64,21,43,32.8125,18.760102675856096,14,2,12,14.285714285714285,7,0,23,12,8,2,10,Getafe,14,Spain - La Liga
87,Carlos Martínez Díez,353,274.0,79,77.62039660056658,39,25,14,64.1025641025641,182,168,14,92.3076923076923,36,14,22,38.88888888888889,17.00852456076782,17,5,12,29.411764705882355,5,1,12,8,5,2,7,Real Sociedad,9,Spain - La Liga
88,Celso Borges Mora,972,787.0,185,80.96707818930041,148,90,58,60.810810810810814,532,499,33,93.796992481203,76,39,37,51.31578947368421,16.50577478855185,6,2,4,33.33333333333333,19,2,18,15,6,6,21,RC Deportivo La Coruña,24,Spain - La Liga
89,Charles Días Barbosa de Oliveira,873,620.0,253,71.01947308132875,86,37,49,43.02325581395349,458,401,57,87.55458515283843,25,12,13,48.0,13.075951851809483,17,5,12,29.411764705882355,31,3,26,15,17,9,50,Málaga,35,Spain - La Liga
90,Charly Musonda Junior,394,284.0,110,72.08121827411168,38,24,14,63.1578947368421,263,220,43,83.65019011406845,38,10,28,26.31578947368421,15.76206030280203,31,5,26,16.129032258064516,11,1,90,52,51,33,57,Real Betis,16,Spain - La Liga
91,Chengdong Zhang,3,2.0,1,66.66666666666666,0,0,0,0.0,0,0,0,0.0,0,0,0,0.0,19.694260941599996,1,0,1,0.0,0,0,0,0,0,0,0,Rayo Vallecano,1,Spain - La Liga
92,Christian Atsu Twasam,143,112.0,31,78.32167832167832,12,9,3,75.0,107,89,18,83.17757009345794,9,6,3,66.66666666666666,14.119911507363357,9,2,7,22.22222222222222,6,0,23,13,16,9,10,Málaga,11,Spain - La Liga
93,Ciro Immobile,63,41.0,22,65.07936507936508,4,1,3,25.0,42,31,11,73.80952380952381,3,2,1,66.66666666666666,13.692514493794285,6,0,6,0.0,1,0,5,2,2,0,5,Sevilla,8,Spain - La Liga
94,Claudio Andrés Bravo Muñoz,1004,848.0,156,84.4621513944223,38,10,28,26.31578947368421,573,570,3,99.47643979057592,247,107,140,43.31983805668016,28.53604019417307,0,0,0,0.0,0,0,1,1,0,0,1,Barcelona,32,Spain - La Liga
95,Claudio Beauvue,134,85.0,49,63.43283582089553,17,8,9,47.05882352941176,70,55,15,78.57142857142857,12,4,8,33.33333333333333,15.588869741376717,11,3,8,27.27272727272727,5,0,17,10,7,4,7,Celta Vigo,10,Spain - La Liga
96,Claudio Matías Kranevitter,133,100.0,33,75.18796992481202,13,6,7,46.15384615384615,80,70,10,87.5,14,4,10,28.57142857142857,19.095339896753686,1,0,1,0.0,0,0,3,3,0,0,3,Atlético Madrid,8,Spain - La Liga
97,Cristiano Biraghi,1372,939.0,433,68.4402332361516,179,83,96,46.36871508379888,483,429,54,88.81987577639751,242,85,157,35.12396694214876,20.136680495046996,67,16,51,23.88059701492537,15,1,24,12,16,8,16,Granada,32,Spain - La Liga
98,Cristiano Piccini,843,641.0,202,76.0379596678529,104,58,46,55.769230769230774,415,365,50,87.95180722891565,69,23,46,33.33333333333333,16.55772552094292,34,13,21,38.23529411764706,13,0,49,26,29,14,13,Real Betis,16,Spain - La Liga
99,Cristiano Ronaldo dos Santos Aveiro,1146,878.0,268,76.61431064572426,82,55,27,67.07317073170732,881,740,141,83.99545970488082,28,12,16,42.857142857142854,12.818792624585088,58,21,37,36.206896551724135,34,10,95,54,69,36,48,Real Madrid,36,Spain - La Liga
100,Cédric Bakambu,515,367.0,148,71.26213592233009,36,20,16,55.55555555555556,337,270,67,80.1186943620178,15,4,11,26.666666666666668,12.971806578212785,23,5,18,21.73913043478261,13,3,44,25,14,9,36,Villarreal,34,Spain - La Liga
101,Damián Nicolás Suárez Suárez,1684,1279.0,405,75.95011876484561,293,182,111,62.116040955631405,755,663,92,87.81456953642383,215,88,127,40.93023255813954,18.335962258633455,37,13,24,35.13513513513514,25,3,51,19,20,7,35,Getafe,31,Spain - La Liga
102,Dani Castellano Betancor,1383,1110.0,273,80.26030368763557,130,81,49,62.30769230769231,803,733,70,91.2826899128269,81,37,44,45.67901234567901,15.884379237521387,26,7,19,26.923076923076923,11,0,58,40,18,7,50,Las Palmas,27,Spain - La Liga
103,Daniel Alves da Silva,1971,1682.0,289,85.33739218670725,172,143,29,83.13953488372093,1211,1129,82,93.22873658133773,169,111,58,65.68047337278107,15.736490976865387,86,26,60,30.23255813953488,18,4,51,26,18,5,24,Barcelona,29,Spain - La Liga
104,Daniel Arnaud N''Di	,227,153.0,74,67.40088105726872,35,17,18,48.57142857142857,152,133,19,87.5,14,2,12,14.285714285714285,15.409988057145727,12,1,11,8.333333333333332,7,0,26,17,9,6,42,Sporting Gijón,15,Spain - La Liga
105,Daniel Carvajal Ramos,1228,1065.0,163,86.72638436482086,82,67,15,81.70731707317073,798,752,46,94.23558897243107,84,48,36,57.14285714285714,16.221732270769643,58,30,28,51.724137931034484,28,4,43,21,23,9,29,Real Madrid,22,Spain - La Liga
106,Daniel Ceballos Fernández,1245,995.0,250,79.91967871485943,191,136,55,71.20418848167539,844,746,98,88.38862559241706,81,46,35,56.79012345679012,15.850156692742555,16,7,9,43.75,21,2,108,59,49,24,96,Real Betis,34,Spain - La Liga
107,Daniel Filipe Martins Carriço,499,408.0,91,81.76352705410822,43,20,23,46.51162790697674,290,280,10,96.55172413793103,67,29,38,43.28358208955223,21.861224284608575,1,0,1,0.0,0,1,5,3,1,1,9,Sevilla,14,Spain - La Liga
108,Daniel García Carrillo,1761,1323.0,438,75.12776831345826,343,181,162,52.76967930029155,756,685,71,90.60846560846561,314,145,169,46.17834394904459,22.573425446368518,11,3,8,27.27272727272727,14,0,29,18,2,0,50,Eibar,35,Spain - La Liga
109,Daniel Giménez Hernández,86,47.0,39,54.65116279069767,16,6,10,37.5,18,18,0,100.0,55,16,39,29.09090909090909,47.11689770533953,0,0,0,0.0,0,0,0,0,0,0,0,Real Betis,3,Spain - La Liga
110,Daniel Parejo Muñoz,1885,1537.0,348,81.53846153846153,261,194,67,74.32950191570882,1188,1088,100,91.58249158249158,225,113,112,50.22222222222222,19.148564164874685,31,14,17,45.16129032258064,35,5,63,36,13,4,91,Valencia,33,Spain - La Liga
111,Daniel Wass,1665,1300.0,365,78.07807807807808,263,173,90,65.77946768060836,1049,946,103,90.1811248808389,189,82,107,43.386243386243386,19.04695132735308,32,9,23,28.125,34,5,34,22,16,9,47,Celta Vigo,36,Spain - La Liga
112,Daniele Bonera,504,432.0,72,85.71428571428571,62,33,29,53.2258064516129,289,280,9,96.88581314878893,67,31,36,46.26865671641791,23.207565019335714,0,0,0,0.0,1,0,1,1,0,0,7,Villarreal,14,Spain - La Liga
113,Danilo Barbosa da Silva,502,377.0,125,75.0996015936255,72,41,31,56.94444444444444,311,268,43,86.17363344051448,37,21,16,56.75675675675676,17.81730241227251,1,0,1,0.0,7,0,44,26,18,9,48,Valencia,19,Spain - La Liga
114,Danilo Luiz da Silva,1491,1260.0,231,84.50704225352112,130,89,41,68.46153846153847,969,902,67,93.08565531475749,102,34,68,33.33333333333333,16.588913451867523,57,15,42,26.31578947368421,12,5,24,16,14,7,24,Real Madrid,24,Spain - La Liga
115,David Barral Torres,110,87.0,23,79.0909090909091,6,4,2,66.66666666666666,60,56,4,93.33333333333333,6,2,4,33.33333333333333,14.234331906091636,7,0,7,0.0,2,0,7,3,4,2,13,Granada,14,Spain - La Liga
116,David Carmona Sierra,36,20.0,16,55.55555555555556,4,2,2,50.0,18,12,6,66.66666666666666,6,0,6,0.0,21.0153729806,2,0,2,0.0,0,0,1,0,0,0,0,Sevilla,1,Spain - La Liga
117,David García Santana,981,781.0,200,79.61264016309887,101,48,53,47.524752475247524,516,479,37,92.82945736434108,111,35,76,31.53153153153153,19.86201949192881,8,5,3,62.5,7,1,6,3,0,0,17,Las Palmas,19,Spain - La Liga
118,David Goldar Gómez,30,12.0,18,40.0,9,1,8,11.11111111111111,7,7,0,100.0,13,3,10,23.076923076923077,32.14694358,0,0,0,0.0,0,0,0,0,0,0,2,Celta Vigo,1,Spain - La Liga
119,David Juncà Reñé,1281,859.0,422,67.05698672911787,224,104,120,46.42857142857143,513,432,81,84.21052631578947,211,64,147,30.33175355450237,20.521630876798877,73,22,51,30.136986301369863,16,4,44,24,20,8,37,Eibar,31,Spain - La Liga
120,David Navarro Pedrós,681,550.0,131,80.76358296622614,96,47,49,48.95833333333333,337,332,5,98.51632047477746,116,45,71,38.793103448275865,23.290595141668017,0,0,0,0.0,0,0,7,5,0,0,10,Levante UD,20,Spain - La Liga
121,David Rodríguez Lombán,983,774.0,209,78.73855544252288,109,45,64,41.284403669724774,436,417,19,95.64220183486239,198,89,109,44.94949494949495,24.78869973959658,3,0,3,0.0,2,0,3,3,0,0,9,Granada,30,Spain - La Liga
122,David Simón Rodríguez Santana,1411,1107.0,304,78.4549964564139,111,67,44,60.36036036036037,781,703,78,90.01280409731113,104,45,59,43.269230769230774,16.051941661799912,48,15,33,31.25,19,2,46,20,25,8,25,Las Palmas,27,Spain - La Liga
123,David Zurutuza Veillet,583,451.0,132,77.35849056603774,72,48,24,66.66666666666666,361,325,36,90.02770083102493,36,13,23,36.11111111111111,14.904162622382572,18,5,13,27.77777777777778,10,3,43,22,22,12,37,Real Sociedad,16,Spain - La Liga
124,Dejan Dražić,25,20.0,5,80.0,2,1,1,50.0,19,18,1,94.73684210526315,2,1,1,50.0,11.640498665615999,0,0,0,0.0,0,0,6,3,4,1,1,Celta Vigo,6,Spain - La Liga
125,Denis Cheryshev,232,158.0,74,68.10344827586206,26,15,11,57.692307692307686,148,123,25,83.1081081081081,12,2,10,16.666666666666664,15.443415438464482,10,2,8,20.0,3,1,19,11,7,4,15,Valencia,9,Spain - La Liga
126,Denis Suárez Fernández,1114,756.0,358,67.86355475763017,120,67,53,55.833333333333336,692,556,136,80.34682080924856,116,44,72,37.93103448275862,16.992172460104417,60,19,41,31.666666666666664,41,4,101,50,63,31,48,Villarreal,33,Spain - La Liga
127,Deyverson Brum Silva Acosta,640,360.0,280,56.25,106,29,77,27.358490566037734,231,187,44,80.95238095238095,36,12,24,33.33333333333333,14.5324157508711,20,7,13,35.0,20,1,43,17,21,7,76,Levante UD,33,Spain - La Liga
128,Didier Digard,165,123.0,42,74.54545454545455,31,9,22,29.03225806451613,93,84,9,90.32258064516128,21,4,17,19.047619047619047,20.07878368976727,0,0,0,0.0,0,0,5,2,0,0,5,Real Betis,8,Spain - La Liga
129,Diego Alende López,6,6.0,0,100.0,0,0,0,0.0,6,6,0,100.0,0,0,0,0.0,16.9418634492,0,0,0,0.0,0,0,0,0,0,0,0,Celta Vigo,1,Spain - La Liga
130,Diego Alves Carreira,400,261.0,139,65.25,32,8,24,25.0,98,98,0,100.0,257,123,134,47.85992217898833,42.933073263298205,0,0,0,0.0,0,0,1,1,0,0,0,Valencia,13,Spain - La Liga
131,Diego Antonio Reyes Rosales,1079,885.0,194,82.02038924930491,111,67,44,60.36036036036037,586,561,25,95.73378839590444,132,67,65,50.75757575757576,21.72805074569327,5,4,1,80.0,5,0,18,15,2,1,16,Real Sociedad,27,Spain - La Liga
132,Diego González Polanco,48,43.0,5,89.58333333333334,4,2,2,50.0,31,31,0,100.0,6,2,4,33.33333333333333,22.3999239072,0,0,0,0.0,0,0,0,0,0,0,1,Sevilla,2,Spain - La Liga
133,Diego Javier Llorente Ríos,1474,1206.0,268,81.81818181818183,173,98,75,56.64739884393064,846,795,51,93.97163120567376,170,70,100,41.17647058823529,21.05380733130464,6,2,4,33.33333333333333,7,1,40,29,4,3,34,Rayo Vallecano,33,Spain - La Liga
134,Diego Mainz García,132,104.0,28,78.78787878787878,18,6,12,33.33333333333333,66,65,1,98.48484848484848,23,6,17,26.08695652173913,22.848550674987273,0,0,0,0.0,0,0,0,0,0,0,5,Granada,5,Spain - La Liga
135,Diego Mariño Villar,829,580.0,249,69.96381182147165,60,24,36,40.0,262,261,1,99.61832061068702,451,212,239,47.006651884700666,40.4597444143171,0,0,0,0.0,2,0,1,1,0,0,6,Levante UD,23,Spain - La Liga
136,Diego Roberto Godín Leal,1152,912.0,240,79.16666666666666,113,52,61,46.017699115044245,629,603,26,95.86645468998411,142,54,88,38.028169014084504,20.46326195582375,0,0,0,0.0,2,1,14,9,1,0,33,Atlético Madrid,31,Spain - La Liga
137,Dimitri Foulquier,698,534.0,164,76.50429799426934,76,44,32,57.89473684210527,320,280,40,87.5,43,13,30,30.23255813953488,15.657837455562293,20,7,13,35.0,10,1,41,19,23,8,11,Granada,21,Spain - La Liga
138,Diogo José Rosário Gomes Figueiras,130,91.0,39,70.0,10,5,5,50.0,63,53,10,84.12698412698413,18,8,10,44.44444444444444,16.909182875730462,11,4,7,36.36363636363637,3,0,7,5,3,3,6,Sevilla,4,Spain - La Liga
139,Douglas Pereira dos Santos,3,2.0,1,66.66666666666666,0,0,0,0.0,2,1,1,50.0,0,0,0,0.0,11.7992150604,0,0,0,0.0,0,0,0,0,0,0,1,Barcelona,1,Spain - La Liga
140,Duje Čop,690,467.0,223,67.68115942028986,62,24,38,38.70967741935484,400,310,90,77.5,34,15,19,44.11764705882353,12.733470777996521,24,10,14,41.66666666666667,15,3,48,16,24,7,24,Málaga,31,Spain - La Liga
141,Eddy Silvestre Pascual İsrafilov,79,54.0,25,68.35443037974683,13,5,8,38.46153846153847,41,34,7,82.92682926829268,3,1,2,33.33333333333333,16.909001958832405,0,0,0,0.0,1,0,0,0,0,0,7,Eibar,6,Spain - La Liga
142,Edgar Antonio Méndez Ortega,236,151.0,85,63.983050847457626,30,12,18,40.0,115,98,17,85.21739130434783,35,8,27,22.857142857142858,18.666493820487457,20,5,15,25.0,5,0,15,7,10,4,13,Granada,15,Spain - La Liga
143,Egor Filipenko,179,132.0,47,73.74301675977654,29,16,13,55.172413793103445,87,76,11,87.35632183908046,29,12,17,41.37931034482759,21.109004038606926,0,0,0,0.0,0,0,0,0,0,0,5,Málaga,8,Spain - La Liga
144,Emiliano Buendía,366,302.0,64,82.5136612021858,44,32,12,72.72727272727273,235,211,24,89.7872340425532,24,12,12,50.0,16.882751139554756,7,2,5,28.57142857142857,5,0,18,9,6,4,20,Getafe,17,Spain - La Liga
145,Emiliano Daniel Velázquez Maldonado,384,254.0,130,66.14583333333334,74,24,50,32.432432432432435,165,156,9,94.54545454545455,94,23,71,24.46808510638298,24.691005712108126,1,1,0,100.0,3,1,9,6,1,0,3,Getafe,11,Spain - La Liga
146,Eneko Bóveda Altube,956,725.0,231,75.83682008368201,129,65,64,50.3875968992248,492,464,28,94.3089430894309,138,55,83,39.85507246376812,19.676692478910876,29,13,16,44.827586206896555,10,0,18,12,7,2,8,Athletic Club,23,Spain - La Liga
147,Eneko Capilla González,5,3.0,2,60.0,0,0,0,0.0,5,3,2,60.0,0,0,0,0.0,14.790950059392,0,0,0,0.0,0,0,1,1,1,1,0,Real Sociedad,1,Spain - La Liga
148,Enrique Sola Clemente,17,10.0,7,58.82352941176471,0,0,0,0.0,6,5,1,83.33333333333334,0,0,0,0.0,12.113781230710588,0,0,0,0.0,0,0,0,0,0,0,5,Athletic Club,5,Spain - La Liga
149,Enzo Nicolás Pérez,692,607.0,85,87.71676300578035,82,57,25,69.51219512195121,469,441,28,94.02985074626866,47,29,18,61.702127659574465,18.697343182906476,2,0,2,0.0,6,0,29,16,9,5,40,Valencia,20,Spain - La Liga
150,Enzo Pablo Roco Roco,984,792.0,192,80.48780487804879,98,41,57,41.83673469387755,461,442,19,95.87852494577007,170,72,98,42.35294117647059,24.11342484626795,6,1,5,16.666666666666664,2,0,8,6,1,0,10,Espanyol,33,Spain - La Liga
151,Eric Bertrand Bailly,838,650.0,188,77.56563245823389,75,34,41,45.33333333333333,461,418,43,90.67245119305856,97,39,58,40.20618556701031,20.71897648226377,0,0,0,0.0,3,0,14,11,4,2,28,Villarreal,25,Spain - La Liga
152,Esteban Félix Granero Molina,527,413.0,114,78.36812144212524,70,46,24,65.71428571428571,323,298,25,92.26006191950464,78,36,42,46.15384615384615,18.546799624890625,13,3,10,23.076923076923077,12,0,16,5,4,0,27,Real Sociedad,15,Spain - La Liga
153,Fabián Ariel Orellana Valenzuela,1651,1230.0,421,74.50030284675954,185,115,70,62.16216216216216,1058,901,157,85.16068052930056,138,64,74,46.3768115942029,17.419922890089232,69,14,55,20.28985507246377,45,7,209,109,98,50,100,Celta Vigo,34,Spain - La Liga
154,Fabián Ruiz Peña,236,189.0,47,80.08474576271186,21,13,8,61.904761904761905,172,155,17,90.11627906976744,7,6,1,85.71428571428571,12.570788865918813,3,2,1,66.66666666666666,5,1,14,6,9,3,3,Real Betis,12,Spain - La Liga
155,Fayçal Fajr,1638,1230.0,408,75.0915750915751,230,146,84,63.47826086956522,889,820,69,92.2384701912261,294,117,177,39.795918367346935,19.247339090341978,86,21,65,24.418604651162788,52,3,49,24,22,10,37,RC Deportivo La Coruña,38,Spain - La Liga
156,Federico Julián Fazio,119,83.0,36,69.74789915966386,21,10,11,47.61904761904761,50,49,1,98.0,34,16,18,47.05882352941176,26.816488151451427,0,0,0,0.0,1,0,2,2,0,0,1,Sevilla,4,Spain - La Liga
157,Federico Nicolás Cartabia,657,489.0,168,74.42922374429224,56,33,23,58.92857142857143,398,351,47,88.19095477386935,89,32,57,35.95505617977528,18.21356347481863,41,11,30,26.82926829268293,20,3,65,44,38,25,62,RC Deportivo La Coruña,26,Spain - La Liga
158,Federico Ricca Rostagnol,353,245.0,108,69.40509915014165,35,11,24,31.428571428571427,131,110,21,83.96946564885496,34,12,22,35.294117647058826,16.798195227059487,16,8,8,50.0,5,1,2,2,0,0,10,Málaga,8,Spain - La Liga
159,Felipe Salvador Caicedo Corozo,520,383.0,137,73.65384615384616,49,24,25,48.97959183673469,320,273,47,85.3125,13,4,9,30.76923076923077,12.667304681381076,10,2,8,20.0,14,0,67,38,35,15,40,Espanyol,31,Spain - La Liga
160,Fernando Damián Tissone,559,428.0,131,76.56529516994634,104,54,50,51.92307692307693,299,267,32,89.29765886287625,67,28,39,41.7910447761194,20.20750534862984,7,1,6,14.285714285714285,12,0,15,11,7,5,8,Málaga,12,Spain - La Liga
161,Fernando José Torres Sanz,389,255.0,134,65.55269922879178,31,15,16,48.38709677419355,225,177,48,78.66666666666666,3,2,1,66.66666666666666,11.380653235495526,9,3,6,33.33333333333333,14,2,72,32,50,22,42,Atlético Madrid,30,Spain - La Liga
162,Fernando Llorente Torres,389,250.0,139,64.26735218508998,36,12,24,33.33333333333333,146,118,28,80.82191780821918,10,5,5,50.0,12.621865146192924,8,4,4,50.0,14,3,20,10,17,8,8,Sevilla,23,Spain - La Liga
163,Fernando Navarro i Corbacho,1627,1212.0,415,74.49293177627536,266,149,117,56.015037593984964,772,710,62,91.96891191709845,189,61,128,32.27513227513227,19.14262280779796,34,6,28,17.647058823529413,10,2,32,20,12,7,41,RC Deportivo La Coruña,35,Spain - La Liga
164,Filipe Luís Kasmirski,2214,1753.0,461,79.17795844625113,261,184,77,70.49808429118774,1264,1148,116,90.82278481012658,191,59,132,30.89005235602094,15.800884941364552,88,17,71,19.318181818181817,25,4,129,74,64,35,46,Atlético Madrid,32,Spain - La Liga
165,Foued Kadir,287,215.0,72,74.91289198606272,20,14,6,70.0,188,167,21,88.82978723404256,25,10,15,40.0,15.026290429446691,20,4,16,20.0,7,0,18,13,8,6,8,Real Betis,8,Spain - La Liga
166,Francisco Alcácer García,480,349.0,131,72.70833333333333,43,19,24,44.18604651162791,298,246,52,82.5503355704698,18,7,11,38.88888888888889,13.89298979419725,10,1,9,10.0,24,5,27,11,14,5,24,Valencia,34,Spain - La Liga
167,Francisco Casilla Cortés,87,58.0,29,66.66666666666666,4,0,4,0.0,34,34,0,100.0,40,14,26,35.0,36.22622999718621,0,0,0,0.0,0,0,0,0,0,0,0,Real Madrid,4,Spain - La Liga
168,Francisco Guillermo Ochoa Magaña,294,167.0,127,56.80272108843537,49,7,42,14.285714285714285,63,63,0,100.0,199,74,125,37.185929648241206,45.88955128572245,0,0,0,0.0,0,0,0,0,0,0,0,Málaga,11,Spain - La Liga
169,Francisco Javier García Noblejas Hernanz,68,49.0,19,72.05882352941177,15,8,7,53.333333333333336,25,21,4,84.0,10,5,5,50.0,19.48925641458706,4,1,3,25.0,0,0,1,0,1,0,1,Getafe,1,Spain - La Liga
170,Francisco José Molinero Calderón,612,463.0,149,75.65359477124183,78,45,33,57.692307692307686,298,261,37,87.58389261744966,56,19,37,33.92857142857143,16.089424775321177,14,5,9,35.714285714285715,5,1,28,5,12,2,6,Real Betis,20,Spain - La Liga
171,Francisco José Perdomo Borges,124,91.0,33,73.38709677419355,8,4,4,50.0,84,75,9,89.28571428571429,8,2,6,25.0,15.434793940546452,9,1,8,11.11111111111111,6,0,16,10,7,5,3,Las Palmas,8,Spain - La Liga
172,Francisco José Sánchez Rodríguez,128,83.0,45,64.84375,17,8,9,47.05882352941176,70,63,7,90.0,6,1,5,16.666666666666664,15.53193286752375,5,1,4,20.0,3,1,10,3,2,0,7,Sevilla,4,Spain - La Liga
173,Francisco José Villalba Rodrigo,4,3.0,1,75.0,1,0,1,0.0,2,2,0,100.0,0,0,0,0.0,19.180335756599998,0,0,0,0.0,0,0,0,0,0,0,0,Valencia,1,Spain - La Liga
174,Francisco Manuel Rico Castro,896,690.0,206,77.00892857142857,138,86,52,62.31884057971014,481,431,50,89.6049896049896,130,68,62,52.307692307692314,18.929509010134552,23,9,14,39.130434782608695,32,0,18,11,5,4,22,Granada,28,Spain - La Liga
175,Francisco Medina Luna,306,176.0,130,57.51633986928104,61,21,40,34.42622950819672,157,125,32,79.61783439490446,69,20,49,28.985507246376812,20.01264262191765,14,3,11,21.428571428571427,12,2,26,20,13,10,12,Rayo Vallecano,16,Spain - La Liga
176,Francisco Miguel Varela Martín,542,395.0,147,72.87822878228782,76,43,33,56.57894736842105,239,218,21,91.21338912133892,89,26,63,29.213483146067414,18.89814463143011,23,8,15,34.78260869565217,9,0,8,3,4,1,4,Real Betis,14,Spain - La Liga
177,Francisco Montañés Claverías,84,56.0,28,66.66666666666666,5,2,3,40.0,54,44,10,81.48148148148148,7,1,6,14.285714285714285,14.930165141605714,5,1,4,20.0,2,0,10,5,5,4,10,Espanyol,7,Spain - La Liga
178,Francisco Portillo Soler,558,459.0,99,82.25806451612904,65,44,21,67.6923076923077,366,331,35,90.43715846994536,43,26,17,60.46511627906976,14.99511849692516,6,3,3,50.0,16,0,46,35,13,9,18,Real Betis,19,Spain - La Liga
179,Francisco Román Alarcón Suárez,1283,1095.0,188,85.34684333593141,118,90,28,76.27118644067797,990,920,70,92.92929292929293,84,50,34,59.523809523809526,15.403298412051443,57,24,33,42.10526315789473,35,7,137,87,68,41,61,Real Madrid,31,Spain - La Liga
180,Fábio Ricardo Gomes Fonseca,55,45.0,10,81.81818181818183,5,4,1,80.0,45,42,3,93.33333333333333,3,1,2,33.33333333333333,12.517241420866908,2,1,1,50.0,1,0,4,1,2,1,1,Málaga,2,Spain - La Liga
181,Gabriel Fernández Arenas,2224,1790.0,434,80.48561151079137,413,261,152,63.19612590799032,1393,1277,116,91.67264895908112,320,157,163,49.0625,18.454202374015683,25,8,17,32.0,21,2,45,28,12,9,48,Atlético Madrid,35,Spain - La Liga
182,Gareth Frank Bale,791,590.0,201,74.58912768647282,76,51,25,67.10526315789474,489,431,58,88.13905930470347,82,39,43,47.5609756097561,16.42831981193446,81,26,55,32.098765432098766,39,10,69,35,38,18,31,Real Madrid,23,Spain - La Liga
183,Gaël Kakuta,15,8.0,7,53.333333333333336,1,1,0,100.0,5,5,0,100.0,2,0,2,0.0,18.105395618447996,1,0,1,0.0,0,0,1,1,1,1,0,Sevilla,2,Spain - La Liga
184,Gerard Gumbau Garriga,20,17.0,3,85.0,2,2,0,100.0,13,12,1,92.3076923076923,1,0,1,0.0,20.33774660916,0,0,0,0.0,0,0,0,0,0,0,0,Barcelona,3,Spain - La Liga
185,Gerard Moreno Balaguero,665,474.0,191,71.2781954887218,66,34,32,51.515151515151516,379,309,70,81.53034300791556,37,22,15,59.45945945945946,15.407307666888903,20,8,12,40.0,13,3,103,57,66,31,26,Espanyol,32,Spain - La Liga
186,Gerard Piqué Bernabéu,2032,1863.0,169,91.68307086614173,193,149,44,77.2020725388601,1369,1350,19,98.61212563915267,174,97,77,55.74712643678161,20.995675229609997,3,1,2,33.33333333333333,4,1,11,10,2,2,12,Barcelona,30,Spain - La Liga
187,Germán Alejandro Pezzella,809,597.0,212,73.79480840543881,87,27,60,31.03448275862069,383,367,16,95.822454308094,140,41,99,29.28571428571429,22.747631625805884,3,2,1,66.66666666666666,0,1,2,2,0,0,14,Real Betis,25,Spain - La Liga
188,Germán Darío Lux,1024,539.0,485,52.63671875,160,42,118,26.25,125,125,0,100.0,768,301,467,39.19270833333333,50.88585438073406,0,0,0,0.0,1,0,1,1,0,0,7,RC Deportivo La Coruña,29,Spain - La Liga
189,Gerónimo Rulli,1250,776.0,474,62.08,177,43,134,24.293785310734464,330,330,0,100.0,749,291,458,38.851802403204275,44.04662966547533,1,0,1,0.0,1,0,2,2,0,0,6,Real Sociedad,36,Spain - La Liga
190,Giedrius Arlauskis,71,30.0,41,42.25352112676056,7,1,6,14.285714285714285,12,11,1,91.66666666666666,53,14,39,26.41509433962264,47.66151412130704,0,0,0,0.0,0,0,0,0,0,0,0,Espanyol,3,Spain - La Liga
191,Giuseppe Rossi,331,262.0,69,79.15407854984893,38,28,10,73.68421052631578,213,185,28,86.85446009389672,23,20,3,86.95652173913044,14.335389872305013,5,3,2,60.0,20,2,49,30,31,17,21,Levante UD,17,Spain - La Liga
192,Gonzalo Castro Irizábal,667,414.0,253,62.06896551724138,85,39,46,45.88235294117647,323,260,63,80.4953560371517,136,51,85,37.5,18.92079075998051,77,28,49,36.36363636363637,33,3,62,37,33,17,28,Málaga,24,Spain - La Liga
193,Gonzalo Escalante,1294,944.0,350,72.95208655332303,208,100,108,48.07692307692308,673,590,83,87.66716196136701,124,54,70,43.54838709677419,17.689494472414776,17,6,11,35.294117647058826,14,1,63,38,19,13,35,Eibar,34,Spain - La Liga
194,Gorka Elustondo Urkola,244,199.0,45,81.55737704918032,36,20,16,55.55555555555556,156,151,5,96.7948717948718,26,5,21,19.230769230769234,18.152573436549442,2,0,2,0.0,2,0,5,5,1,1,1,Athletic Club,11,Spain - La Liga
195,Gorka Iraizoz Moreno,1359,818.0,541,60.191317144959534,279,105,174,37.634408602150536,300,300,0,100.0,934,401,533,42.933618843683085,45.43033280957775,0,0,0,0.0,3,0,0,0,0,0,3,Athletic Club,37,Spain - La Liga
196,Grzegorz Krychowiak,1230,1021.0,209,83.0081300813008,126,73,53,57.936507936507944,715,679,36,94.96503496503496,87,42,45,48.275862068965516,19.779749421111802,6,3,3,50.0,5,0,16,12,6,6,62,Sevilla,26,Spain - La Liga
197,Guilherme Magdalena Siqueira,687,549.0,138,79.91266375545851,74,55,19,74.32432432432432,381,354,27,92.91338582677166,63,20,43,31.746031746031743,16.05563702520419,25,6,19,24.0,3,0,36,14,10,3,16,Valencia,15,Spain - La Liga
198,Gustavo Daniel Cabral Cáceres,1798,1590.0,208,88.43159065628477,90,39,51,43.333333333333336,1157,1139,18,98.44425237683664,161,64,97,39.75155279503105,20.94062349703535,2,0,2,0.0,3,0,12,10,1,1,23,Celta Vigo,31,Spain - La Liga
199,Hachim Mastour,2,1.0,1,50.0,0,0,0,0.0,0,0,0,0.0,0,0,0,0.0,11.719996656480001,0,0,0,0.0,0,0,0,0,0,0,0,Málaga,1,Spain - La Liga
200,Heiko Westermann,647,499.0,148,77.12519319938175,71,26,45,36.61971830985916,325,315,10,96.92307692307692,85,20,65,23.52941176470588,21.409035331652177,1,0,1,0.0,2,0,7,5,0,0,14,Real Betis,20,Spain - La Liga
201,Henok Goitom,33,21.0,12,63.63636363636363,5,2,3,40.0,18,12,6,66.66666666666666,0,0,0,0.0,10.759128267185455,0,0,0,0.0,2,0,1,0,0,0,2,Getafe,2,Spain - La Liga
202,Hernán Arsenio Pérez González,1019,688.0,331,67.5171736997056,91,45,46,49.45054945054945,547,468,79,85.55758683729434,100,35,65,35.0,15.989063332710737,86,23,63,26.744186046511626,25,1,169,96,82,40,62,Espanyol,32,Spain - La Liga
203,Hernán Daniel Santana Trujillo,562,474.0,88,84.34163701067615,38,22,16,57.89473684210527,419,380,39,90.69212410501193,15,5,10,33.33333333333333,16.485935904327842,1,0,1,0.0,1,0,12,6,2,2,17,Las Palmas,18,Spain - La Liga
204,Hugo Fraile Martín,33,21.0,12,63.63636363636363,1,1,0,100.0,19,16,3,84.21052631578947,5,2,3,40.0,17.06519582866909,4,2,2,50.0,2,0,3,0,2,0,1,Sporting Gijón,3,Spain - La Liga
205,Hugo Mallo Novegil,1768,1394.0,374,78.84615384615384,231,121,110,52.38095238095239,939,885,54,94.24920127795528,202,55,147,27.22772277227723,19.595664008172488,44,10,34,22.727272727272727,10,4,22,14,12,6,19,Celta Vigo,34,Spain - La Liga
206,Hugo Miguel Almeida Costa Lopes,1048,784.0,264,74.80916030534351,116,76,40,65.51724137931035,464,397,67,85.5603448275862,95,32,63,33.68421052631579,16.666639935693322,42,5,37,11.904761904761903,12,1,44,30,16,10,20,Granada,26,Spain - La Liga
207,Héctor Hernández Ortega,244,171.0,73,70.08196721311475,16,9,7,56.25,115,99,16,86.08695652173914,28,7,21,25.0,17.677021573354427,18,3,15,16.666666666666664,0,1,10,3,7,1,7,Real Sociedad,13,Spain - La Liga
208,Iago Aspas Juncal,976,744.0,232,76.22950819672131,80,49,31,61.25000000000001,618,520,98,84.14239482200647,56,29,27,51.78571428571429,14.628919349695941,39,16,23,41.02564102564102,41,5,66,34,39,18,49,Celta Vigo,35,Spain - La Liga
209,Iago Herrerín Buisán,81,43.0,38,53.086419753086425,20,3,17,15.0,6,6,0,100.0,66,31,35,46.96969696969697,54.22979810186666,0,0,0,0.0,0,0,0,0,0,0,0,Athletic Club,2,Spain - La Liga
210,Ian González Nieto,11,9.0,2,81.81818181818183,0,0,0,0.0,10,8,2,80.0,0,0,0,0.0,10.145681657934546,0,0,0,0.0,0,0,0,0,0,0,0,Getafe,1,Spain - La Liga
211,Ibai Gómez Pérez,53,32.0,21,60.37735849056604,5,3,2,60.0,26,22,4,84.61538461538461,9,2,7,22.22222222222222,17.328706453698114,8,1,7,12.5,1,0,5,4,2,2,0,Athletic Club,5,Spain - La Liga
212,Idriss Carlos Kameni,782,516.0,266,65.98465473145781,67,22,45,32.83582089552239,185,184,1,99.45945945945947,469,217,252,46.26865671641791,42.66224456675663,0,0,0,0.0,0,1,2,2,0,0,1,Málaga,28,Spain - La Liga
213,Ignacio Camacho Barnola,1167,864.0,303,74.03598971722364,203,108,95,53.20197044334976,619,543,76,87.7221324717286,118,52,66,44.06779661016949,17.362805516932443,8,3,5,37.5,10,1,18,15,2,0,47,Málaga,23,Spain - La Liga
214,Ignacio Cases Mora,963,786.0,177,81.61993769470405,116,81,35,69.82758620689656,614,557,57,90.71661237785015,69,34,35,49.275362318840585,17.16187752878953,11,2,9,18.181818181818183,6,0,25,17,10,5,38,Sporting Gijón,24,Spain - La Liga
215,Ignacio Monsalve Vicente,32,26.0,6,81.25,1,0,1,0.0,16,14,2,87.5,3,1,2,33.33333333333333,20.8335379667625,0,0,0,0.0,1,0,0,0,0,0,0,Atlético Madrid,1,Spain - La Liga
216,Igor Lichnovsky Osorio,26,17.0,9,65.38461538461539,3,1,2,33.33333333333333,12,12,0,100.0,7,1,6,14.285714285714285,22.470570910744616,0,0,0,0.0,0,0,1,1,0,0,2,Sporting Gijón,2,Spain - La Liga
217,Igor Zubeldia Elorza,5,4.0,1,80.0,2,2,0,100.0,3,3,0,100.0,0,0,0,0.0,18.143527652928,0,0,0,0.0,0,0,0,0,0,0,0,Real Sociedad,1,Spain - La Liga
218,Ikechukwu Uche,27,22.0,5,81.48148148148148,3,2,1,66.66666666666666,17,14,3,82.35294117647058,2,1,1,50.0,11.703091347813334,0,0,0,0.0,1,0,2,1,0,0,3,Málaga,3,Spain - La Liga
219,Iker Muniain Goñi,554,465.0,89,83.93501805054152,56,35,21,62.5,397,358,39,90.17632241813602,31,17,14,54.83870967741935,15.41173979113083,10,6,4,60.0,17,0,35,23,19,13,45,Athletic Club,20,Spain - La Liga
220,Imanol Agirretxe Arruti,330,226.0,104,68.48484848484848,33,13,20,39.39393939393939,175,143,32,81.71428571428572,18,3,15,16.666666666666664,13.469156322713673,11,0,11,0.0,3,0,21,6,13,3,28,Real Sociedad,16,Spain - La Liga
221,Isaac Ajayi Success,704,434.0,270,61.64772727272727,62,24,38,38.70967741935484,434,293,141,67.51152073732719,50,17,33,34.0,16.106969928692045,73,19,54,26.027397260273972,23,2,140,57,103,37,97,Granada,30,Spain - La Liga
222,Ismael López Blanco,1275,910.0,365,71.37254901960785,212,110,102,51.886792452830186,595,510,85,85.71428571428571,176,59,117,33.52272727272727,18.53553437931953,51,16,35,31.372549019607842,19,0,48,26,19,8,24,Sporting Gijón,31,Spain - La Liga
223,Ivan Rakitić,1899,1636.0,263,86.1506055818852,206,161,45,78.15533980582524,1258,1179,79,93.72019077901432,183,114,69,62.295081967213115,16.940516032696493,24,9,15,37.5,30,2,37,18,18,6,57,Barcelona,36,Spain - La Liga
224,Iván Cuéllar Sacristán,1019,440.0,579,43.179587831207066,245,53,192,21.63265306122449,142,141,1,99.29577464788733,790,223,567,28.227848101265824,51.97415492897947,0,0,0,0.0,1,2,0,0,0,0,8,Sporting Gijón,32,Spain - La Liga
225,Iván López Mendoza,443,311.0,132,70.20316027088036,60,32,28,53.333333333333336,170,148,22,87.05882352941177,97,39,58,40.20618556701031,21.89210298135115,17,2,15,11.76470588235294,4,0,24,17,6,4,8,Levante UD,13,Spain - La Liga
226,Iván Ramis Barrios,751,582.0,169,77.49667110519307,87,40,47,45.97701149425287,330,312,18,94.54545454545455,131,60,71,45.80152671755725,23.424797052044102,3,2,1,66.66666666666666,3,1,8,5,0,0,11,Eibar,23,Spain - La Liga
227,Izet Hajrović,79,54.0,25,68.35443037974683,7,5,2,71.42857142857143,44,40,4,90.9090909090909,18,3,15,16.666666666666664,18.804013751957466,3,0,3,0.0,3,0,6,0,3,0,2,Eibar,7,Spain - La Liga
228,Iñaki Williams Arthuer,485,300.0,185,61.855670103092784,38,21,17,55.26315789473685,315,223,92,70.7936507936508,26,10,16,38.46153846153847,14.880969796456874,44,12,32,27.27272727272727,10,3,57,32,32,19,47,Athletic Club,25,Spain - La Liga
229,Iñigo Barrenetxea García,7,6.0,1,85.71428571428571,2,2,0,100.0,3,3,0,100.0,0,0,0,0.0,20.330745512091426,0,0,0,0.0,1,0,0,0,0,0,0,Eibar,2,Spain - La Liga
230,Jackson Arley Martínez Valencia,196,140.0,56,71.42857142857143,31,15,16,48.38709677419355,103,87,16,84.46601941747572,9,5,4,55.55555555555556,14.040887736853469,7,4,3,57.14285714285714,8,2,17,11,14,10,16,Atlético Madrid,15,Spain - La Liga
231,James David Rodríguez Rubio,1214,988.0,226,81.38385502471169,120,96,24,80.0,801,734,67,91.6354556803995,156,81,75,51.92307692307693,17.687223421199466,70,26,44,37.142857142857146,53,8,49,26,30,14,26,Real Madrid,26,Spain - La Liga
232,Jan Oblak,818,423.0,395,51.71149144254279,90,23,67,25.555555555555554,172,170,2,98.83720930232558,581,194,387,33.3907056798623,47.63315430936969,0,0,0,0.0,1,0,1,1,0,0,5,Atlético Madrid,38,Spain - La Liga
233,Jaume Doménech Sánchez,516,305.0,211,59.10852713178295,35,11,24,31.428571428571427,125,124,1,99.2,340,135,205,39.705882352941174,43.38844957902418,0,0,0,0.0,1,0,0,0,0,0,5,Valencia,17,Spain - La Liga
234,Jaume Vicent Costa Jordá,843,665.0,178,78.88493475682088,94,52,42,55.319148936170215,405,379,26,93.58024691358024,93,40,53,43.01075268817204,18.402373194954023,15,2,13,13.333333333333334,3,1,5,4,4,3,22,Villarreal,18,Spain - La Liga
235,Javi Castellano Betancor,41,33.0,8,80.48780487804879,2,1,1,50.0,19,19,0,100.0,3,1,2,33.33333333333333,18.23238979161366,0,0,0,0.0,0,0,0,0,0,0,3,Las Palmas,1,Spain - La Liga
236,Javier Alejandro Mascherano,2111,1933.0,178,91.56797726196115,288,211,77,73.26388888888889,1293,1266,27,97.91183294663574,254,173,81,68.11023622047244,22.9771269395045,2,1,1,50.0,10,0,13,11,4,2,22,Barcelona,32,Spain - La Liga
237,Javier Eraso Goñi,260,192.0,68,73.84615384615385,25,14,11,56.00000000000001,169,150,19,88.75739644970415,9,2,7,22.22222222222222,13.763747817401539,1,1,0,100.0,9,1,14,5,8,4,19,Athletic Club,16,Spain - La Liga
238,Javier Fuego Martínez,1268,1073.0,195,84.62145110410094,150,92,58,61.33333333333333,813,764,49,93.9729397293973,114,63,51,55.26315789473685,18.501393035103785,2,1,1,50.0,9,0,16,11,3,2,39,Valencia,26,Spain - La Liga
239,Javier Garrido Behovide,994,838.0,156,84.30583501006036,81,51,30,62.96296296296296,612,583,29,95.26143790849673,89,32,57,35.95505617977528,18.832778668736257,22,7,15,31.818181818181817,5,1,2,2,0,0,4,Las Palmas,18,Spain - La Liga
240,Javier Guerra Rodríguez,663,477.0,186,71.94570135746606,63,24,39,38.095238095238095,385,334,51,86.75324675324674,22,10,12,45.45454545454545,12.970746414695023,13,4,9,30.76923076923077,24,0,47,22,26,12,65,Rayo Vallecano,30,Spain - La Liga
241,Javier López Rodríguez,1231,883.0,348,71.73030056864337,196,95,101,48.46938775510204,554,498,56,89.89169675090253,171,44,127,25.730994152046783,18.59130496080351,41,15,26,36.58536585365854,7,2,37,21,11,3,35,Espanyol,31,Spain - La Liga
242,Javier Márquez Moreno,605,428.0,177,70.74380165289256,164,92,72,56.09756097560976,301,270,31,89.70099667774086,143,61,82,42.65734265734265,22.288877157202514,13,0,13,0.0,11,1,12,9,0,0,30,Granada,19,Spain - La Liga
243,Javier Ontiveros Parra,43,33.0,10,76.74418604651163,4,2,2,50.0,33,27,6,81.81818181818183,3,1,2,33.33333333333333,14.445863635212838,2,0,2,0.0,2,0,2,2,1,1,1,Málaga,4,Spain - La Liga
244,Javier Varas Herrera,1221,762.0,459,62.40786240786241,96,22,74,22.916666666666664,361,357,4,98.89196675900277,704,262,442,37.215909090909086,39.74419805291971,0,0,0,0.0,0,0,3,3,0,0,8,Las Palmas,31,Spain - La Liga
245,Jean-Sylvain Claude Babin,852,699.0,153,82.04225352112677,82,32,50,39.02439024390244,493,475,18,96.34888438133873,121,58,63,47.93388429752066,21.172018452796056,1,0,1,0.0,2,0,1,1,0,0,7,Granada,25,Spain - La Liga
246,Jefferson Andrés Lerma Solís,1211,896.0,315,73.98843930635837,179,100,79,55.865921787709496,619,550,69,88.8529886914378,143,65,78,45.45454545454545,18.461732295132087,37,9,28,24.324324324324326,24,2,34,17,11,3,28,Levante UD,33,Spain - La Liga
247,Jerónimo Figueroa Cabrera,874,715.0,159,81.80778032036613,82,57,25,69.51219512195121,587,536,51,91.31175468483816,93,47,46,50.53763440860215,17.25774050691185,31,8,23,25.806451612903224,24,3,58,41,20,13,32,Las Palmas,23,Spain - La Liga
248,Jesé Rodríguez Ruiz,399,307.0,92,76.94235588972431,15,12,3,80.0,301,252,49,83.72093023255815,21,7,14,33.33333333333333,14.284373514916691,41,12,29,29.268292682926827,20,6,33,20,21,16,14,Real Madrid,28,Spain - La Liga
249,Jesús Fernández Collado,43,18.0,25,41.86046511627907,4,2,2,50.0,2,2,0,100.0,40,16,24,40.0,53.835602538809304,0,0,0,0.0,1,0,0,0,0,0,0,Granada,1,Spain - La Liga
250,Jesús Gámez Duarte,394,269.0,125,68.2741116751269,45,20,25,44.44444444444444,156,136,20,87.17948717948718,76,30,46,39.473684210526315,19.718404411619694,26,5,21,19.230769230769234,4,0,9,4,3,2,9,Atlético Madrid,10,Spain - La Liga
251,Joan Jordán Moreno,376,322.0,54,85.63829787234043,55,40,15,72.72727272727273,248,225,23,90.7258064516129,40,25,15,62.5,18.627649359556596,3,1,2,33.33333333333333,10,0,14,9,3,1,6,Espanyol,9,Spain - La Liga
252,Joan Verdú Fernández,510,427.0,83,83.72549019607844,52,32,20,61.53846153846154,343,313,30,91.25364431486881,41,21,20,51.21951219512195,16.23608608569741,11,6,5,54.54545454545454,17,1,19,13,4,2,14,Levante UD,13,Spain - La Liga
253,Joaquín José Marín Ruiz,1106,747.0,359,67.54068716094032,135,46,89,34.074074074074076,440,370,70,84.0909090909091,130,33,97,25.384615384615383,18.475722690344593,54,7,47,12.962962962962962,9,1,34,22,18,10,20,Rayo Vallecano,27,Spain - La Liga
254,Joaquín Sánchez Rodríguez,961,699.0,262,72.73673257023934,92,49,43,53.2608695652174,573,506,67,88.30715532286213,164,60,104,36.58536585365854,17.735933047647034,49,21,28,42.857142857142854,48,5,88,50,57,34,48,Real Betis,30,Spain - La Liga
255,John Guidetti,316,229.0,87,72.46835443037975,17,9,8,52.94117647058824,212,180,32,84.90566037735849,7,4,3,57.14285714285714,11.25322118381848,8,2,6,25.0,16,0,27,16,17,9,31,Celta Vigo,35,Spain - La Liga
256,Jon Ansotegi Gorostola,179,123.0,56,68.71508379888269,25,6,19,24.0,64,63,1,98.4375,39,13,26,33.33333333333333,24.790538431532514,0,0,0,0.0,2,0,0,0,0,0,3,Eibar,8,Spain - La Liga
257,Jon Bautista Orgilles,35,22.0,13,62.857142857142854,3,1,2,33.33333333333333,19,15,4,78.94736842105263,1,1,0,100.0,10.400771981026285,2,1,1,50.0,2,0,3,1,2,1,4,Real Sociedad,4,Spain - La Liga
258,Jonathan Castro Otto,1895,1547.0,348,81.6358839050132,228,149,79,65.35087719298247,1125,1026,99,91.2,126,46,80,36.507936507936506,16.911714664052646,29,13,16,44.827586206896555,18,4,43,22,26,13,27,Celta Vigo,36,Spain - La Liga
259,Jonathan Javier Rodríguez Portillo,97,65.0,32,67.0103092783505,9,7,2,77.77777777777779,59,46,13,77.96610169491525,0,0,0,0.0,11.918013717978557,3,1,2,33.33333333333333,3,0,11,7,8,4,5,RC Deportivo La Coruña,13,Spain - La Liga
260,Jonathan Rodríguez Menéndez,1122,662.0,460,59.001782531194294,121,57,64,47.107438016528924,575,450,125,78.26086956521739,213,46,167,21.5962441314554,19.831277488539463,152,32,120,21.052631578947366,36,7,140,59,74,28,64,Sporting Gijón,36,Spain - La Liga
261,Jonathan Viera Ramos,1956,1548.0,408,79.14110429447852,221,148,73,66.9683257918552,1337,1178,159,88.1077038145101,157,69,88,43.94904458598726,15.62673517695125,57,14,43,24.561403508771928,65,9,136,72,76,36,96,Las Palmas,36,Spain - La Liga
262,Jonathan dos Santos Ramírez,969,755.0,214,77.91537667698658,106,67,39,63.20754716981132,589,519,70,88.11544991511036,109,58,51,53.21100917431193,17.639800261526936,34,11,23,32.35294117647059,23,1,43,25,14,6,25,Villarreal,26,Spain - La Liga
263,Jonathas Cristian de Jesus,368,260.0,108,70.65217391304348,29,14,15,48.275862068965516,192,159,33,82.8125,10,7,3,70.0,13.125715421165216,14,3,11,21.428571428571427,13,2,54,28,42,21,38,Real Sociedad,27,Spain - La Liga
264,Jonhatan Montiel Caballero,79,55.0,24,69.62025316455697,10,3,7,30.0,52,41,11,78.84615384615384,9,2,7,22.22222222222222,17.165712109124048,7,3,4,42.857142857142854,2,0,9,3,4,1,4,Rayo Vallecano,8,Spain - La Liga
265,Jonás Manuel Gutiérrez,170,103.0,67,60.588235294117645,25,8,17,32.0,92,80,12,86.95652173913044,16,5,11,31.25,17.628689675299764,13,1,12,7.6923076923076925,2,1,20,10,11,5,6,RC Deportivo La Coruña,15,Spain - La Liga
266,Jordi Alba Ramos,2332,2005.0,327,85.97770154373929,174,134,40,77.01149425287356,1597,1489,108,93.23731997495304,95,38,57,40.0,15.117709749820241,67,19,48,28.35820895522388,16,6,16,7,8,1,17,Barcelona,31,Spain - La Liga
267,Jordi Figueras Montel,71,51.0,20,71.83098591549296,15,6,9,40.0,39,37,2,94.87179487179486,15,4,11,26.666666666666668,23.970250861879435,0,0,0,0.0,0,0,1,1,0,0,0,Real Betis,3,Spain - La Liga
268,Jordi Xumetra Feliu,147,100.0,47,68.02721088435374,16,6,10,37.5,76,62,14,81.57894736842105,7,0,7,0.0,15.319757012267754,11,1,10,9.090909090909092,4,0,9,2,4,1,8,Levante UD,13,Spain - La Liga
269,Jorge Andújar Moreno,866,627.0,239,72.40184757505773,127,70,57,55.118110236220474,395,346,49,87.59493670886076,99,36,63,36.36363636363637,18.142487618887206,34,5,29,14.705882352941178,7,1,34,18,18,8,32,Sevilla,22,Spain - La Liga
270,Jorge Franco Alviz,430,295.0,135,68.6046511627907,27,18,9,66.66666666666666,260,209,51,80.38461538461539,46,18,28,39.130434782608695,16.180506199177117,37,11,26,29.72972972972973,16,3,50,23,37,16,21,Espanyol,26,Spain - La Liga
271,Jorge Meré Pérez,789,621.0,168,78.70722433460075,71,19,52,26.76056338028169,422,399,23,94.54976303317537,90,23,67,25.555555555555554,22.159482196340075,0,0,0,0.0,1,0,9,8,0,0,12,Sporting Gijón,25,Spain - La Liga
272,Jorge Molina Vidal,300,185.0,115,61.66666666666667,44,21,23,47.72727272727273,155,122,33,78.70967741935485,12,3,9,25.0,12.5341021405848,4,0,4,0.0,8,1,9,6,4,3,24,Real Betis,23,Spain - La Liga
273,Jorge Resurrección Merodio,2272,1743.0,529,76.71654929577466,274,161,113,58.75912408759124,1450,1322,128,91.17241379310344,293,100,193,34.129692832764505,16.401959491947466,81,15,66,18.51851851851852,64,14,53,27,21,9,63,Atlético Madrid,35,Spain - La Liga
274,Joseba Zaldúa Bengoetxea,501,345.0,156,68.8622754491018,91,50,41,54.94505494505495,171,152,19,88.88888888888889,79,29,50,36.708860759493675,18.98379246409437,29,9,20,31.03448275862069,5,0,13,4,13,4,24,Real Sociedad,13,Spain - La Liga
275,Josep Señé Escudero,112,81.0,31,72.32142857142857,17,8,9,47.05882352941176,73,62,11,84.93150684931507,7,3,4,42.857142857142854,15.559317719794285,1,0,1,0.0,1,1,14,8,5,3,17,Celta Vigo,9,Spain - La Liga
276,Josip Radošević,194,143.0,51,73.71134020618557,30,18,12,60.0,96,84,12,87.5,19,10,9,52.63157894736842,18.678103233628452,3,3,0,100.0,1,0,3,2,1,0,7,Eibar,8,Spain - La Liga
277,José Alberto Cañas Ruiz Herrera,397,321.0,76,80.85642317380352,57,38,19,66.66666666666666,241,217,24,90.04149377593362,47,29,18,61.702127659574465,19.666401595569972,1,0,1,0.0,3,0,4,4,2,2,16,Espanyol,13,Spain - La Liga
278,José Antonio Dorado Ramírez,271,220.0,51,81.18081180811808,30,12,18,40.0,166,154,12,92.7710843373494,35,11,24,31.428571428571427,20.346430442589963,0,0,0,0.0,3,0,3,2,1,1,0,Rayo Vallecano,10,Spain - La Liga
279,José Antonio García Rabasco,1362,1049.0,313,77.01908957415566,206,114,92,55.33980582524271,747,694,53,92.904953145917,252,110,142,43.65079365079365,21.1972313272985,37,9,28,24.324324324324326,41,3,19,13,3,2,32,Levante UD,29,Spain - La Liga
280,José Antonio Reyes Calderón,607,378.0,229,62.27347611202636,88,53,35,60.22727272727273,336,261,75,77.67857142857143,100,34,66,34.0,18.145757428114003,50,15,35,30.0,31,1,38,16,21,9,43,Sevilla,24,Spain - La Liga
281,José Eduardo Rosa Vale de Castro,1159,871.0,288,75.15099223468508,215,85,130,39.53488372093023,567,543,24,95.76719576719577,262,92,170,35.11450381679389,25.007200798433683,2,0,2,0.0,5,0,12,10,0,0,6,Rayo Vallecano,22,Spain - La Liga
282,José Ignacio Fernández Iglesias,578,518.0,60,89.61937716262976,32,28,4,87.5,406,391,15,96.30541871921181,26,10,16,38.46153846153847,17.265410979970795,5,1,4,20.0,2,0,5,4,2,2,15,Real Madrid,16,Spain - La Liga
283,José Ignacio Martínez García,1109,809.0,300,72.94860234445446,169,86,83,50.887573964497044,477,423,54,88.67924528301887,151,50,101,33.11258278145696,19.17263856327906,37,5,32,13.513513513513514,10,0,17,8,8,5,17,Rayo Vallecano,22,Spain - La Liga
284,José Ignacio Peleteiro Ramallo,260,181.0,79,69.61538461538461,22,13,9,59.09090909090909,149,126,23,84.56375838926175,42,17,25,40.476190476190474,18.69621777987785,18,3,15,16.666666666666664,14,0,50,33,28,17,5,Eibar,13,Spain - La Liga
285,José Joaquín Matos García,53,39.0,14,73.58490566037736,6,5,1,83.33333333333334,30,23,7,76.66666666666667,2,0,2,0.0,16.082444792024152,5,0,5,0.0,0,0,2,1,1,1,1,Sevilla,1,Spain - La Liga
286,José Luis García del Pozo,1483,1174.0,309,79.16385704652731,209,129,80,61.72248803827751,965,881,84,91.29533678756476,167,66,101,39.52095808383233,17.981438123310262,22,4,18,18.181818181818183,30,4,60,36,32,17,47,Málaga,33,Spain - La Liga
287,José Luis Gayà Peña,851,665.0,186,78.1433607520564,64,42,22,65.625,448,418,30,93.30357142857143,99,39,60,39.39393939393939,17.27659133795422,42,10,32,23.809523809523807,14,0,34,18,22,8,20,Valencia,20,Spain - La Liga
288,José Luis Morales Nogales,1002,674.0,328,67.26546906187625,100,53,47,53.0,565,449,116,79.46902654867256,132,57,75,43.18181818181818,17.472026256007187,105,31,74,29.523809523809526,51,4,169,88,107,61,40,Levante UD,35,Spain - La Liga
289,José María Giménez de Vargas,882,659.0,223,74.71655328798185,144,61,83,42.36111111111111,393,377,16,95.92875318066157,202,76,126,37.62376237623762,24.57908936426939,2,1,1,50.0,6,1,11,8,0,0,12,Atlético Madrid,27,Spain - La Liga
290,José María Martín-Bejarano Serrano,418,322.0,96,77.03349282296651,59,28,31,47.45762711864407,214,196,18,91.58878504672897,52,25,27,48.07692307692308,20.297905823587175,3,0,3,0.0,3,0,9,5,3,2,18,Levante UD,12,Spain - La Liga
291,José Raúl Baena Urdiales,848,681.0,167,80.30660377358491,114,57,57,50.0,502,467,35,93.02788844621513,88,36,52,40.909090909090914,18.56157420889019,5,1,4,20.0,8,1,22,16,11,7,43,Rayo Vallecano,24,Spain - La Liga
292,José Vicente Gómez Umpiérrez,1038,908.0,130,87.47591522157995,64,48,16,75.0,718,688,30,95.82172701949861,35,16,19,45.714285714285715,16.030212256286706,7,2,5,28.57142857142857,6,1,28,16,5,3,45,Las Palmas,21,Spain - La Liga
293,José Ángel Crespo Rincón,411,340.0,71,82.7250608272506,34,18,16,52.94117647058824,246,234,12,95.1219512195122,53,18,35,33.9622641509434,20.3662112160508,0,0,0,0.0,0,0,2,1,0,0,7,Rayo Vallecano,9,Spain - La Liga
294,Jozabed Sánchez Ruiz,1079,885.0,194,82.02038924930491,137,92,45,67.15328467153284,680,617,63,90.73529411764706,84,38,46,45.23809523809524,17.01052064907394,16,3,13,18.75,27,2,38,23,9,2,33,Rayo Vallecano,27,Spain - La Liga
295,João Pedro Cavaco Cancelo,1210,909.0,301,75.12396694214875,142,82,60,57.74647887323944,594,528,66,88.88888888888889,161,59,102,36.64596273291926,18.964144735911074,74,14,60,18.91891891891892,12,4,109,59,54,24,43,Valencia,28,Spain - La Liga
296,Juan Antonio Rodríguez Villamuela,1147,901.0,246,78.55274629468177,161,82,79,50.931677018633536,606,572,34,94.38943894389439,148,68,80,45.94594594594595,19.88631238829524,7,2,5,28.57142857142857,6,1,16,11,3,3,31,Getafe,32,Spain - La Liga
297,Juan Carlos Martín Corral,759,539.0,220,71.01449275362319,81,16,65,19.753086419753085,299,297,2,99.33110367892976,320,118,202,36.875,37.00245974152031,0,0,0,0.0,1,0,1,1,0,0,3,Rayo Vallecano,21,Spain - La Liga
298,Juan Carlos Pérez López,535,384.0,151,71.77570093457943,54,34,20,62.96296296296296,322,283,39,87.88819875776397,45,11,34,24.444444444444443,16.324572591683125,32,8,24,25.0,14,2,25,14,9,5,22,Málaga,19,Spain - La Liga
299,Juan Carlos Valerón Santana,388,344.0,44,88.65979381443299,65,50,15,76.92307692307693,281,260,21,92.52669039145907,23,14,9,60.86956521739131,16.745149985407423,2,0,2,0.0,6,0,15,6,4,1,17,Las Palmas,13,Spain - La Liga
300,Juan Domínguez Lamas,60,46.0,14,76.66666666666667,9,5,4,55.55555555555556,40,37,3,92.5,1,0,1,0.0,16.014498153312,0,0,0,0.0,4,0,1,1,0,0,1,RC Deportivo La Coruña,5,Spain - La Liga
301,Juan Emmanuel Culio,364,303.0,61,83.24175824175825,44,31,13,70.45454545454545,262,239,23,91.22137404580153,31,20,11,64.51612903225806,16.90440229877934,4,1,3,25.0,8,1,28,17,6,4,32,Las Palmas,12,Spain - La Liga
302,Juan Francisco García García,765,495.0,270,64.70588235294117,186,85,101,45.69892473118279,298,256,42,85.90604026845638,219,83,136,37.89954337899543,25.141810231392,26,6,20,23.076923076923077,4,1,21,11,2,0,18,Levante UD,21,Spain - La Liga
303,Juan Francisco Moreno Fuertes,1515,1060.0,455,69.96699669966998,178,93,85,52.24719101123596,700,610,90,87.14285714285714,200,62,138,31.0,18.58932384677608,94,16,78,17.02127659574468,18,0,56,30,27,14,32,RC Deportivo La Coruña,35,Spain - La Liga
304,Juan Francisco Torres Belén,1723,1303.0,420,75.62391178177597,121,69,52,57.02479338842975,860,742,118,86.27906976744187,158,47,111,29.746835443037973,15.557245928013186,99,36,63,36.36363636363637,25,1,60,36,42,23,21,Atlético Madrid,35,Spain - La Liga
305,Juan Isaac Cuenca López,228,185.0,43,81.14035087719299,31,20,11,64.51612903225806,168,151,17,89.88095238095238,8,2,6,25.0,14.265458579302104,10,3,7,30.0,3,2,27,15,10,5,15,Granada,12,Spain - La Liga
306,Juan Manuel Vargas Risco,921,641.0,280,69.59826275787188,103,62,41,60.19417475728155,391,366,25,93.60613810741688,175,60,115,34.285714285714285,19.10629146835075,64,17,47,26.5625,23,2,22,16,7,5,9,Real Betis,20,Spain - La Liga
307,Juan Muñiz Gallego,28,19.0,9,67.85714285714286,3,2,1,66.66666666666666,18,17,1,94.44444444444444,5,2,3,40.0,18.85040529595714,1,0,1,0.0,4,0,2,2,0,0,5,Sporting Gijón,4,Spain - La Liga
308,Juan Muñoz Muñoz,38,25.0,13,65.78947368421053,6,2,4,33.33333333333333,19,18,1,94.73684210526315,6,3,3,50.0,17.868307155176844,2,1,1,50.0,0,0,2,1,0,0,1,Sevilla,8,Spain - La Liga
309,Juan Pablo Añor Acosta,684,505.0,179,73.83040935672514,73,37,36,50.68493150684932,467,392,75,83.94004282655246,59,22,37,37.28813559322034,15.440074055220526,17,5,12,29.411764705882355,27,1,93,41,50,23,48,Málaga,29,Spain - La Liga
310,Juan Rafael Fuentes Hernández,349,272.0,77,77.93696275071633,34,21,13,61.76470588235294,180,164,16,91.11111111111111,31,7,24,22.58064516129032,16.91302026912963,12,0,12,0.0,2,0,6,3,4,2,8,Espanyol,10,Spain - La Liga
311,Juan Torres Ruiz,783,587.0,196,74.96807151979566,122,46,76,37.704918032786885,340,328,12,96.47058823529412,194,73,121,37.628865979381445,27.30324166701563,1,0,1,0.0,3,1,9,6,1,0,26,Getafe,22,Spain - La Liga
312,Jérémy Mathieu,832,735.0,97,88.34134615384616,63,44,19,69.84126984126983,587,562,25,95.74105621805792,35,15,20,42.857142857142854,18.73236886718798,7,2,5,28.57142857142857,2,2,5,5,2,2,6,Barcelona,21,Spain - La Liga
313,Karim Benzema,687,535.0,152,77.87481804949053,61,44,17,72.1311475409836,498,427,71,85.7429718875502,21,11,10,52.38095238095239,13.607648103852576,31,2,29,6.451612903225806,32,5,49,27,32,18,27,Real Madrid,27,Spain - La Liga
314,Kevin Gameiro,439,316.0,123,71.98177676537586,24,17,7,70.83333333333334,299,230,69,76.92307692307693,8,1,7,12.5,12.666178268067936,20,8,12,40.0,21,3,49,21,37,18,23,Sevilla,31,Spain - La Liga
315,Keylor Navas Gamboa,905,627.0,278,69.28176795580112,63,7,56,11.11111111111111,322,322,0,100.0,418,152,266,36.36363636363637,38.29044256648548,0,0,0,0.0,1,0,0,0,0,0,6,Real Madrid,34,Spain - La Liga
316,Kléper Laveran Lima Ferreira,1177,1018.0,159,86.4910790144435,100,57,43,56.99999999999999,800,775,25,96.875,101,39,62,38.613861386138616,19.0774827988174,5,2,3,40.0,6,1,15,12,2,2,25,Real Madrid,21,Spain - La Liga
317,Laureano Sanabria Ruiz,805,599.0,206,74.40993788819877,82,42,40,51.21951219512195,373,342,31,91.68900804289544,84,21,63,25.0,17.498374840705193,27,9,18,33.33333333333333,8,0,20,10,9,5,14,RC Deportivo La Coruña,23,Spain - La Liga
318,Leandro Damião da Silva dos Santos,28,18.0,10,64.28571428571429,6,4,2,66.66666666666666,14,14,0,100.0,0,0,0,0.0,11.802240751217143,1,0,1,0.0,4,0,2,0,1,0,3,Real Betis,3,Spain - La Liga
319,Leonardo Carrilho Baptistão,385,249.0,136,64.67532467532467,35,21,14,60.0,237,176,61,74.26160337552743,21,11,10,52.38095238095239,14.258336510139241,28,7,21,25.0,7,1,49,20,31,11,45,Villarreal,26,Spain - La Liga
320,Lionel Andrés Messi Cuccittini,1926,1544.0,382,80.16614745586709,284,189,95,66.54929577464789,1305,1159,146,88.81226053639847,219,124,95,56.62100456621004,16.786830197904635,36,5,31,13.88888888888889,59,15,241,179,155,109,80,Barcelona,33,Spain - La Liga
321,Lucas Alfonso Orbán Alegre,392,303.0,89,77.29591836734694,46,26,20,56.52173913043478,198,187,11,94.44444444444444,49,14,35,28.57142857142857,18.922573723463266,14,1,13,7.142857142857142,0,0,14,7,4,2,19,Levante UD,10,Spain - La Liga
322,Lucas Hernández Pi,325,237.0,88,72.92307692307692,37,12,25,32.432432432432435,164,155,9,94.51219512195121,50,11,39,22.0,20.429088774127756,3,2,1,66.66666666666666,3,0,3,2,0,0,11,Atlético Madrid,10,Spain - La Liga
323,Lucas Pérez Martínez,1023,749.0,274,73.21603128054741,67,44,23,65.67164179104478,665,559,106,84.06015037593984,92,34,58,36.95652173913043,15.826380716329618,49,20,29,40.816326530612244,60,7,74,41,57,28,61,RC Deportivo La Coruña,36,Spain - La Liga
324,Lucas Vázquez Iglesias,704,565.0,139,80.25568181818183,36,26,10,72.22222222222221,510,455,55,89.2156862745098,49,22,27,44.89795918367347,15.022514169573752,51,16,35,31.372549019607842,23,6,40,27,22,14,41,Real Madrid,25,Spain - La Liga
325,Luciano Vietto,375,294.0,81,78.4,15,6,9,40.0,257,218,39,84.8249027237354,10,4,6,40.0,12.44849949346176,11,3,8,27.27272727272727,9,3,31,20,17,10,23,Atlético Madrid,19,Spain - La Liga
326,Luis Alberto Romero Alconchel,794,515.0,279,64.86146095717883,84,41,43,48.80952380952381,489,376,113,76.89161554192229,63,25,38,39.682539682539684,15.491477276478589,45,8,37,17.77777777777778,27,6,72,37,52,28,25,RC Deportivo La Coruña,29,Spain - La Liga
327,Luis Alberto Suárez Díaz,973,707.0,266,72.66187050359713,68,37,31,54.41176470588235,571,455,116,79.6847635726795,47,25,22,53.191489361702125,14.053406163860497,52,21,31,40.38461538461539,45,15,134,50,102,36,77,Barcelona,35,Spain - La Liga
328,Luis Carlos Correia Pinto,504,342.0,162,67.85714285714286,41,18,23,43.90243902439025,248,219,29,88.30645161290323,56,9,47,16.071428571428573,17.893809307015715,33,3,30,9.090909090909092,4,0,31,20,20,13,33,RC Deportivo La Coruña,20,Spain - La Liga
329,Luis Carlos Fariña Olivera,19,17.0,2,89.47368421052632,1,1,0,100.0,14,14,0,100.0,1,0,1,0.0,11.746090167385264,0,0,0,0.0,0,0,3,0,2,0,1,Rayo Vallecano,3,Spain - La Liga
330,Luis Hernández Rodríguez,1630,1270.0,360,77.91411042944786,154,80,74,51.94805194805194,846,786,60,92.90780141843972,249,84,165,33.734939759036145,21.207069089431947,39,8,31,20.51282051282051,14,0,11,10,1,1,18,Sporting Gijón,36,Spain - La Liga
331,Luka Modrić,2270,2026.0,244,89.2511013215859,329,260,69,79.0273556231003,1620,1541,79,95.12345679012346,215,137,78,63.72093023255814,17.946313559998256,24,7,17,29.166666666666668,59,4,65,47,22,13,70,Real Madrid,32,Spain - La Liga
332,Lévy Clément Madinda,2,2.0,0,100.0,1,1,0,100.0,2,2,0,100.0,0,0,0,0.0,11.771872214399998,0,0,0,0.0,0,0,0,0,0,0,0,Celta Vigo,1,Spain - La Liga
333,Mamadou Sylla Diallo,68,46.0,22,67.64705882352942,4,3,1,75.0,38,29,9,76.31578947368422,3,1,2,33.33333333333333,14.995777919304706,5,2,3,40.0,3,0,12,6,9,5,10,Espanyol,13,Spain - La Liga
334,Manuel Agudo Durán,1283,821.0,462,63.99064692127825,161,76,85,47.20496894409938,714,540,174,75.63025210084034,215,77,138,35.81395348837209,19.157867223320345,65,16,49,24.615384615384617,54,7,163,76,122,54,77,Celta Vigo,29,Spain - La Liga
335,Manuel Castellano Castro,341,246.0,95,72.14076246334311,49,31,18,63.26530612244898,144,136,8,94.44444444444444,60,23,37,38.333333333333336,21.13590928744399,10,2,8,20.0,2,0,2,1,1,0,6,Eibar,10,Spain - La Liga
336,Manuel Fernández Muñíz,245,114.0,131,46.53061224489796,52,17,35,32.69230769230769,19,18,1,94.73684210526315,205,78,127,38.048780487804876,54.05709566594938,0,0,0,0.0,1,0,0,0,0,0,3,RC Deportivo La Coruña,9,Spain - La Liga
337,Manuel Pablo García Díaz,104,87.0,17,83.65384615384616,7,6,1,85.71428571428571,58,56,2,96.55172413793103,8,1,7,12.5,17.421049079404614,1,0,1,0.0,1,0,0,0,0,0,1,RC Deportivo La Coruña,3,Spain - La Liga
338,Manuel Rolando Iturra Urrutia,174,144.0,30,82.75862068965517,8,0,8,0.0,120,113,7,94.16666666666667,5,0,5,0.0,17.525496700051033,0,0,0,0.0,2,0,4,1,1,0,5,Rayo Vallecano,6,Spain - La Liga
339,Manuel Trigueros Muñoz,1216,981.0,235,80.67434210526315,183,108,75,59.01639344262295,732,678,54,92.62295081967213,120,66,54,55.00000000000001,19.534375450165854,2,0,2,0.0,14,1,19,13,6,3,31,Villarreal,31,Spain - La Liga
340,Marc Bartra Aregall,392,346.0,46,88.26530612244898,31,24,7,77.41935483870968,259,256,3,98.84169884169884,39,17,22,43.58974358974359,21.51875164770918,0,0,0,0.0,0,1,4,3,1,1,9,Barcelona,13,Spain - La Liga
341,Marc-André ter Stegen,187,165.0,22,88.23529411764706,1,1,0,100.0,102,102,0,100.0,54,32,22,59.25925925925925,29.153420641289838,0,0,0,0.0,1,0,0,0,0,0,0,Barcelona,7,Spain - La Liga
342,Marcelo Alfonso Díaz Rojas,758,676.0,82,89.18205804749341,91,75,16,82.41758241758241,504,482,22,95.63492063492063,70,49,21,70.0,19.40122683381372,3,0,3,0.0,3,1,7,4,2,1,14,Celta Vigo,14,Spain - La Liga
343,Marcelo Vieira da Silva Júnior,2087,1708.0,379,81.83996166746526,253,170,83,67.19367588932806,1272,1162,110,91.35220125786164,237,115,122,48.52320675105485,18.080061391841227,97,25,72,25.773195876288657,45,3,100,60,57,31,42,Real Madrid,30,Spain - La Liga
344,Marco Andreolli,206,173.0,33,83.98058252427184,21,6,15,28.57142857142857,108,105,3,97.22222222222221,23,6,17,26.08695652173913,22.766810124971183,0,0,0,0.0,2,0,0,0,0,0,4,Sevilla,7,Spain - La Liga
345,Marco Asensio Willemsen,1315,945.0,370,71.86311787072243,145,97,48,66.89655172413794,811,698,113,86.06658446362515,182,64,118,35.16483516483517,17.88750553609697,73,24,49,32.87671232876712,57,9,112,61,45,27,71,Espanyol,34,Spain - La Liga
346,Marcos Alberto Angeleri,384,297.0,87,77.34375,60,29,31,48.333333333333336,190,180,10,94.73684210526315,64,23,41,35.9375,22.1335211929275,0,0,0,0.0,2,0,1,0,0,0,8,Málaga,13,Spain - La Liga
347,Marcos Llorente Moreno,19,19.0,0,100.0,1,1,0,100.0,18,18,0,100.0,0,0,0,0.0,15.312036775301053,0,0,0,0.0,1,0,0,0,0,0,0,Real Madrid,2,Spain - La Liga
348,Mariano Damián Barbosa,43,33.0,10,76.74418604651163,0,0,0,0.0,23,23,0,100.0,15,5,10,33.33333333333333,29.433456087220467,0,0,0,0.0,0,0,1,1,0,0,0,Villarreal,2,Spain - La Liga
349,Mariano Ferreira Filho,892,620.0,272,69.50672645739911,76,35,41,46.05263157894737,385,319,66,82.85714285714286,122,47,75,38.52459016393443,19.11440263101821,96,27,69,28.125,20,2,34,20,20,9,17,Sevilla,23,Spain - La Liga
350,Mario Gaspar Pérez Martínez,1684,1255.0,429,74.5249406175772,250,135,115,54.0,805,739,66,91.80124223602485,196,50,146,25.510204081632654,18.50724913456582,29,5,24,17.24137931034483,8,1,23,11,14,7,14,Villarreal,33,Spain - La Liga
351,Markel Bergara Larrañaga,593,473.0,120,79.76391231028668,78,43,35,55.12820512820513,343,319,24,93.00291545189503,41,17,24,41.46341463414634,17.584563368753724,1,0,1,0.0,1,0,13,10,3,2,28,Real Sociedad,20,Spain - La Liga
352,Markel Susaeta Laskurain,775,540.0,235,69.6774193548387,77,42,35,54.54545454545454,485,406,79,83.71134020618557,90,33,57,36.666666666666664,15.72764151638462,65,23,42,35.38461538461539,38,8,87,35,46,15,40,Athletic Club,28,Spain - La Liga
353,Martín Montoya Torralbo,740,586.0,154,79.1891891891892,72,44,28,61.111111111111114,388,351,37,90.4639175257732,40,17,23,42.5,14.926649509031352,9,2,7,22.22222222222222,3,1,25,14,8,2,21,Real Betis,13,Spain - La Liga
354,Mateo Kovačić,773,696.0,77,90.03880983182407,71,55,16,77.46478873239437,634,593,41,93.53312302839116,14,6,8,42.857142857142854,15.14550113606841,3,1,2,33.33333333333333,17,2,25,15,6,3,22,Real Madrid,25,Spain - La Liga
355,Mateo Pablo Musacchio,461,377.0,84,81.77874186550976,36,13,23,36.11111111111111,264,251,13,95.07575757575758,50,18,32,36.0,21.276544040757138,0,0,0,0.0,2,0,6,3,0,0,8,Villarreal,13,Spain - La Liga
356,Matheus Dória Macedo,169,113.0,56,66.86390532544378,33,11,22,33.33333333333333,66,61,5,92.42424242424242,44,13,31,29.545454545454547,26.104596902857278,0,0,0,0.0,0,0,0,0,0,0,0,Granada,8,Spain - La Liga
357,Mathew Ryan,279,179.0,100,64.15770609318996,36,8,28,22.22222222222222,70,69,1,98.57142857142858,181,87,94,48.06629834254144,43.72312697260645,0,0,0,0.0,0,0,0,0,0,0,1,Valencia,8,Spain - La Liga
358,Matías Nahuel Leiva Esquivel,377,258.0,119,68.43501326259947,25,11,14,44.0,239,197,42,82.42677824267783,38,8,30,21.052631578947366,16.131133686400425,16,2,14,12.5,12,1,42,20,22,9,17,Villarreal,20,Spain - La Liga
359,Mauricio Andrés Cuero Castillo,142,91.0,51,64.08450704225352,6,2,4,33.33333333333333,92,64,28,69.56521739130434,11,6,5,54.54545454545454,14.969225233333521,20,12,8,60.0,6,1,28,17,15,9,11,Levante UD,13,Spain - La Liga
360,Mauricio Lemos Merladet,353,294.0,59,83.28611898016997,33,14,19,42.42424242424242,207,205,2,99.03381642512076,64,28,36,43.75,23.739078330401814,0,0,0,0.0,0,0,7,6,2,2,1,Las Palmas,10,Spain - La Liga
361,Mauro Javier Dos Santos,981,658.0,323,67.07441386340469,173,53,120,30.63583815028902,328,301,27,91.76829268292683,248,82,166,33.064516129032256,25.006514362391194,5,1,4,20.0,2,1,11,5,0,0,17,Eibar,31,Spain - La Liga
362,Mehdi Lacen,1446,1175.0,271,81.25864453665284,207,131,76,63.28502415458937,905,831,74,91.8232044198895,141,77,64,54.60992907801418,18.497849653338175,6,2,4,33.33333333333333,11,0,23,16,0,0,43,Getafe,31,Spain - La Liga
363,Michael Krohn-Dehli,888,715.0,173,80.51801801801803,117,73,44,62.39316239316239,567,520,47,91.71075837742504,114,62,52,54.385964912280706,18.67444238337892,27,8,19,29.629629629629626,31,3,36,17,20,8,19,Sevilla,27,Spain - La Liga
364,Mickaël Ciani,96,72.0,24,75.0,15,6,9,40.0,52,50,2,96.15384615384616,18,6,12,33.33333333333333,21.502108451437497,0,0,0,0.0,0,0,0,0,0,0,1,Espanyol,2,Spain - La Liga
365,Miguel Filipe Nunes Cardoso,16,12.0,4,75.0,1,1,0,100.0,12,10,2,83.33333333333334,1,1,0,100.0,13.751272179899999,0,0,0,0.0,0,1,4,1,4,1,0,RC Deportivo La Coruña,3,Spain - La Liga
366,Miguel Torres Gómez,901,634.0,267,70.36625971143174,139,65,74,46.76258992805755,348,314,34,90.22988505747126,128,40,88,31.25,19.148075397049944,21,7,14,33.33333333333333,8,2,6,3,3,1,6,Málaga,23,Spain - La Liga
367,Miguel Ángel Guerrero Martín,277,209.0,68,75.45126353790613,20,7,13,35.0,171,145,26,84.7953216374269,6,4,2,66.66666666666666,13.311513456971264,7,4,3,57.14285714285714,12,1,26,18,18,14,15,Sporting Gijón,23,Spain - La Liga
368,Miguel Ángel Muñoz Alonso,91,75.0,16,82.41758241758241,5,4,1,80.0,49,43,6,87.75510204081633,2,0,2,0.0,16.07010167736,0,0,0,0.0,1,0,1,1,0,0,2,Getafe,3,Spain - La Liga
369,Mikel Arruabarrena Aranbide,34,32.0,2,94.11764705882352,3,2,1,66.66666666666666,22,21,1,95.45454545454545,0,0,0,0.0,13.35781542479294,0,0,0,0.0,0,0,0,0,0,0,2,Eibar,6,Spain - La Liga
370,Mikel Balenziaga Oruesagasti,1508,1153.0,355,76.45888594164457,137,84,53,61.31386861313869,712,651,61,91.43258426966293,165,53,112,32.121212121212125,17.704353269874268,81,24,57,29.629629629629626,20,3,48,24,28,12,26,Athletic Club,34,Spain - La Liga
371,Mikel González de Martín Martínez,566,449.0,117,79.3286219081272,61,31,30,50.81967213114754,314,297,17,94.5859872611465,76,28,48,36.84210526315789,21.69193568710007,4,1,3,25.0,1,0,6,5,0,0,5,Real Sociedad,19,Spain - La Liga
372,Mikel Oyarzabal Ugarte,511,358.0,153,70.0587084148728,41,24,17,58.536585365853654,326,266,60,81.59509202453987,27,13,14,48.148148148148145,14.405641972655108,26,7,19,26.923076923076923,21,1,56,16,34,9,39,Real Sociedad,22,Spain - La Liga
373,Mikel Rico Moreno,377,283.0,94,75.06631299734748,57,32,25,56.14035087719298,221,196,25,88.68778280542986,36,15,21,41.66666666666667,17.347433257948012,5,1,4,20.0,3,1,12,5,3,0,9,Athletic Club,17,Spain - La Liga
374,Mikel San José Domínguez,1541,1220.0,321,79.16937053861129,208,134,74,64.42307692307693,887,813,74,91.65727170236752,134,62,72,46.26865671641791,18.468609534356496,11,5,6,45.45454545454545,11,3,28,15,9,4,32,Athletic Club,34,Spain - La Liga
375,Moisés Gómez Bordonado,430,350.0,80,81.3953488372093,48,38,10,79.16666666666666,305,274,31,89.8360655737705,32,16,16,50.0,16.342476986304,12,3,9,25.0,5,3,31,21,11,6,6,Getafe,22,Spain - La Liga
376,Mubarak Wakaso,497,394.0,103,79.27565392354124,59,34,25,57.6271186440678,336,300,36,89.28571428571429,52,24,28,46.15384615384615,18.6722688870268,17,5,12,29.411764705882355,8,0,37,21,10,5,34,Las Palmas,19,Spain - La Liga
377,Munir El Haddadi Mohamed,321,252.0,69,78.50467289719626,17,8,9,47.05882352941176,240,207,33,86.25,16,6,10,37.5,13.809702388539812,10,1,9,10.0,6,1,21,9,11,5,13,Barcelona,15,Spain - La Liga
378,Nabil El Zhar,632,492.0,140,77.84810126582279,36,25,11,69.44444444444444,447,394,53,88.14317673378076,37,16,21,43.24324324324324,14.349906197976987,34,10,24,29.411764705882355,14,4,74,30,36,17,36,Las Palmas,30,Spain - La Liga
379,Nabil Ghilas,235,146.0,89,62.12765957446808,26,10,16,38.46153846153847,109,91,18,83.4862385321101,9,4,5,44.44444444444444,13.17440055509617,7,3,4,42.857142857142854,9,1,37,18,24,12,11,Levante UD,20,Spain - La Liga
380,Nauzet Alemán Viera,150,111.0,39,74.0,10,6,4,60.0,92,79,13,85.86956521739131,20,9,11,45.0,16.521194372328,7,4,3,57.14285714285714,5,0,4,2,1,0,2,Las Palmas,10,Spain - La Liga
381,Nemanja Radoja,813,670.0,143,82.41082410824109,92,65,27,70.65217391304348,544,504,40,92.64705882352942,48,19,29,39.58333333333333,17.934890785297416,2,1,1,50.0,3,0,29,18,4,1,14,Celta Vigo,30,Spain - La Liga
382,Neymar da Silva Santos Junior,1970,1532.0,438,77.76649746192894,138,108,30,78.26086956521739,1381,1197,184,86.67632150615496,159,73,86,45.911949685534594,14.817353186505416,71,26,45,36.61971830985916,82,12,273,169,185,114,159,Barcelona,34,Spain - La Liga
383,Nicolás Federico López Alonso,60,35.0,25,58.333333333333336,8,2,6,25.0,27,21,6,77.77777777777779,15,2,13,13.333333333333334,19.308837655043998,5,1,4,20.0,3,0,10,7,7,5,5,Granada,8,Spain - La Liga
384,Nicolás Ladislao Fedor Flores,409,303.0,106,74.08312958435208,36,17,19,47.22222222222222,266,233,33,87.59398496240601,9,3,6,33.33333333333333,12.519259298816038,9,3,6,33.33333333333333,22,3,37,16,18,7,26,Rayo Vallecano,22,Spain - La Liga
385,Nicolás Martín Pareja,92,70.0,22,76.08695652173914,25,12,13,48.0,44,43,1,97.72727272727273,22,8,14,36.36363636363637,26.119612607110437,0,0,0,0.0,1,0,1,0,0,0,3,Sevilla,2,Spain - La Liga
386,Nikolaos Karabelas,60,35.0,25,58.333333333333336,9,5,4,55.55555555555556,15,13,2,86.66666666666667,13,4,9,30.76923076923077,20.310573349308,4,1,3,25.0,0,0,1,0,1,0,1,Levante UD,1,Spain - La Liga
387,Nordin Amrabat,313,197.0,116,62.939297124600635,25,8,17,32.0,190,146,44,76.84210526315789,31,8,23,25.806451612903224,16.632489347735465,47,12,35,25.53191489361702,15,1,38,24,29,18,37,Málaga,13,Spain - La Liga
388,Néstor Díaz García,2,2.0,0,100.0,0,0,0,0.0,0,0,0,0.0,2,2,0,100.0,42.932559042,0,0,0,0.0,0,0,0,0,0,0,0,Celta Vigo,1,Spain - La Liga
389,Ognjen Vranješ,384,267.0,117,69.53125,49,32,17,65.3061224489796,145,123,22,84.82758620689656,47,13,34,27.659574468085108,17.345074931955,10,2,8,20.0,1,0,6,4,1,1,18,Sporting Gijón,11,Spain - La Liga
390,Oier Olazábal Paredes,93,51.0,42,54.83870967741935,15,5,10,33.33333333333333,19,19,0,100.0,61,19,42,31.147540983606557,43.21429953663484,0,0,0,0.0,0,0,0,0,0,0,1,Real Sociedad,3,Spain - La Liga
391,Omar Mascarell González,851,621.0,230,72.97297297297297,136,70,66,51.470588235294116,421,380,41,90.26128266033254,135,56,79,41.48148148148148,20.87288635898183,6,2,4,33.33333333333333,8,1,12,9,1,0,14,Sporting Gijón,26,Spain - La Liga
392,Oriol Riera Magem,264,180.0,84,68.18181818181817,27,14,13,51.85185185185185,135,113,22,83.7037037037037,7,4,3,57.14285714285714,13.442282191281818,4,1,3,25.0,8,0,11,7,7,3,19,RC Deportivo La Coruña,22,Spain - La Liga
393,Pablo Daniel Piatti,320,214.0,106,66.875,20,12,8,60.0,198,162,36,81.81818181818183,47,13,34,27.659574468085108,16.39989571160475,30,8,22,26.666666666666668,13,0,36,13,18,6,40,Valencia,21,Spain - La Liga
394,Pablo Fornals Malla,738,564.0,174,76.42276422764228,103,51,52,49.51456310679612,483,437,46,90.47619047619048,75,20,55,26.666666666666668,17.299826391561464,4,0,4,0.0,14,0,33,16,13,3,16,Málaga,27,Spain - La Liga
395,Pablo Hernández Domínguez,1017,763.0,254,75.02458210422812,144,87,57,60.416666666666664,609,520,89,85.38587848932676,75,29,46,38.666666666666664,17.271808355696283,38,13,25,34.21052631578947,26,3,54,24,35,14,24,Rayo Vallecano,27,Spain - La Liga
396,Pablo Pérez Rodríguez,261,162.0,99,62.06896551724138,34,10,24,29.411764705882355,128,101,27,78.90625,8,2,6,25.0,14.021211369641378,7,1,6,14.285714285714285,3,1,14,5,8,2,10,Sporting Gijón,18,Spain - La Liga
397,Pablo Sarabia García,1208,766.0,442,63.41059602649006,134,69,65,51.49253731343284,732,563,169,76.91256830601093,216,72,144,33.33333333333333,17.834582058416284,112,30,82,26.785714285714285,65,6,112,45,69,24,66,Getafe,31,Spain - La Liga
398,Papa Kouly Diop,1206,931.0,275,77.19734660033167,226,116,110,51.32743362831859,674,628,46,93.17507418397626,148,68,80,45.94594594594595,19.82385213784,1,0,1,0.0,3,0,25,18,3,2,58,Espanyol,30,Spain - La Liga
399,Pape Cheikh Diop Gueye,24,22.0,2,91.66666666666666,1,1,0,100.0,16,16,0,100.0,0,0,0,0.0,13.9856067252,0,0,0,0.0,0,0,2,2,0,0,4,Celta Vigo,4,Spain - La Liga
400,Patrick Ebert,272,189.0,83,69.48529411764706,21,16,5,76.19047619047619,158,132,26,83.54430379746836,30,7,23,23.333333333333332,16.344024888271765,15,1,14,6.666666666666667,8,0,8,5,5,3,8,Rayo Vallecano,9,Spain - La Liga
401,Pau López Sabata,979,541.0,438,55.260469867211434,129,34,95,26.356589147286826,211,210,1,99.52606635071089,644,225,419,34.93788819875777,46.2950960872192,0,0,0,0.0,0,0,0,0,0,0,7,Espanyol,36,Spain - La Liga
402,Pedro Bigas Rigo,1284,1074.0,210,83.64485981308411,67,28,39,41.7910447761194,802,773,29,96.38403990024938,120,27,93,22.5,20.512547130708782,4,2,2,50.0,5,0,21,16,5,4,28,Las Palmas,27,Spain - La Liga
403,Pedro León Sánchez Gil,764,454.0,310,59.424083769633505,94,42,52,44.680851063829785,365,293,72,80.27397260273973,158,49,109,31.0126582278481,18.574250541004083,72,22,50,30.555555555555557,30,4,96,56,49,27,42,Getafe,31,Spain - La Liga
404,Pedro López Muñoz,707,550.0,157,77.7934936350778,91,46,45,50.54945054945055,309,274,35,88.67313915857605,73,28,45,38.35616438356164,18.813480818666818,28,6,22,21.428571428571427,3,0,31,19,13,8,22,Levante UD,17,Spain - La Liga
405,Pedro Mosquera Parada,1942,1593.0,349,82.02883625128733,308,193,115,62.66233766233766,1061,1002,59,94.43920829406221,246,137,109,55.6910569105691,20.55925811929013,6,1,5,16.666666666666664,19,2,23,14,4,3,56,RC Deportivo La Coruña,37,Spain - La Liga
406,Pedro Pablo Hernández,1495,1191.0,304,79.66555183946488,247,157,90,63.56275303643725,880,818,62,92.95454545454545,128,67,61,52.34375,18.269448498581394,8,1,7,12.5,10,3,48,33,9,6,118,Celta Vigo,33,Spain - La Liga
407,Pedro Taunausú Domínguez Placeres,1150,952.0,198,82.78260869565217,107,79,28,73.83177570093457,873,775,98,88.77434135166094,57,27,30,47.368421052631575,14.58867394764814,12,6,6,50.0,29,3,63,34,27,16,61,Las Palmas,27,Spain - La Liga
408,Petros Matheus dos Santos Araújo,1195,985.0,210,82.42677824267783,123,64,59,52.03252032520326,794,740,54,93.19899244332494,67,23,44,34.32835820895522,16.176155235642376,4,3,1,75.0,16,1,40,25,6,2,79,Real Betis,30,Spain - La Liga
409,Rachid Aït-Atmane,511,384.0,127,75.14677103718199,78,43,35,55.12820512820513,314,281,33,89.49044585987261,74,27,47,36.486486486486484,18.9119387885946,9,1,8,11.11111111111111,11,1,14,8,4,3,19,Sporting Gijón,18,Spain - La Liga
410,Rafael Alcântara do Nascimento,179,149.0,30,83.24022346368714,14,11,3,78.57142857142857,141,124,17,87.94326241134752,3,2,1,66.66666666666666,14.8331390454543,1,0,1,0.0,4,0,7,4,3,1,6,Barcelona,6,Spain - La Liga
411,Rafael van der Vaart,109,74.0,35,67.88990825688074,21,8,13,38.095238095238095,61,54,7,88.52459016393442,14,4,10,28.57142857142857,17.725908897485507,3,1,2,33.33333333333333,3,0,2,0,1,0,9,Real Betis,7,Spain - La Liga
412,Raphaël Varane,1258,1112.0,146,88.39427662957074,59,33,26,55.932203389830505,770,749,21,97.27272727272728,93,45,48,48.38709677419355,21.653254000749634,0,0,0,0.0,1,0,9,7,2,2,12,Real Madrid,26,Spain - La Liga
413,Raúl Albentosa Redal,1076,766.0,310,71.18959107806691,192,72,120,37.5,419,393,26,93.7947494033413,261,94,167,36.015325670498086,24.237324989650038,4,0,4,0.0,8,0,6,5,1,1,13,Málaga,29,Spain - La Liga
414,Raúl García Escudero,972,604.0,368,62.139917695473244,192,93,99,48.4375,493,394,99,79.91886409736308,59,17,42,28.8135593220339,15.869088782836295,28,4,24,14.285714285714285,17,6,45,21,20,6,87,Athletic Club,31,Spain - La Liga
415,Raúl Lizoáin Cruz,295,173.0,122,58.644067796610166,24,4,20,16.666666666666664,91,91,0,100.0,173,57,116,32.947976878612714,39.561839456136404,0,0,0,0.0,0,0,0,0,0,0,2,Las Palmas,8,Spain - La Liga
416,Rene Krhin,537,411.0,126,76.53631284916202,65,27,38,41.53846153846154,315,287,28,91.11111111111111,35,11,24,31.428571428571427,17.090182639848937,1,0,1,0.0,4,0,13,11,2,1,21,Granada,23,Spain - La Liga
417,Ricardo Jorge Luz Horta,299,231.0,68,77.25752508361204,27,19,8,70.37037037037037,200,174,26,87.0,23,8,15,34.78260869565217,15.501893965079597,9,4,5,44.44444444444444,7,0,29,16,19,8,8,Málaga,17,Spain - La Liga
418,Ricardo Miguel Moreira da Costa,453,369.0,84,81.45695364238411,43,15,28,34.883720930232556,215,209,6,97.20930232558139,70,28,42,40.0,23.871475542071522,0,0,0,0.0,1,0,1,1,1,1,3,Granada,14,Spain - La Liga
419,Ricky van Wolfswinkel,170,116.0,54,68.23529411764706,11,6,5,54.54545454545454,108,91,17,84.25925925925925,2,1,1,50.0,11.606745121236,5,3,2,60.0,4,2,5,4,4,3,13,Real Betis,17,Spain - La Liga
420,Robert Ibáñez Castro,200,159.0,41,79.5,7,4,3,57.14285714285714,141,126,15,89.36170212765957,11,3,8,27.27272727272727,12.7200184248348,11,1,10,9.090909090909092,7,1,21,11,13,6,27,Granada,18,Spain - La Liga
421,Roberto Antonio Correa Silva,283,223.0,60,78.79858657243817,30,17,13,56.666666666666664,161,141,20,87.5776397515528,21,7,14,33.33333333333333,16.08470345631689,3,0,3,0.0,1,0,5,1,2,0,4,Espanyol,7,Spain - La Liga
422,Roberto Canella Suárez,337,245.0,92,72.70029673590504,45,19,26,42.22222222222222,148,138,10,93.24324324324324,41,16,25,39.02439024390244,18.450984279127834,13,1,12,7.6923076923076925,2,0,5,3,2,1,9,Sporting Gijón,9,Spain - La Liga
423,Roberto José Rosales Altuve,1715,1238.0,477,72.1865889212828,247,149,98,60.32388663967612,750,655,95,87.33333333333333,271,114,157,42.066420664206646,19.70423325266169,101,17,84,16.831683168316832,16,3,53,27,20,8,40,Málaga,35,Spain - La Liga
424,Roberto Lago Soto,670,532.0,138,79.40298507462687,67,38,29,56.71641791044776,326,299,27,91.71779141104295,57,25,32,43.859649122807014,16.04409395430627,16,6,10,37.5,9,2,20,12,12,6,15,Getafe,17,Spain - La Liga
425,Roberto Román Triguero,1294,1009.0,285,77.97527047913447,124,68,56,54.83870967741935,633,592,41,93.52290679304897,122,34,88,27.86885245901639,18.020187013623023,33,11,22,33.33333333333333,14,3,25,13,18,8,39,Rayo Vallecano,29,Spain - La Liga
426,Roberto Soldado Rillo,818,548.0,270,66.99266503667481,98,44,54,44.89795918367347,497,385,112,77.46478873239437,32,13,19,40.625,14.744853586558825,19,5,14,26.31578947368421,18,10,46,23,25,11,70,Villarreal,28,Spain - La Liga
427,Roberto Suárez Pier,42,35.0,7,83.33333333333334,7,5,2,71.42857142857143,16,16,0,100.0,9,6,3,66.66666666666666,24.004181478822858,0,0,0,0.0,0,0,0,0,0,0,0,RC Deportivo La Coruña,2,Spain - La Liga
428,Roberto Trashorras Gayoso,2680,2190.0,490,81.71641791044776,409,259,150,63.325183374083124,1496,1397,99,93.38235294117648,451,229,222,50.77605321507761,21.414867330503284,59,18,41,30.508474576271187,57,7,59,34,26,11,84,Rayo Vallecano,36,Spain - La Liga
429,Rodrigo Hernández Cascante,75,66.0,9,88.0,9,5,4,55.55555555555556,54,52,2,96.29629629629629,5,1,4,20.0,18.2143708685184,0,0,0,0.0,1,0,1,0,0,0,1,Villarreal,3,Spain - La Liga
430,Rodrigo Javier De Paul,279,194.0,85,69.53405017921148,40,24,16,60.0,147,122,25,82.99319727891157,52,27,25,51.92307692307693,20.667473435181936,6,0,6,0.0,18,0,29,14,12,5,14,Valencia,9,Spain - La Liga
431,Rodrigo Moreno Machado,523,367.0,156,70.17208413001912,39,20,19,51.28205128205128,345,281,64,81.44927536231884,35,8,27,22.857142857142858,15.402760093021492,39,11,28,28.205128205128204,18,3,46,20,25,12,27,Valencia,25,Spain - La Liga
432,Roger Martí Salvador,130,78.0,52,60.0,14,7,7,50.0,81,59,22,72.8395061728395,2,0,2,0.0,13.306002179798769,3,2,1,66.66666666666666,6,0,9,6,4,2,11,Levante UD,16,Spain - La Liga
433,Roque Luis Santa Cruz Cantero,174,138.0,36,79.3103448275862,12,7,5,58.333333333333336,101,94,7,93.06930693069307,3,0,3,0.0,12.911127829957241,1,0,1,0.0,6,1,11,4,3,1,8,Málaga,17,Spain - La Liga
434,Roque Mesa Quevedo,2074,1802.0,272,86.88524590163934,200,148,52,74.0,1533,1428,105,93.15068493150685,105,51,54,48.57142857142857,16.79693103501813,9,2,7,22.22222222222222,14,2,67,39,20,7,65,Las Palmas,34,Spain - La Liga
435,Rubén Blanco Veiga,228,131.0,97,57.45614035087719,30,3,27,10.0,76,76,0,100.0,128,33,95,25.78125,42.36087913460211,0,0,0,0.0,0,0,0,0,0,0,2,Celta Vigo,8,Spain - La Liga
436,Rubén Castro Martín,1022,735.0,287,71.91780821917808,79,35,44,44.303797468354425,632,534,98,84.49367088607595,60,26,34,43.333333333333336,13.428368456343287,44,11,33,25.0,26,4,57,25,39,16,68,Real Betis,38,Spain - La Liga
437,Rubén Duarte Sánchez,871,628.0,243,72.10103329506315,95,45,50,47.368421052631575,371,336,35,90.56603773584906,121,42,79,34.710743801652896,18.588597695244456,44,12,32,27.27272727272727,9,1,10,4,7,2,22,Espanyol,22,Spain - La Liga
438,Rubén García Santos,464,309.0,155,66.59482758620689,37,21,16,56.75675675675676,256,204,52,79.6875,61,25,36,40.98360655737705,16.984160564775518,25,6,19,24.0,21,0,50,28,28,13,29,Levante UD,22,Spain - La Liga
439,Rubén Gracia Calmache,417,298.0,119,71.46282973621103,50,24,26,48.0,258,211,47,81.78294573643412,40,16,24,40.0,16.88106519121036,11,2,9,18.181818181818183,8,0,31,14,18,10,11,RC Deportivo La Coruña,18,Spain - La Liga
440,Rubén Iván Martínez Andrade,413,228.0,185,55.205811138014525,53,17,36,32.075471698113205,76,76,0,100.0,283,104,179,36.74911660777385,46.3839776509354,0,0,0,0.0,0,0,0,0,0,0,1,Levante UD,15,Spain - La Liga
441,Rubén Pardo Gutiérrez,1185,900.0,285,75.9493670886076,186,116,70,62.365591397849464,636,598,38,94.0251572327044,248,108,140,43.54838709677419,21.448410425580757,56,19,37,33.92857142857143,39,7,22,8,9,4,9,Real Sociedad,28,Spain - La Liga
442,Rubén Rochina Naixes,1327,882.0,445,66.46571213262999,311,168,143,54.019292604501615,641,548,93,85.49141965678628,307,122,185,39.73941368078176,22.123503180167113,38,6,32,15.789473684210526,39,6,107,71,33,19,96,Granada,35,Spain - La Liga
443,Rubén Salvador Pérez Del Mármol,1404,1062.0,342,75.64102564102564,239,137,102,57.32217573221757,721,659,62,91.40083217753121,204,86,118,42.15686274509804,21.465693016633846,11,4,7,36.36363636363637,22,2,34,24,7,4,40,Granada,31,Spain - La Liga
444,Rúben Miguel Nunes Vezo,506,371.0,135,73.3201581027668,56,29,27,51.78571428571429,246,217,29,88.21138211382113,60,28,32,46.666666666666664,21.582663221926957,6,2,4,33.33333333333333,3,0,10,5,4,1,10,Valencia,15,Spain - La Liga
445,Răzvan Dincă Raț,572,403.0,169,70.45454545454545,94,44,50,46.808510638297875,219,197,22,89.95433789954338,104,39,65,37.5,20.435880064478603,36,13,23,36.11111111111111,13,0,8,5,3,2,3,Rayo Vallecano,10,Spain - La Liga
446,Sabin Merino Zuloaga,323,210.0,113,65.01547987616098,27,7,20,25.925925925925924,181,151,30,83.42541436464089,18,7,11,38.88888888888889,14.020948517904891,26,6,20,23.076923076923077,10,0,40,16,23,10,10,Athletic Club,22,Spain - La Liga
447,Salvador Ruiz Rodríguez,41,35.0,6,85.36585365853658,5,3,2,60.0,22,22,0,100.0,3,0,3,0.0,15.934466876487804,0,0,0,0.0,0,0,2,0,0,0,1,Granada,2,Spain - La Liga
448,Salvador Sevilla López,332,276.0,56,83.13253012048193,36,27,9,75.0,243,221,22,90.94650205761316,31,13,18,41.935483870967744,17.03967660448265,5,2,3,40.0,11,0,4,4,3,3,11,Espanyol,15,Spain - La Liga
449,Samuel Castillejo Azuaga,690,452.0,238,65.5072463768116,57,27,30,47.368421052631575,417,339,78,81.29496402877699,81,19,62,23.456790123456788,17.239881865607998,49,12,37,24.489795918367346,22,1,84,35,46,21,52,Villarreal,28,Spain - La Liga
450,Samuel García Sánchez,364,246.0,118,67.58241758241759,35,18,17,51.42857142857142,223,187,36,83.85650224215246,23,4,19,17.391304347826086,14.503982435007034,20,3,17,15.0,11,1,21,15,13,9,15,Villarreal,16,Spain - La Liga
451,Sandro Ramírez Castillo,91,72.0,19,79.12087912087912,8,7,1,87.5,63,56,7,88.88888888888889,4,1,3,25.0,13.110999530138903,6,0,6,0.0,4,1,8,2,5,1,7,Barcelona,10,Spain - La Liga
452,Santiago Mina Lorenzo,558,406.0,152,72.75985663082437,47,23,24,48.93617021276596,353,303,50,85.8356940509915,26,8,18,30.76923076923077,14.462433763137419,25,7,18,28.000000000000004,9,1,61,18,35,9,55,Valencia,26,Spain - La Liga
453,Santiago Vergini,927,770.0,157,83.06364617044228,89,38,51,42.69662921348314,514,497,17,96.69260700389106,146,62,84,42.465753424657535,22.22230833309825,0,0,0,0.0,1,0,15,10,2,1,7,Getafe,26,Spain - La Liga
454,Saúl Berjón Pérez,684,392.0,292,57.30994152046783,76,33,43,43.42105263157895,283,201,82,71.02473498233216,149,58,91,38.92617449664429,20.66523916607684,53,11,42,20.754716981132077,34,4,60,17,42,11,12,Eibar,29,Spain - La Liga
455,Saúl Ñíguez Esclapez,1144,878.0,266,76.74825174825175,150,101,49,67.33333333333333,702,625,77,89.03133903133903,65,25,40,38.46153846153847,14.733755633867474,27,7,20,25.925925925925924,18,2,61,27,20,6,32,Atlético Madrid,31,Spain - La Liga
456,Sebastián Carlos Cristóforo Pepe,812,698.0,114,85.96059113300493,90,62,28,68.88888888888889,565,529,36,93.6283185840708,55,28,27,50.90909090909091,17.055827109194187,4,1,3,25.0,3,1,19,14,5,3,55,Sevilla,21,Spain - La Liga
457,Sergi Darder Moll,40,34.0,6,85.0,11,9,2,81.81818181818183,26,23,3,88.46153846153845,6,4,2,66.66666666666666,19.41744165399,1,1,0,100.0,1,0,3,3,1,1,1,Málaga,1,Spain - La Liga
458,Sergi Gómez Solà,1542,1320.0,222,85.60311284046692,106,35,71,33.0188679245283,1036,1013,23,97.77992277992279,157,36,121,22.929936305732486,21.436471667145995,0,0,0,0.0,3,1,5,4,0,0,9,Celta Vigo,31,Spain - La Liga
459,Sergi Roberto Carnicer,1372,1196.0,176,87.17201166180757,105,80,25,76.19047619047619,978,919,59,93.96728016359918,49,24,25,48.97959183673469,15.035492355363498,33,9,24,27.27272727272727,12,5,45,31,23,15,26,Barcelona,31,Spain - La Liga
460,Sergi Samper Montaña,26,22.0,4,84.61538461538461,0,0,0,0.0,19,19,0,100.0,0,0,0,0.0,15.824785981126153,0,0,0,0.0,0,0,0,0,0,0,0,Barcelona,1,Spain - La Liga
461,Sergio Asenjo Andrés,105,60.0,45,57.14285714285714,9,2,7,22.22222222222222,19,19,0,100.0,80,37,43,46.25,47.259696276891425,0,0,0,0.0,0,0,0,0,0,0,0,Villarreal,4,Spain - La Liga
462,Sergio Busquets i Burgos,2406,2182.0,224,90.68994181213633,293,237,56,80.88737201365188,1637,1581,56,96.5791081246182,182,154,28,84.61538461538461,17.619963111482992,4,3,1,75.0,13,5,30,21,9,4,82,Barcelona,35,Spain - La Liga
463,Sergio Canales Madrazo,511,391.0,120,76.51663405088063,38,24,14,63.1578947368421,337,298,39,88.4272997032641,39,14,25,35.8974358974359,15.601901571157104,33,8,25,24.242424242424242,10,0,10,1,6,0,17,Real Sociedad,16,Spain - La Liga
464,Sergio Enrich Ametller,857,582.0,275,67.91131855309219,91,29,62,31.868131868131865,388,324,64,83.50515463917526,22,12,10,54.54545454545454,12.664088254711112,18,7,11,38.88888888888889,21,7,44,22,28,14,60,Eibar,38,Spain - La Liga
465,Sergio Escudero Palomo,658,476.0,182,72.3404255319149,72,40,32,55.55555555555556,333,292,41,87.68768768768768,75,30,45,40.0,17.495398798318174,43,13,30,30.23255813953488,16,0,22,14,13,8,23,Sevilla,15,Spain - La Liga
466,Sergio Ezequiel Araújo,524,380.0,144,72.51908396946564,50,21,29,42.0,306,259,47,84.640522875817,15,6,9,40.0,12.900757553188626,6,3,3,50.0,16,3,52,26,30,13,24,Las Palmas,30,Spain - La Liga
467,Sergio Gontán Gallardo,920,597.0,323,64.89130434782608,87,46,41,52.87356321839081,504,397,107,78.76984126984127,95,36,59,37.89473684210527,17.095856050767914,104,34,70,32.69230769230769,38,3,82,40,43,20,69,Eibar,29,Spain - La Liga
468,Sergio Mendigutxia Iglesias,8,5.0,3,62.5,1,0,1,0.0,1,1,0,100.0,0,0,0,0.0,9.91882565253,0,0,0,0.0,0,0,1,0,0,0,2,Sporting Gijón,1,Spain - La Liga
469,Sergio Ramos García,1299,1160.0,139,89.2994611239415,139,95,44,68.34532374100719,860,838,22,97.44186046511628,134,71,63,52.98507462686567,20.14589268738402,4,2,2,50.0,6,1,4,3,1,0,30,Real Madrid,23,Spain - La Liga
470,Sergio Rico González,1020,678.0,342,66.47058823529412,61,17,44,27.86885245901639,371,369,2,99.46091644204851,553,219,334,39.602169981916816,39.16493022358447,0,0,0,0.0,0,0,0,0,0,0,8,Sevilla,34,Spain - La Liga
471,Sergio Álvarez Conde,1001,584.0,417,58.341658341658345,101,24,77,23.762376237623762,300,299,1,99.66666666666667,610,202,408,33.114754098360656,42.619140043222295,0,0,0,0.0,0,0,0,0,0,0,1,Celta Vigo,31,Spain - La Liga
472,Sergio Álvarez Díaz,1100,832.0,268,75.63636363636364,143,75,68,52.44755244755245,646,587,59,90.86687306501547,96,33,63,34.375,18.19872637216527,9,3,6,33.33333333333333,13,2,33,25,6,3,39,Sporting Gijón,27,Spain - La Liga
473,Shkodran Mustafi,1489,1206.0,283,80.99395567494963,156,87,69,55.769230769230774,771,726,45,94.16342412451361,215,95,120,44.18604651162791,23.24317571693238,1,0,1,0.0,3,0,14,7,2,0,22,Valencia,30,Spain - La Liga
474,Sidnei Rechel da Silva Júnior,1272,986.0,286,77.51572327044025,194,88,106,45.36082474226804,589,547,42,92.86926994906621,219,83,136,37.89954337899543,24.271466699300376,3,0,3,0.0,5,0,23,15,2,1,23,RC Deportivo La Coruña,33,Spain - La Liga
475,Simone Verdi,84,66.0,18,78.57142857142857,13,10,3,76.92307692307693,43,37,6,86.04651162790698,9,4,5,44.44444444444444,15.484587498486857,4,0,4,0.0,5,0,11,5,7,2,10,Eibar,9,Spain - La Liga
476,Simão Mate,998,762.0,236,76.35270541082164,128,62,66,48.4375,508,482,26,94.88188976377953,107,38,69,35.51401869158878,19.505944265688576,0,0,0,0.0,3,0,14,9,1,1,38,Levante UD,30,Spain - La Liga
477,Sofiane Feghouli,573,359.0,214,62.652705061082024,71,35,36,49.29577464788733,298,250,48,83.89261744966443,75,25,50,33.33333333333333,18.12535538395602,63,18,45,28.57142857142857,28,1,41,14,21,4,24,Valencia,21,Spain - La Liga
478,Stefan Savić,393,306.0,87,77.86259541984732,40,14,26,35.0,193,187,6,96.89119170984456,70,21,49,30.0,23.576500085377095,1,0,1,0.0,0,0,1,1,0,0,5,Atlético Madrid,12,Spain - La Liga
479,Stefan Šćepović,492,341.0,151,69.3089430894309,46,13,33,28.26086956521739,271,221,50,81.54981549815497,17,11,6,64.70588235294117,12.166493845346341,10,4,6,40.0,20,1,19,7,10,3,43,Getafe,34,Spain - La Liga
480,Steven N''Kemboanza Mike Christopher Nzonzi,969,760.0,209,78.43137254901961,128,69,59,53.90625,596,563,33,94.46308724832215,79,33,46,41.77215189873418,18.46826106394031,13,5,8,38.46153846153847,9,1,17,11,4,2,17,Sevilla,28,Spain - La Liga
481,Stipe Pletikosa,61,31.0,30,50.81967213114754,5,0,5,0.0,7,7,0,100.0,45,17,28,37.77777777777778,46.95197775314754,0,0,0,0.0,0,0,0,0,0,0,0,RC Deportivo La Coruña,2,Spain - La Liga
482,Sérgio Paulo Barbosa Valente,730,446.0,284,61.09589041095891,144,78,66,54.166666666666664,386,310,76,80.31088082901555,137,34,103,24.817518248175183,20.042839104849865,45,9,36,20.0,35,1,46,26,15,5,48,Málaga,27,Spain - La Liga
483,Takashi Inui,565,387.0,178,68.49557522123894,53,27,26,50.943396226415096,364,294,70,80.76923076923077,67,19,48,28.35820895522388,16.42159131985147,44,14,30,31.818181818181817,20,3,45,28,34,19,22,Eibar,27,Spain - La Liga
484,Thievy Guivane Bifouma Koulossa,70,52.0,18,74.28571428571429,5,3,2,60.0,45,35,10,77.77777777777779,3,1,2,33.33333333333333,13.562930294310858,1,0,1,0.0,2,0,13,6,12,5,5,Granada,7,Spain - La Liga
485,Thomas Teye Partey,216,166.0,50,76.85185185185185,21,10,11,47.61904761904761,152,128,24,84.21052631578947,7,4,3,57.14285714285714,14.34077947434,9,3,6,33.33333333333333,6,1,16,12,5,5,6,Atlético Madrid,13,Spain - La Liga
486,Thomas Vermaelen,347,318.0,29,91.64265129682997,13,10,3,76.92307692307693,234,232,2,99.14529914529915,19,5,14,26.31578947368421,21.04971528795458,0,0,0,0.0,0,0,0,0,0,0,7,Barcelona,10,Spain - La Liga
487,Théo Bongonda Mbul''Ofeko Batombo,335,243.0,92,72.53731343283583,31,18,13,58.06451612903226,244,207,37,84.8360655737705,18,8,10,44.44444444444444,13.978041615312716,17,4,13,23.52941176470588,10,1,56,21,25,7,36,Celta Vigo,22,Spain - La Liga
488,Tiago Cardoso Mendes,775,654.0,121,84.38709677419355,101,71,30,70.29702970297029,485,459,26,94.63917525773195,72,47,25,65.27777777777779,17.55654486222658,1,0,1,0.0,4,2,1,0,0,0,19,Atlético Madrid,14,Spain - La Liga
489,Tiago Manuel Dias Correia,842,525.0,317,62.35154394299287,60,32,28,53.333333333333336,402,330,72,82.08955223880598,123,38,85,30.89430894308943,18.1797113616663,111,32,79,28.82882882882883,24,6,111,60,56,31,25,Rayo Vallecano,34,Spain - La Liga
490,Timothée Kolodziejczak,1262,1033.0,229,81.8541996830428,159,78,81,49.056603773584904,753,714,39,94.82071713147411,168,72,96,42.857142857142854,22.034680870968685,8,4,4,50.0,4,0,8,5,3,0,10,Sevilla,29,Spain - La Liga
491,Tomás Pina Isla,761,598.0,163,78.580814717477,93,55,38,59.13978494623656,475,426,49,89.6842105263158,42,21,21,50.0,16.715336289242522,2,1,1,50.0,6,1,6,6,1,1,32,Villarreal,27,Spain - La Liga
492,Toni Kroos,2552,2330.0,222,91.30094043887146,299,257,42,85.95317725752508,1747,1689,58,96.68002289639381,330,226,104,68.48484848484848,20.073679045986584,32,9,23,28.125,46,9,28,19,9,7,58,Real Madrid,32,Spain - La Liga
493,Uche Henry Agbo,105,88.0,17,83.80952380952381,8,5,3,62.5,79,69,10,87.34177215189874,4,1,3,25.0,16.250337305712,0,0,0,0.0,0,0,1,1,0,0,4,Granada,6,Spain - La Liga
494,Vicente Guaita Panadero,1153,609.0,544,52.818733738074584,185,36,149,19.45945945945946,232,232,0,100.0,786,252,534,32.06106870229007,47.46903587530002,0,0,0,0.0,2,0,1,1,0,0,4,Getafe,38,Spain - La Liga
495,Vicente Iborra De La Fuente,650,442.0,208,68.0,86,34,52,39.53488372093023,303,262,41,86.46864686468648,35,18,17,51.42857142857142,15.887640760807017,13,4,9,30.76923076923077,11,2,11,6,2,1,28,Sevilla,29,Spain - La Liga
496,Vincenzo Renato Rennella,59,35.0,24,59.32203389830508,10,2,8,20.0,25,22,3,88.0,2,1,1,50.0,13.6942792866061,3,1,2,33.33333333333333,3,0,6,2,3,1,5,Real Betis,6,Spain - La Liga
497,Víctor Camarasa Ferrando,1098,917.0,181,83.51548269581056,118,86,32,72.88135593220339,730,686,44,93.97260273972603,76,44,32,57.89473684210527,16.70481148494164,13,5,8,38.46153846153847,18,3,48,25,22,10,32,Levante UD,34,Spain - La Liga
498,Víctor Casadesús Castaño,387,262.0,125,67.70025839793283,53,27,26,50.943396226415096,201,163,38,81.09452736318407,19,14,5,73.68421052631578,14.674516967250232,7,0,7,0.0,11,1,19,15,12,8,16,Levante UD,23,Spain - La Liga
499,Víctor Guillermo Álvarez Delgado,757,510.0,247,67.37120211360634,110,63,47,57.27272727272727,381,321,60,84.25196850393701,88,27,61,30.681818181818183,17.420246514048507,28,7,21,25.0,12,2,54,26,14,7,34,Espanyol,27,Spain - La Liga
500,Víctor Machín Pérez,816,592.0,224,72.54901960784314,54,33,21,61.111111111111114,582,465,117,79.89690721649485,28,10,18,35.714285714285715,14.036138159528912,43,14,29,32.55813953488372,33,4,82,40,49,24,70,Sevilla,28,Spain - La Liga
501,Víctor Rodríguez Romero,1042,863.0,179,82.82149712092131,74,56,18,75.67567567567568,742,672,70,90.56603773584906,39,13,26,33.33333333333333,14.36374455380361,25,8,17,32.0,21,1,67,34,45,23,43,Getafe,33,Spain - La Liga
502,Víctor Ruíz Torre,1570,1256.0,314,80.0,212,82,130,38.67924528301887,880,834,46,94.77272727272728,219,69,150,31.506849315068493,23.37523605111889,1,0,1,0.0,0,0,7,6,1,1,15,Villarreal,35,Spain - La Liga
503,Víctor Sánchez Mata,1034,788.0,246,76.20889748549324,140,68,72,48.57142857142857,635,565,70,88.9763779527559,110,41,69,37.27272727272727,17.33735032283002,18,4,14,22.22222222222222,17,5,34,27,15,9,45,Espanyol,29,Spain - La Liga
504,Wanderson Maciel Sousa Campos,262,193.0,69,73.66412213740458,18,12,6,66.66666666666666,180,161,19,89.44444444444444,21,5,16,23.809523809523807,15.080846555008856,20,5,15,25.0,7,0,47,31,20,13,22,Getafe,20,Spain - La Liga
505,Weligton Róbson Pena de Oliveira,1191,862.0,329,72.37615449202352,190,71,119,37.368421052631575,531,507,24,95.48022598870057,269,92,177,34.20074349442379,24.23470101608282,3,1,2,33.33333333333333,4,2,4,2,0,0,26,Málaga,30,Spain - La Liga
506,Wilfried Aimeric Zahibo,62,45.0,17,72.58064516129032,5,4,1,80.0,36,32,4,88.88888888888889,4,2,2,50.0,15.033489324015484,0,0,0,0.0,1,0,1,0,1,0,1,Valencia,2,Spain - La Liga
507,Willian José da Silva,550,406.0,144,73.81818181818181,51,24,27,47.05882352941176,324,279,45,86.11111111111111,39,21,18,53.84615384615385,15.23658149088349,14,3,11,21.428571428571427,20,1,39,26,18,11,36,Las Palmas,30,Spain - La Liga
508,Xabier Etxeita Gorritxategi,1193,944.0,249,79.12824811399832,121,45,76,37.1900826446281,659,617,42,93.62670713201821,180,66,114,36.666666666666664,21.824406654492673,1,0,1,0.0,4,1,6,6,0,0,7,Athletic Club,30,Spain - La Liga
509,Xabier Iruretagoiena Aranzamendi,112,53.0,59,47.32142857142857,29,7,22,24.137931034482758,9,9,0,100.0,89,31,58,34.831460674157306,53.09666982970714,0,0,0,0.0,0,0,0,0,0,0,0,Eibar,4,Spain - La Liga
510,Xabier Prieto Argarate,1284,969.0,315,75.46728971962617,156,102,54,65.38461538461539,711,628,83,88.32630098452883,88,45,43,51.13636363636363,15.243977811485607,62,21,41,33.87096774193548,32,3,40,21,20,6,66,Real Sociedad,36,Spain - La Liga
511,Xavier Torres Buigues,316,244.0,72,77.21518987341773,36,18,18,50.0,176,165,11,93.75,32,14,18,43.75,20.483092523410633,2,0,2,0.0,3,0,2,2,1,1,12,Real Betis,12,Spain - La Liga
512,Yannick Ferreira Carrasco,812,617.0,195,75.98522167487684,43,28,15,65.11627906976744,587,510,77,86.88245315161839,51,13,38,25.49019607843137,13.902372399676256,44,7,37,15.909090909090908,19,1,116,67,71,40,32,Atlético Madrid,29,Spain - La Liga
513,Yevhen Konoplyanka,725,483.0,242,66.62068965517241,39,26,13,66.66666666666666,386,332,54,86.01036269430051,121,42,79,34.710743801652896,17.110600848639557,106,27,79,25.471698113207548,35,4,75,42,48,27,30,Sevilla,32,Spain - La Liga
514,Yoel Rodríguez Oterino,354,227.0,127,64.12429378531074,31,7,24,22.58064516129032,119,118,1,99.15966386554622,176,57,119,32.38636363636363,40.72949602580949,0,0,0,0.0,1,0,0,0,0,0,2,Rayo Vallecano,10,Spain - La Liga
515,Youssef El-Arabi,643,432.0,211,67.18506998444789,93,43,50,46.236559139784944,342,279,63,81.57894736842105,41,19,22,46.34146341463415,15.388784343494818,19,9,10,47.368421052631575,21,1,64,37,32,18,54,Granada,35,Spain - La Liga
516,Yuri Berchiche Izeta,1189,889.0,300,74.76871320437343,147,103,44,70.06802721088435,554,476,78,85.92057761732852,98,34,64,34.69387755102041,16.799177044633232,73,15,58,20.54794520547945,13,4,28,13,12,4,26,Real Sociedad,21,Spain - La Liga
517,Zakaria Bakkali,228,160.0,68,70.17543859649122,13,8,5,61.53846153846154,131,113,18,86.25954198473282,32,9,23,28.125,16.69142429017263,30,8,22,26.666666666666668,9,3,31,19,17,11,19,Valencia,16,Spain - La Liga
518,Zouhair Feddal,1137,848.0,289,74.58223394898856,186,81,105,43.54838709677419,471,447,24,94.90445859872611,279,115,164,41.21863799283154,25.52894401588781,0,0,0,0.0,5,1,9,9,1,1,16,Levante UD,28,Spain - La Liga
519,Álvaro Arbeloa Coca,168,141.0,27,83.92857142857143,11,8,3,72.72727272727273,102,95,7,93.13725490196079,5,3,2,60.0,14.036854452814286,2,0,2,0.0,1,0,1,1,0,0,1,Real Madrid,6,Spain - La Liga
520,Álvaro Cejudo Carmona,784,526.0,258,67.09183673469387,83,36,47,43.373493975903614,426,356,70,83.56807511737088,121,35,86,28.92561983471074,17.433277846786837,49,11,38,22.448979591836736,21,2,78,38,32,15,49,Real Betis,30,Spain - La Liga
521,Álvaro Daniel Pereira Barragán,189,123.0,66,65.07936507936508,33,15,18,45.45454545454545,67,57,10,85.07462686567165,40,15,25,37.5,20.718673832838096,5,3,2,60.0,3,0,2,0,2,0,1,Getafe,6,Spain - La Liga
522,Álvaro González Soberón,1528,1139.0,389,74.54188481675392,284,131,153,46.12676056338028,706,667,39,94.47592067988668,328,122,206,37.19512195121951,24.285435082411098,12,4,8,33.33333333333333,10,1,11,9,0,0,35,Espanyol,36,Spain - La Liga
523,Álvaro Medrán Just,614,502.0,112,81.75895765472313,106,66,40,62.264150943396224,375,349,26,93.06666666666666,64,30,34,46.875,19.55349253805746,2,0,2,0.0,7,1,30,16,7,3,29,Getafe,20,Spain - La Liga
524,Álvaro Negredo Sánchez,357,233.0,124,65.26610644257703,49,21,28,42.857142857142854,142,110,32,77.46478873239437,16,11,5,68.75,13.91013558191395,4,1,3,25.0,12,2,23,13,13,7,17,Valencia,25,Spain - La Liga
525,Álvaro Vadillo Cifuentes,36,32.0,4,88.88888888888889,1,1,0,100.0,28,27,1,96.42857142857143,0,0,0,0.0,13.10555328084,2,1,1,50.0,2,0,4,2,3,1,3,Real Betis,3,Spain - La Liga
526,Álvaro Vázquez García,415,280.0,135,67.46987951807229,26,7,19,26.923076923076923,259,206,53,79.53667953667953,19,8,11,42.10526315789473,13.519911609109302,24,12,12,50.0,20,4,37,13,19,6,34,Getafe,34,Spain - La Liga
527,Ángel Domingo López Ruano,28,25.0,3,89.28571428571429,2,2,0,100.0,18,16,2,88.88888888888889,2,2,0,100.0,17.431858742657145,0,0,0,0.0,0,0,0,0,0,0,0,Las Palmas,3,Spain - La Liga
528,Ángel Lafita Castillo,276,177.0,99,64.13043478260869,38,21,17,55.26315789473685,151,124,27,82.11920529801324,25,7,18,28.000000000000004,14.44106198904,15,4,11,26.666666666666668,7,2,40,16,20,6,24,Getafe,14,Spain - La Liga
529,Ángel Martín Correa,354,236.0,118,66.66666666666666,37,16,21,43.24324324324324,233,177,56,75.9656652360515,24,11,13,45.83333333333333,15.17443109233627,14,4,10,28.57142857142857,14,3,65,32,48,23,31,Atlético Madrid,26,Spain - La Liga
530,Ángel Montoro Sánchez,325,274.0,51,84.3076923076923,33,22,11,66.66666666666666,216,198,18,91.66666666666666,38,24,14,63.1578947368421,19.369051629166524,6,2,4,33.33333333333333,6,0,4,2,1,1,7,Las Palmas,9,Spain - La Liga
531,Ángel Trujillo Canorea,190,146.0,44,76.84210526315789,24,8,16,33.33333333333333,107,105,2,98.13084112149532,24,7,17,29.166666666666668,21.120851842673684,0,0,0,0.0,0,0,1,1,1,1,2,Levante UD,8,Spain - La Liga
532,Éver Maximiliano David Banega,1258,964.0,294,76.6295707472178,222,142,80,63.96396396396396,737,664,73,90.09497964721845,194,82,112,42.2680412371134,20.600624737805724,44,11,33,25.0,38,2,100,69,42,25,63,Sevilla,25,Spain - La Liga
533,Íñigo Lekue Martínez,594,441.0,153,74.24242424242425,32,20,12,62.5,317,282,35,88.95899053627761,60,19,41,31.666666666666664,16.37367460320606,43,14,29,32.55813953488372,11,0,46,18,23,8,10,Athletic Club,20,Spain - La Liga
534,Íñigo Martínez Berridi,1453,1135.0,318,78.11424638678595,236,123,113,52.118644067796616,772,737,35,95.46632124352331,228,72,156,31.57894736842105,22.912042161159476,1,0,1,0.0,2,0,17,12,3,0,27,Real Sociedad,30,Spain - La Liga
535,Óliver Torres Muñoz,511,414.0,97,81.01761252446184,66,48,18,72.72727272727273,347,304,43,87.60806916426513,36,18,18,50.0,15.683617902039922,8,3,5,37.5,13,2,21,16,10,7,17,Atlético Madrid,21,Spain - La Liga
536,Óscar Esau Duarte Gaitán,468,349.0,119,74.57264957264957,66,30,36,45.45454545454545,215,209,6,97.20930232558139,90,36,54,40.0,21.988547578667692,1,0,1,0.0,1,1,2,2,0,0,5,Espanyol,14,Spain - La Liga
537,Óscar de Marcos Arana,1618,1180.0,438,72.92954264524104,185,98,87,52.972972972972975,714,592,122,82.91316526610645,173,63,110,36.41618497109826,17.81428423505776,80,26,54,32.5,16,3,64,27,36,14,23,Athletic Club,34,Spain - La Liga
0,Aaron Hunt,870,625.0,245,71.83908045977012,98,57,41,58.16326530612245,509,427,82,83.88998035363457,101,42,59,41.584158415841586,18.020298302589353,30,8,22,26.666666666666668,35,2,37,25,20,13,47,Hamburger SV,23,Germany - 1. Bundesliga
1,Adam Hloušek,206,157.0,49,76.2135922330097,39,17,22,43.58974358974359,86,85,1,98.83720930232558,52,23,29,44.230769230769226,24.761701529860197,1,0,1,0.0,0,0,1,1,0,0,5,VfB Stuttgart,7,Germany - 1. Bundesliga
2,Adelino André Vieira Freitas,1304,977.0,327,74.92331288343557,182,120,62,65.93406593406593,687,607,80,88.35516739446871,219,106,113,48.401826484018265,19.91045528498098,72,17,55,23.61111111111111,31,5,37,24,13,6,59,Wolfsburg,26,Germany - 1. Bundesliga
3,Admir Mehmedi,564,424.0,140,75.177304964539,50,29,21,57.99999999999999,397,332,65,83.6272040302267,39,14,25,35.8974358974359,14.449669407852127,25,12,13,48.0,27,5,44,32,25,19,22,Bayer Leverkusen,28,Germany - 1. Bundesliga
4,Adnan Januzaj,57,42.0,15,73.68421052631578,4,4,0,100.0,37,31,6,83.78378378378379,9,4,5,44.44444444444444,17.77773959143579,4,1,3,25.0,5,2,7,5,6,5,5,Borussia Dortmund,6,Germany - 1. Bundesliga
5,Ahmet Metin Arslan,1,1.0,0,100.0,1,1,0,100.0,0,0,0,0.0,0,0,0,0.0,16.3165974912,0,0,0,0.0,0,0,0,0,0,0,0,Hamburger SV,1,Germany - 1. Bundesliga
6,Albian Afrim Ajeti,8,6.0,2,75.0,0,0,0,0.0,5,4,1,80.0,0,0,0,0.0,11.41503544395,0,0,0,0.0,0,0,0,0,0,0,0,Augsburg,1,Germany - 1. Bundesliga
7,Albin Ekdal,591,460.0,131,77.834179357022,85,51,34,60.0,365,336,29,92.05479452054794,37,14,23,37.83783783783784,17.08649624379655,1,0,1,0.0,5,0,9,4,2,2,39,Hamburger SV,14,Germany - 1. Bundesliga
8,Alejandro Gálvez Jimena,513,383.0,130,74.6588693957115,92,43,49,46.73913043478261,202,189,13,93.56435643564357,117,57,60,48.717948717948715,25.19909048947228,2,1,1,50.0,0,0,3,2,0,0,7,Werder Bremen,21,Germany - 1. Bundesliga
9,Aleksandar Ignjovski,568,379.0,189,66.72535211267606,64,34,30,53.125,281,231,50,82.20640569395017,54,13,41,24.074074074074073,17.295784855296464,34,10,24,29.411764705882355,7,1,34,15,16,7,29,Eintracht Frankfurt,18,Germany - 1. Bundesliga
10,Alessandro Schöpf,176,128.0,48,72.72727272727273,21,11,10,52.38095238095239,115,96,19,83.47826086956522,11,7,4,63.63636363636363,14.363454571576364,9,3,6,33.33333333333333,7,1,24,8,7,1,12,Schalke 04,13,Germany - 1. Bundesliga
11,Alexander Baumjohann,230,162.0,68,70.43478260869566,25,14,11,56.00000000000001,171,137,34,80.11695906432749,4,0,4,0.0,13.96958796663339,5,2,3,40.0,13,2,23,14,15,7,18,Hertha Berlin,24,Germany - 1. Bundesliga
12,Alexander Esswein,568,377.0,191,66.37323943661971,33,17,16,51.515151515151516,334,268,66,80.23952095808383,50,15,35,30.0,16.051919969920565,66,18,48,27.27272727272727,29,1,58,30,34,18,37,Augsburg,29,Germany - 1. Bundesliga
13,Alexander Hack,372,311.0,61,83.60215053763442,36,19,17,52.77777777777778,202,188,14,93.06930693069307,55,26,29,47.27272727272727,22.82531980978839,0,0,0,0.0,0,0,7,6,0,0,4,FSV Mainz 05,7,Germany - 1. Bundesliga
14,Alexander Manninger,36,25.0,11,69.44444444444444,3,1,2,33.33333333333333,12,12,0,100.0,22,11,11,50.0,43.533647756,0,0,0,0.0,0,0,0,0,0,0,0,Augsburg,2,Germany - 1. Bundesliga
15,Alexander Meier,483,321.0,162,66.45962732919256,65,30,35,46.15384615384615,216,182,34,84.25925925925925,21,12,9,57.14285714285714,15.4306537117759,3,1,2,33.33333333333333,16,1,12,7,5,2,12,Eintracht Frankfurt,19,Germany - 1. Bundesliga
16,Alexander Milosevic,340,277.0,63,81.47058823529412,43,19,24,44.18604651162791,189,181,8,95.76719576719577,47,16,31,34.04255319148936,20.209896650484,0,0,0,0.0,0,0,0,0,0,0,4,Hannover 96,10,Germany - 1. Bundesliga
17,Alexandru Iulian Maxim,627,456.0,171,72.72727272727273,72,43,29,59.72222222222222,357,310,47,86.83473389355743,108,44,64,40.74074074074074,18.037280700021817,27,11,16,40.74074074074074,29,5,30,17,15,6,18,VfB Stuttgart,25,Germany - 1. Bundesliga
18,Alfredo Morales,526,303.0,223,57.60456273764258,100,41,59,41.0,218,174,44,79.81651376146789,63,15,48,23.809523809523807,17.295888003673003,21,3,18,14.285714285714285,9,1,42,21,22,8,54,Ingolstadt,24,Germany - 1. Bundesliga
19,Alfreð Finnbogason,292,203.0,89,69.52054794520548,19,7,12,36.84210526315789,158,119,39,75.31645569620254,8,3,5,37.5,13.472467796330136,6,0,6,0.0,12,1,23,11,20,8,12,Augsburg,14,Germany - 1. Bundesliga
20,Allan Saint-Maximin,137,87.0,50,63.503649635036496,12,3,9,25.0,91,69,22,75.82417582417582,8,4,4,50.0,14.815434405825986,7,3,4,42.857142857142854,4,0,30,18,15,7,9,Hannover 96,16,Germany - 1. Bundesliga
21,Almog Cohen,275,181.0,94,65.81818181818181,57,20,37,35.08771929824561,125,106,19,84.8,26,9,17,34.61538461538461,16.831163361089455,1,1,0,100.0,4,1,6,3,2,1,14,Ingolstadt,20,Germany - 1. Bundesliga
22,Andre Hoffmann,312,244.0,68,78.2051282051282,42,26,16,61.904761904761905,215,193,22,89.76744186046511,21,5,16,23.809523809523807,16.759294128323077,0,0,0,0.0,1,0,5,3,1,0,4,Hannover 96,8,Germany - 1. Bundesliga
23,Andreas Christensen,1807,1596.0,211,88.32318760376315,115,62,53,53.91304347826087,1218,1185,33,97.29064039408867,104,33,71,31.73076923076923,20.239556713884934,1,1,0,100.0,1,1,7,6,0,0,26,Borussia Mönchengladbach,31,Germany - 1. Bundesliga
24,Andreas Hirzel,21,11.0,10,52.38095238095239,4,1,3,25.0,3,3,0,100.0,17,7,10,41.17647058823529,45.83100461996572,0,0,0,0.0,0,0,0,0,0,0,0,Hamburger SV,1,Germany - 1. Bundesliga
25,Andrej Kramarić,336,253.0,83,75.29761904761905,28,19,9,67.85714285714286,230,202,28,87.82608695652175,24,12,12,50.0,14.983987357521428,15,6,9,40.0,7,2,32,26,21,17,15,Hoffenheim,15,Germany - 1. Bundesliga
26,André Hahn,267,153.0,114,57.30337078651685,25,11,14,44.0,131,101,30,77.09923664122137,18,3,15,16.666666666666664,13.927809119722246,12,1,11,8.333333333333332,5,0,12,3,9,3,18,Borussia Mönchengladbach,15,Germany - 1. Bundesliga
27,André Ramalho Silva,612,499.0,113,81.5359477124183,61,21,40,34.42622950819672,294,286,8,97.27891156462584,89,30,59,33.70786516853933,22.424659327555293,1,0,1,0.0,1,0,5,5,0,0,8,Bayer Leverkusen,19,Germany - 1. Bundesliga
28,André Schürrle,732,570.0,162,77.8688524590164,36,23,13,63.888888888888886,516,451,65,87.40310077519379,32,12,20,37.5,14.604650632535408,38,10,28,26.31578947368421,18,3,74,34,41,20,31,Wolfsburg,29,Germany - 1. Bundesliga
29,Anthony Modeste,618,374.0,244,60.517799352750814,117,46,71,39.31623931623932,261,215,46,82.37547892720306,20,8,12,40.0,14.668934162002717,8,1,7,12.5,15,3,40,13,18,2,79,FC Köln,34,Germany - 1. Bundesliga
30,Anthony Ujah,593,359.0,234,60.53962900505903,85,40,45,47.05882352941176,271,228,43,84.13284132841329,12,5,7,41.66666666666667,13.02775335666601,14,4,10,28.57142857142857,18,0,32,16,20,7,37,Werder Bremen,32,Germany - 1. Bundesliga
31,Arianit Ferati,46,36.0,10,78.26086956521739,10,6,4,60.0,30,28,2,93.33333333333333,5,3,2,60.0,15.24846451996174,2,1,1,50.0,3,1,4,2,0,0,0,VfB Stuttgart,3,Germany - 1. Bundesliga
32,Arjen Robben,620,495.0,125,79.83870967741935,36,24,12,66.66666666666666,419,371,48,88.54415274463007,41,20,21,48.78048780487805,15.670901299346712,26,9,17,34.61538461538461,24,1,34,19,24,13,15,Bayern Munich,15,Germany - 1. Bundesliga
33,Aron Jóhannsson,100,67.0,33,67.0,6,4,2,66.66666666666666,54,47,7,87.03703703703704,15,8,7,53.333333333333336,17.602431956762402,6,2,4,33.33333333333333,7,0,7,3,4,2,6,Werder Bremen,6,Germany - 1. Bundesliga
34,Artem Kravets,180,122.0,58,67.77777777777779,20,7,13,35.0,106,89,17,83.9622641509434,5,0,5,0.0,12.9919407997596,6,0,6,0.0,4,1,11,6,8,3,5,VfB Stuttgart,15,Germany - 1. Bundesliga
35,Artoms Rudņevs,163,100.0,63,61.34969325153374,24,10,14,41.66666666666667,72,58,14,80.55555555555556,6,1,5,16.666666666666664,14.108558737048345,7,2,5,28.57142857142857,4,1,10,3,6,2,5,Hamburger SV,11,Germany - 1. Bundesliga
36,Artur Sobiech,415,297.0,118,71.56626506024097,45,16,29,35.55555555555556,232,208,24,89.65517241379311,8,3,5,37.5,11.621555991791999,6,3,3,50.0,20,0,10,7,5,3,26,Hannover 96,25,Germany - 1. Bundesliga
37,Arturo Erasmo Vidal Pardo,2027,1822.0,205,89.88653182042428,211,174,37,82.46445497630332,1468,1392,76,94.82288828337875,148,96,52,64.86486486486487,18.00913937199487,21,9,12,42.857142857142854,42,5,15,9,7,6,38,Bayern Munich,30,Germany - 1. Bundesliga
38,Assani Lukimya-Mulongoti,380,266.0,114,70.0,76,32,44,42.10526315789473,166,151,15,90.96385542168674,98,39,59,39.795918367346935,25.551067102247366,0,0,0,0.0,1,0,1,0,0,0,8,Werder Bremen,12,Germany - 1. Bundesliga
39,Aytac Sulu,568,324.0,244,57.04225352112676,172,60,112,34.883720930232556,127,116,11,91.33858267716536,196,60,136,30.612244897959183,27.853183415914227,0,0,0,0.0,10,0,2,2,0,0,56,Darmstadt 98,33,Germany - 1. Bundesliga
40,Bas Dost,398,311.0,87,78.14070351758794,40,22,18,55.00000000000001,217,200,17,92.16589861751152,13,8,5,61.53846153846154,13.820514408253267,4,1,3,25.0,10,2,4,2,3,1,10,Wolfsburg,22,Germany - 1. Bundesliga
41,Bastian Oczipka,1656,1259.0,397,76.02657004830918,145,76,69,52.41379310344828,907,821,86,90.51819184123484,180,58,122,32.22222222222222,16.788075477243478,69,15,54,21.73913043478261,22,0,69,44,36,22,34,Eintracht Frankfurt,30,Germany - 1. Bundesliga
42,Benedikt Höwedes,534,457.0,77,85.58052434456928,68,46,22,67.64705882352942,345,330,15,95.65217391304348,42,20,22,47.61904761904761,19.57581785958472,5,3,2,60.0,5,0,0,0,0,0,8,Schalke 04,15,Germany - 1. Bundesliga
43,Benjamin Gorka,5,3.0,2,60.0,2,1,1,50.0,1,1,0,100.0,1,0,1,0.0,27.1595654928,0,0,0,0.0,0,0,0,0,0,0,0,Darmstadt 98,4,Germany - 1. Bundesliga
44,Benjamin Henrichs,237,169.0,68,71.30801687763713,41,19,22,46.34146341463415,102,88,14,86.27450980392157,23,5,18,21.73913043478261,17.975682523145316,0,0,0,0.0,2,1,2,2,1,1,11,Bayer Leverkusen,9,Germany - 1. Bundesliga
45,Benjamin Hübner,720,470.0,250,65.27777777777779,142,42,100,29.577464788732392,219,196,23,89.49771689497716,147,48,99,32.6530612244898,22.902242323693997,0,0,0,0.0,3,0,7,3,0,0,42,Ingolstadt,30,Germany - 1. Bundesliga
46,Bernd Leno,1092,707.0,385,64.74358974358975,203,57,146,28.078817733990146,417,415,2,99.52038369304557,596,221,375,37.080536912751676,41.35251309450527,0,0,0,0.0,2,0,0,0,0,0,3,Bayer Leverkusen,33,Germany - 1. Bundesliga
47,Borys Tashchy,52,33.0,19,63.46153846153846,6,3,3,50.0,29,23,6,79.3103448275862,0,0,0,0.0,12.087171500566154,1,0,1,0.0,1,0,2,0,2,0,4,VfB Stuttgart,9,Germany - 1. Bundesliga
48,Branimir Hrgota,39,33.0,6,84.61538461538461,1,1,0,100.0,29,25,4,86.20689655172413,0,0,0,0.0,11.726651950412307,0,0,0,0.0,0,0,6,5,5,5,4,Borussia Mönchengladbach,9,Germany - 1. Bundesliga
49,Bruno Henrique Pinto,77,53.0,24,68.83116883116884,6,2,4,33.33333333333333,43,36,7,83.72093023255815,2,1,1,50.0,15.093713288889349,6,3,3,50.0,3,1,12,5,9,3,11,Wolfsburg,7,Germany - 1. Bundesliga
50,Caiuby Francisco da Silva,771,493.0,278,63.94293125810635,112,57,55,50.89285714285714,347,288,59,82.9971181556196,48,15,33,31.25,15.405112185200311,30,9,21,30.0,33,4,75,45,37,19,39,Augsburg,26,Germany - 1. Bundesliga
51,Carlos Antonio Ascues Ávila,6,5.0,1,83.33333333333334,1,0,1,0.0,3,3,0,100.0,2,1,1,50.0,28.208708428799998,0,0,0,0.0,0,0,1,1,0,0,0,Wolfsburg,1,Germany - 1. Bundesliga
52,Carlos Armando Gruezo Arboleda,18,10.0,8,55.55555555555556,5,1,4,20.0,7,5,2,71.42857142857143,3,1,2,33.33333333333333,19.80316741924,0,0,0,0.0,0,0,0,0,0,0,0,VfB Stuttgart,2,Germany - 1. Bundesliga
53,Carlos Augusto Zambrano Ochandarte,920,767.0,153,83.36956521739131,91,48,43,52.74725274725275,560,528,32,94.28571428571428,99,35,64,35.35353535353536,20.67851362223207,0,0,0,0.0,1,0,13,12,0,0,62,Eintracht Frankfurt,24,Germany - 1. Bundesliga
54,Ceyhun Gülselam,423,308.0,115,72.81323877068559,83,43,40,51.80722891566265,218,195,23,89.44954128440367,56,26,30,46.42857142857143,19.502470383596595,4,3,1,75.0,6,1,12,8,4,2,18,Hannover 96,13,Germany - 1. Bundesliga
55,Charles Mariano Aránguiz Sandoval,224,165.0,59,73.66071428571429,25,16,9,64.0,117,100,17,85.47008547008546,40,22,18,55.00000000000001,19.491098659148573,5,1,4,20.0,4,1,2,2,0,0,14,Bayer Leverkusen,7,Germany - 1. Bundesliga
56,Charlison Benschop,74,52.0,22,70.27027027027027,8,3,5,37.5,35,30,5,85.71428571428571,1,0,1,0.0,13.787584980363244,2,0,2,0.0,1,0,0,0,0,0,2,Hannover 96,9,Germany - 1. Bundesliga
57,Christian Clemens,535,337.0,198,62.99065420560748,58,30,28,51.724137931034484,272,218,54,80.14705882352942,100,30,70,30.0,18.718081976929795,33,12,21,36.36363636363637,28,2,38,18,22,10,20,FSV Mainz 05,28,Germany - 1. Bundesliga
58,Christian Gentner,1354,993.0,361,73.33825701624815,229,135,94,58.951965065502186,730,653,77,89.45205479452055,138,56,82,40.57971014492754,17.614886106620208,33,5,28,15.151515151515152,25,2,28,20,12,8,63,VfB Stuttgart,29,Germany - 1. Bundesliga
59,Christian Mathenia,1067,431.0,636,40.393626991565135,515,167,348,32.42718446601941,41,39,2,95.1219512195122,995,368,627,36.984924623115575,59.141881885111154,0,0,0,0.0,2,0,0,0,0,0,4,Darmstadt 98,33,Germany - 1. Bundesliga
60,Christian Pulisic,190,143.0,47,75.26315789473685,9,8,1,88.88888888888889,143,123,20,86.01398601398601,10,2,8,20.0,13.448800836579789,19,5,14,26.31578947368421,7,0,19,7,12,3,10,Borussia Dortmund,9,Germany - 1. Bundesliga
61,Christian Schulz,996,821.0,175,82.429718875502,92,40,52,43.47826086956522,584,565,19,96.74657534246576,103,35,68,33.980582524271846,20.447789517503132,4,1,3,25.0,4,0,2,2,1,1,12,Hannover 96,25,Germany - 1. Bundesliga
62,Christian Träsch,1729,1363.0,366,78.8316946211683,230,142,88,61.73913043478261,908,848,60,93.3920704845815,234,92,142,39.31623931623932,19.54043791289344,82,23,59,28.04878048780488,24,1,43,23,19,5,32,Wolfsburg,29,Germany - 1. Bundesliga
63,Christoph Janker,150,124.0,26,82.66666666666667,11,5,6,45.45454545454545,84,81,3,96.42857142857143,14,6,8,42.857142857142854,21.1062494915568,0,0,0,0.0,0,0,1,0,0,0,7,Augsburg,11,Germany - 1. Bundesliga
64,Christoph Kramer,1558,1283.0,275,82.34916559691912,184,99,85,53.80434782608695,970,904,66,93.19587628865979,145,72,73,49.6551724137931,16.827704542195995,16,6,10,37.5,14,1,39,21,22,9,38,Bayer Leverkusen,28,Germany - 1. Bundesliga
65,Christoph Moritz,118,101.0,17,85.59322033898306,8,3,5,37.5,79,75,4,94.9367088607595,3,0,3,0.0,15.16634153967051,2,0,2,0.0,0,0,2,1,1,0,3,FSV Mainz 05,8,Germany - 1. Bundesliga
66,Claudio Miguel Pizarro Bossio,593,414.0,179,69.81450252951096,81,43,38,53.086419753086425,343,277,66,80.75801749271136,25,17,8,68.0,13.968141866167933,3,2,1,66.66666666666666,27,3,46,29,16,9,23,Werder Bremen,28,Germany - 1. Bundesliga
67,Cleber Janderson Pereira Reis,758,587.0,171,77.44063324538259,93,43,50,46.236559139784944,377,357,20,94.6949602122016,137,59,78,43.06569343065693,24.132281628519262,1,0,1,0.0,1,0,18,15,1,0,15,Hamburger SV,23,Germany - 1. Bundesliga
68,Clemens Fritz,1035,764.0,271,73.81642512077295,189,111,78,58.730158730158735,541,475,66,87.8003696857671,154,72,82,46.75324675324675,20.185696720683826,16,5,11,31.25,15,2,47,33,14,9,91,Werder Bremen,29,Germany - 1. Bundesliga
69,Daniel Baier,1511,1123.0,388,74.3216412971542,316,170,146,53.79746835443038,754,699,55,92.70557029177718,294,108,186,36.734693877551024,22.528017824196294,20,10,10,50.0,48,2,16,10,6,2,49,Augsburg,28,Germany - 1. Bundesliga
70,Daniel Brosinski,1362,933.0,429,68.5022026431718,207,97,110,46.85990338164252,513,445,68,86.74463937621833,288,108,180,37.5,22.01065471287436,55,17,38,30.909090909090907,20,2,28,18,15,7,33,FSV Mainz 05,30,Germany - 1. Bundesliga
71,Daniel Caligiuri,844,644.0,200,76.30331753554502,65,34,31,52.307692307692314,539,469,70,87.01298701298701,60,30,30,50.0,16.65518806376019,48,15,33,31.25,26,5,112,53,71,35,55,Wolfsburg,29,Germany - 1. Bundesliga
72,Daniel Didavi,1027,752.0,275,73.22297955209348,154,78,76,50.649350649350644,622,556,66,89.38906752411575,110,35,75,31.818181818181817,17.993341799898346,47,17,30,36.17021276595745,32,3,36,23,26,14,66,VfB Stuttgart,31,Germany - 1. Bundesliga
73,Daniel Ginczek,190,111.0,79,58.42105263157895,9,4,5,44.44444444444444,89,70,19,78.65168539325843,4,2,2,50.0,12.610432594038317,7,2,5,28.57142857142857,12,1,21,13,17,10,15,VfB Stuttgart,7,Germany - 1. Bundesliga
74,Daniel Schwaab,1187,904.0,283,76.15838247683236,214,109,105,50.93457943925234,545,509,36,93.39449541284404,168,59,109,35.11904761904761,21.717754872019615,9,4,5,44.44444444444444,5,1,18,16,4,3,20,VfB Stuttgart,29,Germany - 1. Bundesliga
75,Daniel Tawiah Opare,138,89.0,49,64.4927536231884,19,6,13,31.57894736842105,50,43,7,86.0,32,9,23,28.125,20.92191897992348,7,2,5,28.57142857142857,2,0,14,6,3,2,7,Augsburg,4,Germany - 1. Bundesliga
76,Danilo Teodoro Soares,36,20.0,16,55.55555555555556,7,1,6,14.285714285714285,8,6,2,75.0,4,1,3,25.0,18.61647337658,3,2,1,66.66666666666666,0,0,2,1,2,1,6,Ingolstadt,1,Germany - 1. Bundesliga
77,Danny Latza,1189,950.0,239,79.89907485281749,132,75,57,56.81818181818182,690,638,52,92.46376811594203,140,63,77,45.0,19.745216580768645,21,6,15,28.57142857142857,28,2,13,10,5,2,38,FSV Mainz 05,27,Germany - 1. Bundesliga
78,Danny Vieira da Costa,807,547.0,260,67.7819083023544,151,85,66,56.29139072847682,269,216,53,80.29739776951673,96,32,64,33.33333333333333,17.891622472200446,27,7,20,25.925925925925924,10,3,36,18,24,12,17,Ingolstadt,19,Germany - 1. Bundesliga
79,Dante Bonfim da Costa Santos,1678,1477.0,201,88.02145411203814,167,93,74,55.688622754491014,1098,1070,28,97.44990892531877,166,60,106,36.144578313253014,22.215838365909224,0,0,0,0.0,4,0,3,2,1,1,19,Wolfsburg,24,Germany - 1. Bundesliga
80,Dario Kresic,18,11.0,7,61.111111111111114,2,1,1,50.0,1,1,0,100.0,16,10,6,62.5,52.731817218399996,0,0,0,0.0,0,0,0,0,0,0,0,Bayer Leverkusen,1,Germany - 1. Bundesliga
81,Dario Lezcano,311,211.0,100,67.84565916398714,29,10,19,34.48275862068966,184,146,38,79.34782608695652,6,3,3,50.0,11.727538770573377,9,1,8,11.11111111111111,15,1,40,23,25,14,43,Ingolstadt,17,Germany - 1. Bundesliga
82,David Kinsombi,15,11.0,4,73.33333333333333,5,2,3,40.0,7,7,0,100.0,4,1,3,25.0,22.245152922864,0,0,0,0.0,0,0,0,0,0,0,0,Eintracht Frankfurt,1,Germany - 1. Bundesliga
83,David Olatukunbo Alaba,2536,2340.0,196,92.27129337539432,282,234,48,82.97872340425532,1912,1864,48,97.48953974895397,119,54,65,45.378151260504204,17.60081585112199,31,10,21,32.25806451612903,18,0,12,7,7,4,22,Bayern Munich,30,Germany - 1. Bundesliga
84,David Yelldell,20,6.0,14,30.0,4,1,3,25.0,1,1,0,100.0,17,3,14,17.647058823529413,56.106960333480004,0,0,0,0.0,0,0,0,0,0,0,0,Bayer Leverkusen,1,Germany - 1. Bundesliga
85,David Ángel Abraham,1104,892.0,212,80.79710144927536,107,47,60,43.925233644859816,595,577,18,96.97478991596638,152,60,92,39.473684210526315,21.98992594386,1,0,1,0.0,5,0,9,3,1,0,31,Eintracht Frankfurt,31,Germany - 1. Bundesliga
86,Dennis Aogo,1224,982.0,242,80.22875816993465,96,67,29,69.79166666666666,619,579,40,93.53796445880452,125,53,72,42.4,18.01323311426765,72,21,51,29.166666666666668,25,1,12,8,5,3,15,Schalke 04,23,Germany - 1. Bundesliga
87,Dennis Diekmeier,669,493.0,176,73.69207772795217,67,30,37,44.776119402985074,329,302,27,91.7933130699088,75,25,50,33.33333333333333,18.494536508827263,37,12,25,32.432432432432435,8,0,14,9,5,3,22,Hamburger SV,22,Germany - 1. Bundesliga
88,Devante James Parker,1,1.0,0,100.0,0,0,0,0.0,1,1,0,100.0,0,0,0,0.0,4.42705607856,0,0,0,0.0,0,0,0,0,0,0,0,FSV Mainz 05,1,Germany - 1. Bundesliga
89,Diego Orlando Benaglio,733,587.0,146,80.0818553888131,30,4,26,13.333333333333334,366,365,1,99.72677595628416,261,119,142,45.593869731800766,32.25667414181697,0,0,0,0.0,0,0,0,0,0,0,3,Wolfsburg,21,Germany - 1. Bundesliga
90,Dominik Kohr,1124,860.0,264,76.51245551601423,185,108,77,58.37837837837838,623,550,73,88.28250401284109,132,48,84,36.36363636363637,19.90195512143253,5,1,4,20.0,5,2,25,10,13,3,51,Augsburg,31,Germany - 1. Bundesliga
91,Dominik Maroh,1162,1019.0,143,87.69363166953529,55,28,27,50.90909090909091,696,679,17,97.5574712643678,99,46,53,46.464646464646464,21.400460712567572,0,0,0,0.0,0,0,1,0,0,0,16,FC Köln,25,Germany - 1. Bundesliga
92,Dominik Stroh-Engel,119,68.0,51,57.14285714285714,20,9,11,45.0,44,36,8,81.81818181818183,4,2,2,50.0,12.660878315181177,2,1,1,50.0,3,1,2,0,2,0,10,Darmstadt 98,15,Germany - 1. Bundesliga
93,Dominique Heintz,1484,1219.0,265,82.14285714285714,199,94,105,47.23618090452261,803,769,34,95.76587795765879,228,82,146,35.96491228070175,23.5648720097641,13,3,10,23.076923076923077,3,0,20,14,2,0,18,FC Köln,33,Germany - 1. Bundesliga
94,Dong-Won Ji,308,230.0,78,74.67532467532467,36,19,17,52.77777777777778,163,141,22,86.50306748466258,23,10,13,43.47826086956522,15.694933753019221,10,5,5,50.0,13,0,15,5,7,2,13,Augsburg,21,Germany - 1. Bundesliga
95,Douglas Costa de Souza,1118,812.0,306,72.62969588550983,84,53,31,63.095238095238095,740,619,121,83.64864864864865,133,48,85,36.09022556390977,17.536029855398212,114,36,78,31.57894736842105,36,9,116,59,69,37,26,Bayern Munich,27,Germany - 1. Bundesliga
96,Dušan Švento,62,35.0,27,56.451612903225815,9,5,4,55.55555555555556,30,24,6,80.0,12,2,10,16.666666666666664,18.649635259587097,8,1,7,12.5,1,0,4,3,3,2,1,FC Köln,7,Germany - 1. Bundesliga
97,Edgar Prib,630,425.0,205,67.46031746031747,82,49,33,59.756097560975604,303,269,34,88.77887788778878,120,39,81,32.5,18.83592681938057,36,10,26,27.77777777777778,16,2,39,16,18,8,28,Hannover 96,20,Germany - 1. Bundesliga
98,Eduardo Jesús Vargas Rojas,557,407.0,150,73.07001795332137,82,43,39,52.4390243902439,348,295,53,84.77011494252874,34,17,17,50.0,15.287740497322254,13,4,9,30.76923076923077,24,3,58,39,27,19,23,Hoffenheim,24,Germany - 1. Bundesliga
99,Elias Kachunga,75,48.0,27,64.0,9,2,7,22.22222222222222,44,35,9,79.54545454545455,3,0,3,0.0,12.3126295658016,2,0,2,0.0,0,0,5,2,2,1,10,Ingolstadt,10,Germany - 1. Bundesliga
100,Emiliano Adrián Insúa Zapata,1678,1224.0,454,72.94398092967819,258,136,122,52.71317829457365,709,638,71,89.98589562764458,218,67,151,30.73394495412844,18.80342992601764,69,24,45,34.78260869565217,29,1,56,37,28,15,37,VfB Stuttgart,33,Germany - 1. Bundesliga
101,Emir Spahić,1290,999.0,291,77.44186046511628,188,81,107,43.08510638297872,637,606,31,95.13343799058084,229,83,146,36.24454148471616,23.26676906346257,5,2,3,40.0,2,0,9,8,1,0,10,Hamburger SV,26,Germany - 1. Bundesliga
102,Erik Durm,527,404.0,123,76.66034155597723,58,34,24,58.620689655172406,298,262,36,87.91946308724832,49,18,31,36.734693877551024,17.204706441521214,19,5,14,26.31578947368421,7,1,20,14,7,4,10,Borussia Dortmund,14,Germany - 1. Bundesliga
103,Ermin Bičakčić,760,631.0,129,83.02631578947368,82,39,43,47.5609756097561,462,449,13,97.18614718614718,85,30,55,35.294117647058826,20.573142739327988,1,0,1,0.0,2,0,4,2,1,1,21,Hoffenheim,21,Germany - 1. Bundesliga
104,Eugen Polanski,899,691.0,208,76.86318131256952,158,78,80,49.36708860759494,589,526,63,89.30390492359932,79,21,58,26.582278481012654,18.4693002950707,8,2,6,25.0,14,3,24,16,6,4,48,Hoffenheim,27,Germany - 1. Bundesliga
105,Fabian Frei,441,336.0,105,76.19047619047619,55,28,27,50.90909090909091,236,221,15,93.64406779661016,45,20,25,44.44444444444444,19.358193790208983,8,4,4,50.0,7,2,6,3,3,2,4,FSV Mainz 05,17,Germany - 1. Bundesliga
106,Fabian Holland,451,281.0,170,62.3059866962306,120,52,68,43.333333333333336,110,95,15,86.36363636363636,97,31,66,31.958762886597935,21.757936545506873,12,2,10,16.666666666666664,5,0,5,4,2,1,25,Darmstadt 98,18,Germany - 1. Bundesliga
107,Fabian Johnson,917,706.0,211,76.99018538713194,68,34,34,50.0,641,558,83,87.05148205928236,34,15,19,44.11764705882353,13.831177161384078,20,7,13,35.0,26,3,37,17,19,8,26,Borussia Mönchengladbach,26,Germany - 1. Bundesliga
108,Fabian Lukas Schär,888,705.0,183,79.3918918918919,157,71,86,45.22292993630573,446,422,24,94.61883408071749,167,70,97,41.91616766467065,24.99270859129054,0,0,0,0.0,5,0,9,7,2,2,21,Hoffenheim,24,Germany - 1. Bundesliga
109,Fabian Lustenberger,1389,1221.0,168,87.90496760259178,100,51,49,51.0,852,816,36,95.77464788732394,115,58,57,50.43478260869565,21.542645521432743,0,0,0,0.0,8,0,5,4,1,1,51,Hertha Berlin,30,Germany - 1. Bundesliga
110,Fabian Reese,3,2.0,1,66.66666666666666,0,0,0,0.0,1,1,0,100.0,0,0,0,0.0,7.3267270788,0,0,0,0.0,1,0,0,0,0,0,0,Schalke 04,1,Germany - 1. Bundesliga
111,Federico Barba,75,60.0,15,80.0,9,4,5,44.44444444444444,42,39,3,92.85714285714286,7,4,3,57.14285714285714,18.8982095670816,0,0,0,0.0,0,0,0,0,0,0,2,VfB Stuttgart,2,Germany - 1. Bundesliga
112,Felipe Trevizan Martins,28,20.0,8,71.42857142857143,4,3,1,75.0,9,9,0,100.0,5,2,3,40.0,21.239602961400003,0,0,0,0.0,0,0,2,1,1,1,5,Hannover 96,8,Germany - 1. Bundesliga
113,Felix Klaus,208,148.0,60,71.15384615384616,10,4,6,40.0,115,95,20,82.6086956521739,12,7,5,58.333333333333336,14.037984704596154,3,2,1,66.66666666666666,5,0,23,10,16,9,29,Hannover 96,18,Germany - 1. Bundesliga
114,Felix Kroos,101,75.0,26,74.25742574257426,20,11,9,55.00000000000001,50,44,6,88.0,11,3,8,27.27272727272727,16.82731957841822,1,0,1,0.0,3,0,2,1,0,0,5,Werder Bremen,8,Germany - 1. Bundesliga
115,Felix Passlack,126,107.0,19,84.92063492063492,13,10,3,76.92307692307693,88,82,6,93.18181818181817,5,1,4,20.0,15.144467156485714,2,0,2,0.0,1,0,1,0,1,0,1,Borussia Dortmund,3,Germany - 1. Bundesliga
116,Felix Platte,49,24.0,25,48.97959183673469,11,5,6,45.45454545454545,15,11,4,73.33333333333333,7,1,6,14.285714285714285,16.750527586207347,2,0,2,0.0,2,0,4,2,2,1,4,Darmstadt 98,12,Germany - 1. Bundesliga
117,Felix Wiedwald,1033,633.0,400,61.27783155856727,131,42,89,32.06106870229007,245,242,3,98.77551020408163,700,312,388,44.57142857142857,44.36361885871202,0,0,0,0.0,0,0,1,1,0,0,8,Werder Bremen,34,Germany - 1. Bundesliga
118,Filip Kostić,1089,589.0,500,54.08631772268136,94,42,52,44.680851063829785,489,354,135,72.39263803680981,239,75,164,31.380753138075313,19.728742982897188,162,45,117,27.77777777777778,71,5,88,50,51,32,47,VfB Stuttgart,30,Germany - 1. Bundesliga
119,Filip Mladenović,383,277.0,106,72.32375979112271,29,15,14,51.724137931034484,178,155,23,87.07865168539325,63,26,37,41.269841269841265,19.57247564760188,28,10,18,35.714285714285715,11,2,15,5,6,4,7,FC Köln,14,Germany - 1. Bundesliga
120,Fin Bartels,663,487.0,176,73.45399698340876,69,44,25,63.76811594202898,406,338,68,83.2512315270936,45,16,29,35.55555555555556,15.95252649185267,30,9,21,30.0,21,1,78,39,44,23,36,Werder Bremen,30,Germany - 1. Bundesliga
121,Florian Grillitsch,913,670.0,243,73.38444687842278,120,66,54,55.00000000000001,485,425,60,87.62886597938144,119,48,71,40.33613445378151,19.07391917953262,16,6,10,37.5,19,2,27,12,13,3,43,Werder Bremen,25,Germany - 1. Bundesliga
122,Florian Jungwirth,492,298.0,194,60.56910569105691,75,38,37,50.66666666666667,132,108,24,81.81818181818183,76,23,53,30.263157894736842,20.145760248242926,15,6,9,40.0,5,0,3,1,2,1,22,Darmstadt 98,19,Germany - 1. Bundesliga
123,Florian Klein,670,481.0,189,71.7910447761194,94,56,38,59.57446808510638,269,241,28,89.59107806691449,68,17,51,25.0,16.92531596337958,29,13,16,44.827586206896555,12,1,12,9,10,7,17,VfB Stuttgart,22,Germany - 1. Bundesliga
124,Florian Kohls,3,2.0,1,66.66666666666666,0,0,0,0.0,2,2,0,100.0,0,0,0,0.0,13.0675087392,0,0,0,0.0,0,0,0,0,0,0,0,Hertha Berlin,1,Germany - 1. Bundesliga
125,Florian Niederlechner,37,20.0,17,54.054054054054056,5,1,4,20.0,22,16,6,72.72727272727273,2,0,2,0.0,14.624831556077837,0,0,0,0.0,0,0,2,0,2,0,4,FSV Mainz 05,12,Germany - 1. Bundesliga
126,Francisco José Rodriguez Araya,19,16.0,3,84.21052631578947,4,3,1,75.0,12,11,1,91.66666666666666,3,2,1,66.66666666666666,21.31419832976842,0,0,0,0.0,1,0,0,0,0,0,0,Wolfsburg,1,Germany - 1. Bundesliga
127,Franck Bilal Ribéry,558,431.0,127,77.24014336917563,55,37,18,67.27272727272727,396,347,49,87.62626262626263,59,25,34,42.3728813559322,16.299209990025805,37,11,26,29.72972972972973,23,3,61,29,39,19,17,Bayern Munich,13,Germany - 1. Bundesliga
128,Franco Matías Di Santo,299,185.0,114,61.87290969899666,37,17,20,45.94594594594595,128,97,31,75.78125,25,13,12,52.0,14.056793939699396,16,10,6,62.5,16,1,17,8,7,3,16,Schalke 04,25,Germany - 1. Bundesliga
129,Frederik Hillesborg Sørensen,905,685.0,220,75.69060773480662,142,61,81,42.95774647887324,399,375,24,93.98496240601504,190,73,117,38.421052631578945,24.892150059394208,3,1,2,33.33333333333333,1,2,8,5,1,0,18,FC Köln,22,Germany - 1. Bundesliga
130,Fynn Arkenberg,59,36.0,23,61.016949152542374,12,4,8,33.33333333333333,19,17,2,89.47368421052632,10,3,7,30.0,18.995551547271866,2,1,1,50.0,0,0,3,2,2,2,3,Hannover 96,2,Germany - 1. Bundesliga
131,Gaëtan Bussmann,613,403.0,210,65.74225122349104,103,47,56,45.63106796116505,199,172,27,86.4321608040201,88,23,65,26.136363636363637,18.927795535231713,19,4,15,21.052631578947366,10,0,5,4,3,2,10,FSV Mainz 05,13,Germany - 1. Bundesliga
132,Genki Haraguchi,778,558.0,220,71.72236503856041,70,39,31,55.714285714285715,482,397,85,82.36514522821577,39,18,21,46.15384615384615,14.867374266777377,57,21,36,36.84210526315789,23,3,90,54,47,29,42,Hertha Berlin,32,Germany - 1. Bundesliga
133,Georg Niedermeier,638,524.0,114,82.13166144200626,50,22,28,44.0,350,337,13,96.28571428571429,71,26,45,36.61971830985916,22.020493236597368,0,0,0,0.0,3,1,0,0,0,0,8,VfB Stuttgart,18,Germany - 1. Bundesliga
134,Gian-Luca Waldschmidt,72,53.0,19,73.61111111111111,6,4,2,66.66666666666666,52,40,12,76.92307692307693,5,1,4,20.0,13.055440881700001,5,3,2,60.0,7,1,11,4,10,3,6,Eintracht Frankfurt,12,Germany - 1. Bundesliga
135,Gideon Jung,455,350.0,105,76.92307692307693,63,33,30,52.38095238095239,270,236,34,87.4074074074074,44,19,25,43.18181818181818,17.551837780832493,0,0,0,0.0,3,0,16,9,5,2,26,Hamburger SV,18,Germany - 1. Bundesliga
136,Giulio Donati,1043,720.0,323,69.03163950143816,186,108,78,58.06451612903226,391,326,65,83.37595907928389,153,53,100,34.64052287581699,19.656717201278543,31,6,25,19.35483870967742,8,1,27,13,13,6,52,FSV Mainz 05,23,Germany - 1. Bundesliga
137,Gojko Kačar,529,412.0,117,77.882797731569,70,29,41,41.42857142857143,303,273,30,90.0990099009901,41,13,28,31.70731707317073,18.343152981807652,1,1,0,100.0,1,0,5,4,1,0,14,Hamburger SV,19,Germany - 1. Bundesliga
138,Gonzalo Alejandro Jara Reyes,229,178.0,51,77.72925764192141,30,21,9,70.0,112,105,7,93.75,39,17,22,43.58974358974359,21.236098504433187,2,0,2,0.0,3,0,4,2,0,0,4,FSV Mainz 05,6,Germany - 1. Bundesliga
139,Gonzalo Castro Randon,1016,833.0,183,81.98818897637796,108,65,43,60.18518518518518,758,680,78,89.70976253298153,55,24,31,43.63636363636363,16.060664266739998,13,0,13,0.0,22,7,35,16,19,10,23,Borussia Dortmund,25,Germany - 1. Bundesliga
140,Gotoku Sakai,1031,761.0,270,73.81183317167799,111,61,50,54.95495495495496,472,423,49,89.61864406779661,130,50,80,38.46153846153847,17.84463113927907,30,8,22,26.666666666666668,13,1,24,16,7,5,13,Hamburger SV,22,Germany - 1. Bundesliga
141,Granit Xhaka,2219,1895.0,324,85.3988283010365,359,243,116,67.68802228412257,1403,1312,91,93.51389878831077,232,139,93,59.91379310344828,19.903410596566236,4,0,4,0.0,17,0,38,25,6,5,56,Borussia Mönchengladbach,28,Germany - 1. Bundesliga
142,Gustavo Adrián Ramos Vásquez,258,179.0,79,69.37984496124031,29,16,13,55.172413793103445,144,119,25,82.63888888888889,13,10,3,76.92307692307693,14.110546784963722,5,2,3,40.0,7,3,23,16,20,15,20,Borussia Dortmund,27,Germany - 1. Bundesliga
143,György Garics,627,392.0,235,62.51993620414673,125,51,74,40.8,159,143,16,89.937106918239,127,41,86,32.28346456692913,21.28165533646966,12,5,7,41.66666666666667,3,0,6,5,3,2,7,Darmstadt 98,21,Germany - 1. Bundesliga
144,Hakan Çalhanoğlu,1457,997.0,460,68.42827728208648,202,116,86,57.42574257425742,749,670,79,89.45260347129505,333,124,209,37.23723723723724,19.931473569850493,86,29,57,33.72093023255814,74,5,54,31,31,19,34,Bayer Leverkusen,31,Germany - 1. Bundesliga
145,Halil Altıntop,378,298.0,80,78.83597883597884,45,22,23,48.888888888888886,265,230,35,86.79245283018868,25,12,13,48.0,16.30560752745238,3,0,3,0.0,13,2,19,11,8,3,18,Augsburg,19,Germany - 1. Bundesliga
146,Haris Seferović,900,576.0,324,64.0,97,34,63,35.051546391752574,455,372,83,81.75824175824175,57,23,34,40.35087719298245,15.526143920472,43,14,29,32.55813953488372,20,4,27,15,14,7,32,Eintracht Frankfurt,29,Germany - 1. Bundesliga
147,Henrikh Mkhitaryan,1487,1059.0,428,71.21721587088096,127,62,65,48.818897637795274,971,803,168,82.6982492276004,150,63,87,42.0,16.284688149494446,80,23,57,28.749999999999996,63,13,136,74,69,37,70,Borussia Dortmund,31,Germany - 1. Bundesliga
148,Heung-Min Son,18,14.0,4,77.77777777777779,2,1,1,50.0,15,12,3,80.0,1,1,0,100.0,13.6632514644,1,0,1,0.0,0,0,3,1,1,1,0,Bayer Leverkusen,1,Germany - 1. Bundesliga
149,Hiroki Sakai,1300,935.0,365,71.92307692307692,152,76,76,50.0,576,498,78,86.45833333333334,129,41,88,31.782945736434108,17.45991088773231,40,9,31,22.5,11,0,19,11,8,3,22,Hannover 96,26,Germany - 1. Bundesliga
150,Hiroshi Kiyotake,996,719.0,277,72.18875502008032,148,102,46,68.91891891891892,586,516,70,88.05460750853243,159,58,101,36.477987421383645,17.55156938400072,48,11,37,22.916666666666664,50,6,59,43,27,17,39,Hannover 96,21,Germany - 1. Bundesliga
151,Holger Badstuber,395,357.0,38,90.37974683544304,22,15,7,68.18181818181817,260,257,3,98.84615384615385,31,15,16,48.38709677419355,19.854613187258128,1,0,1,0.0,1,0,0,0,0,0,2,Bayern Munich,7,Germany - 1. Bundesliga
152,Hotaru Yamaguchi,167,139.0,28,83.23353293413174,14,8,6,57.14285714285714,116,108,8,93.10344827586206,7,3,4,42.857142857142854,15.17795963946625,1,0,1,0.0,1,0,1,0,0,0,1,Hannover 96,6,Germany - 1. Bundesliga
153,Hugo Miguel Pereira de Almeida,210,113.0,97,53.80952380952381,27,10,17,37.03703703703704,57,45,12,78.94736842105263,21,6,15,28.57142857142857,15.681252732500571,11,4,7,36.36363636363637,6,0,4,3,3,3,6,Hannover 96,7,Germany - 1. Bundesliga
154,Håvard Nordtveit,1768,1471.0,297,83.20135746606336,240,117,123,48.75,1030,979,51,95.04854368932038,204,74,130,36.27450980392157,22.201319869922035,5,3,2,60.0,7,1,9,6,4,3,23,Borussia Mönchengladbach,31,Germany - 1. Bundesliga
155,Ibrahima Traoré,775,569.0,206,73.41935483870968,61,37,24,60.65573770491803,497,409,88,82.29376257545272,107,47,60,43.925233644859816,17.969293008544412,47,16,31,34.04255319148936,34,1,94,60,42,25,43,Borussia Mönchengladbach,24,Germany - 1. Bundesliga
156,Ismail Azzaoui,9,7.0,2,77.77777777777779,1,1,0,100.0,8,7,1,87.5,0,0,0,0.0,12.5489905484,2,0,2,0.0,0,0,1,1,1,1,0,Wolfsburg,2,Germany - 1. Bundesliga
157,Ivan Perišić,84,59.0,25,70.23809523809523,9,7,2,77.77777777777779,53,44,9,83.01886792452831,9,3,6,33.33333333333333,16.644130279654284,9,1,8,11.11111111111111,2,0,2,1,0,0,1,Wolfsburg,2,Germany - 1. Bundesliga
158,Iver Tobias Rørvik Fossum,323,235.0,88,72.75541795665634,36,21,15,58.333333333333336,208,180,28,86.53846153846155,15,7,8,46.666666666666664,14.143261665270094,7,2,5,28.57142857142857,10,0,13,7,5,2,9,Hannover 96,9,Germany - 1. Bundesliga
159,Ivica Olić,54,32.0,22,59.25925925925925,1,0,1,0.0,25,16,9,64.0,4,0,4,0.0,12.423328141186666,5,0,5,0.0,1,0,1,1,1,1,0,Hamburger SV,9,Germany - 1. Bundesliga
160,Ivo Iličević,839,602.0,237,71.75208581644816,102,62,40,60.78431372549019,513,427,86,83.23586744639377,68,26,42,38.23529411764706,15.761189619978737,44,8,36,18.181818181818183,26,2,69,44,29,19,47,Hamburger SV,31,Germany - 1. Bundesliga
161,Ja-Cheol Koo,843,666.0,177,79.00355871886121,94,58,36,61.702127659574465,533,486,47,91.18198874296435,60,25,35,41.66666666666667,15.401952291846234,16,7,9,43.75,26,1,41,28,14,9,51,Augsburg,29,Germany - 1. Bundesliga
162,Jairo Samperio Bustara,658,437.0,221,66.41337386018236,75,41,34,54.666666666666664,399,309,90,77.44360902255639,37,15,22,40.54054054054054,14.72135424980553,25,6,19,24.0,23,4,106,44,64,26,56,FSV Mainz 05,31,Germany - 1. Bundesliga
163,Jan Kliment,45,34.0,11,75.55555555555556,5,2,3,40.0,29,25,4,86.20689655172413,2,0,2,0.0,13.5875771428,3,2,1,66.66666666666666,3,0,5,2,4,1,1,VfB Stuttgart,8,Germany - 1. Bundesliga
164,Jan Morávek,177,136.0,41,76.8361581920904,15,8,7,53.333333333333336,114,99,15,86.8421052631579,6,2,4,33.33333333333333,13.809961623315255,1,0,1,0.0,5,0,5,2,4,2,2,Augsburg,11,Germany - 1. Bundesliga
165,Jan Rosenthal,375,221.0,154,58.93333333333334,59,16,43,27.11864406779661,167,134,33,80.23952095808383,26,8,18,30.76923076923077,15.085475335029118,10,4,6,40.0,8,1,22,13,11,7,19,Darmstadt 98,23,Germany - 1. Bundesliga
166,Jan-Ingwer Callsen-Bracker,346,291.0,55,84.10404624277457,37,17,20,45.94594594594595,177,174,3,98.30508474576271,53,22,31,41.509433962264154,24.846472781977106,0,0,0,0.0,1,0,0,0,0,0,4,Augsburg,10,Germany - 1. Bundesliga
167,Janek Sternberg,201,134.0,67,66.66666666666666,24,9,15,37.5,84,75,9,89.28571428571429,26,9,17,34.61538461538461,18.949540491693135,12,4,8,33.33333333333333,2,0,7,6,2,2,9,Werder Bremen,9,Germany - 1. Bundesliga
168,Jannik Vestergaard,1292,974.0,318,75.38699690402477,229,100,129,43.66812227074236,619,582,37,94.02261712439419,228,88,140,38.59649122807017,24.180765638573313,2,0,2,0.0,4,0,15,11,1,1,30,Werder Bremen,33,Germany - 1. Bundesliga
169,Jaroslav Drobný,314,158.0,156,50.318471337579616,70,13,57,18.571428571428573,62,62,0,100.0,224,71,153,31.69642857142857,49.5829791693149,0,0,0,0.0,0,1,2,2,0,0,1,Hamburger SV,10,Germany - 1. Bundesliga
170,Javier Hernández Balcázar,549,407.0,142,74.13479052823315,38,24,14,63.1578947368421,334,277,57,82.93413173652695,28,10,18,35.714285714285715,13.565221187395409,23,7,16,30.434782608695656,24,2,45,22,22,10,60,Bayer Leverkusen,28,Germany - 1. Bundesliga
171,Javier Martínez Aginaga,907,811.0,96,89.41565600882029,77,56,21,72.72727272727273,629,620,9,98.5691573926868,49,25,24,51.02040816326531,18.883772507554134,4,2,2,50.0,5,1,2,0,0,0,15,Bayern Munich,16,Germany - 1. Bundesliga
172,Jean-Eric Maxim Choupo-Moting,732,529.0,203,72.26775956284153,66,30,36,45.45454545454545,433,374,59,86.37413394919169,46,28,18,60.86956521739131,14.794269471849836,39,21,18,53.84615384615385,31,2,123,79,57,33,48,Schalke 04,28,Germany - 1. Bundesliga
173,Jeffrey Gouweleeuw,511,403.0,108,78.86497064579257,95,44,51,46.31578947368421,264,248,16,93.93939393939394,104,40,64,38.46153846153847,25.449020214553972,1,0,1,0.0,3,0,3,2,1,0,6,Augsburg,11,Germany - 1. Bundesliga
174,Jens Grahl,25,20.0,5,80.0,1,0,1,0.0,17,17,0,100.0,7,2,5,28.57142857142857,28.676097417311997,0,0,0,0.0,0,0,0,0,0,0,0,Hoffenheim,1,Germany - 1. Bundesliga
175,Jens Hegeler,215,180.0,35,83.72093023255815,27,18,9,66.66666666666666,144,134,10,93.05555555555556,5,1,4,20.0,14.63603124478772,0,0,0,0.0,1,0,5,5,1,1,8,Hertha Berlin,15,Germany - 1. Bundesliga
176,Jeong-Ho Hong,919,776.0,143,84.43960826985855,95,57,38,60.0,478,458,20,95.81589958158996,124,64,60,51.61290322580645,24.807868270039783,2,1,1,50.0,3,0,2,2,0,0,14,Augsburg,23,Germany - 1. Bundesliga
177,Jeremy Toljan,703,517.0,186,73.54196301564723,81,49,32,60.49382716049383,324,275,49,84.87654320987654,56,21,35,37.5,17.42636868010515,14,1,13,7.142857142857142,5,0,23,14,17,10,23,Hoffenheim,18,Germany - 1. Bundesliga
178,Jhon Andrés Córdoba Copete,266,201.0,65,75.56390977443608,18,11,7,61.111111111111114,171,144,27,84.21052631578947,2,0,2,0.0,12.817145365999849,5,0,5,0.0,7,2,25,15,12,5,68,FSV Mainz 05,22,Germany - 1. Bundesliga
179,Jiloan Hamad,126,84.0,42,66.66666666666666,17,7,10,41.17647058823529,80,66,14,82.5,7,2,5,28.57142857142857,17.7151617248,2,0,2,0.0,2,0,6,2,2,0,5,Hoffenheim,7,Germany - 1. Bundesliga
180,Jin-Su Kim,662,480.0,182,72.50755287009063,83,47,36,56.62650602409639,288,256,32,88.88888888888889,95,34,61,35.78947368421053,19.237084002804835,9,5,4,55.55555555555556,4,0,15,5,6,2,20,Hoffenheim,15,Germany - 1. Bundesliga
181,Joel Gerezgiher,31,15.0,16,48.38709677419355,9,4,5,44.44444444444444,17,11,6,64.70588235294117,3,1,2,33.33333333333333,17.48576618860645,0,0,0,0.0,1,0,3,2,1,0,2,Eintracht Frankfurt,3,Germany - 1. Bundesliga
182,Joelinton Cassio Apolinário de Lira,3,2.0,1,66.66666666666666,0,0,0,0.0,1,1,0,100.0,0,0,0,0.0,14.8769140104,0,0,0,0.0,0,0,0,0,0,0,0,Hoffenheim,1,Germany - 1. Bundesliga
183,Johan Danon Djourou-Gbadjere,1123,933.0,190,83.08103294746215,112,50,62,44.642857142857146,570,552,18,96.84210526315789,186,86,100,46.236559139784944,24.32788465478233,3,1,2,33.33333333333333,1,0,2,1,0,0,12,Hamburger SV,26,Germany - 1. Bundesliga
184,Johannes Flum,80,54.0,26,67.5,14,3,11,21.428571428571427,38,31,7,81.57894736842105,11,6,5,54.54545454545454,18.213781629006,3,2,1,66.66666666666666,0,1,0,0,0,0,6,Eintracht Frankfurt,5,Germany - 1. Bundesliga
185,Johannes Geis,1701,1307.0,394,76.83715461493239,315,174,141,55.23809523809524,792,762,30,96.21212121212122,481,219,262,45.53014553014553,24.862833304231533,42,16,26,38.095238095238095,52,5,10,8,2,2,57,Schalke 04,28,Germany - 1. Bundesliga
186,Johannes van den Bergh,98,69.0,29,70.40816326530613,9,6,3,66.66666666666666,63,55,8,87.3015873015873,11,2,9,18.181818181818183,17.081795230420408,8,2,6,25.0,2,1,2,1,0,0,3,Hertha Berlin,13,Germany - 1. Bundesliga
187,John Anthony Brooks,1211,1039.0,172,85.79686209744013,116,59,57,50.86206896551724,640,623,17,97.34375,126,42,84,33.33333333333333,25.008292003704376,0,0,0,0.0,1,1,8,3,1,0,21,Hertha Berlin,22,Germany - 1. Bundesliga
188,Jonas Hector,1853,1469.0,384,79.27684835402052,181,117,64,64.64088397790056,997,926,71,92.87863590772318,226,85,141,37.610619469026545,18.88271781360246,48,22,26,45.83333333333333,49,4,44,31,19,11,53,FC Köln,32,Germany - 1. Bundesliga
189,Jonas Hofmann,252,201.0,51,79.76190476190477,27,21,6,77.77777777777779,187,164,23,87.70053475935828,16,8,8,50.0,15.882496509917143,11,4,7,36.36363636363637,9,3,17,10,11,6,13,Borussia Mönchengladbach,15,Germany - 1. Bundesliga
190,Jonathan Schmid,419,285.0,134,68.01909307875896,44,21,23,47.72727272727273,230,196,34,85.21739130434783,63,18,45,28.57142857142857,17.342583439609545,23,5,18,21.73913043478261,24,0,23,6,13,3,25,Hoffenheim,23,Germany - 1. Bundesliga
191,Jonathan Tah,1194,951.0,243,79.64824120603015,160,90,70,56.25,621,596,25,95.97423510466989,148,59,89,39.86486486486486,22.091745255565023,1,0,1,0.0,4,0,16,8,2,1,26,Bayer Leverkusen,29,Germany - 1. Bundesliga
192,Joo-Ho Park,308,263.0,45,85.3896103896104,37,26,11,70.27027027027027,194,187,7,96.3917525773196,20,6,14,30.0,15.779683380649091,3,2,1,66.66666666666666,2,0,4,3,0,0,10,Borussia Dortmund,6,Germany - 1. Bundesliga
193,Joshua Kimmich,1527,1408.0,119,92.20694171578258,196,156,40,79.59183673469387,1107,1074,33,97.01897018970189,110,71,39,64.54545454545455,18.571775884953244,7,1,6,14.285714285714285,7,2,12,10,4,2,29,Bayern Munich,22,Germany - 1. Bundesliga
194,Josip Drmic,279,188.0,91,67.38351254480287,23,11,12,47.82608695652174,148,117,31,79.05405405405406,12,7,5,58.333333333333336,13.907538709894194,8,1,7,12.5,5,0,22,8,7,4,5,Hamburger SV,19,Germany - 1. Bundesliga
195,Josuha Guilavogui,1449,1273.0,176,87.85369220151829,167,121,46,72.45508982035929,1022,970,52,94.9119373776908,85,51,34,60.0,18.640561829074286,6,2,4,33.33333333333333,18,0,20,12,4,2,30,Wolfsburg,30,Germany - 1. Bundesliga
196,Joël Andre Job Matip,1732,1447.0,285,83.54503464203233,242,144,98,59.50413223140496,1000,936,64,93.60000000000001,182,84,98,46.15384615384615,22.047118529312286,6,2,4,33.33333333333333,8,3,18,13,7,7,25,Schalke 04,34,Germany - 1. Bundesliga
197,Juan Bernat Velasco,948,845.0,103,89.13502109704642,90,73,17,81.11111111111111,673,642,31,95.39375928677563,42,19,23,45.23809523809524,15.724048777353417,18,4,14,22.22222222222222,7,1,27,14,10,4,16,Bayern Munich,16,Germany - 1. Bundesliga
198,Julian Baumgartlinger,1467,1228.0,239,83.70824812542604,185,115,70,62.16216216216216,947,896,51,94.61457233368532,120,68,52,56.666666666666664,17.313031262192148,6,2,4,33.33333333333333,19,1,17,11,5,4,64,FSV Mainz 05,31,Germany - 1. Bundesliga
199,Julian Brandt,735,544.0,191,74.01360544217687,47,30,17,63.829787234042556,473,399,74,84.35517970401692,45,13,32,28.888888888888886,13.99878138945208,26,11,15,42.30769230769231,29,3,56,28,35,15,24,Bayer Leverkusen,29,Germany - 1. Bundesliga
200,Julian Draxler,842,676.0,166,80.28503562945369,101,69,32,68.31683168316832,529,471,58,89.03591682419659,110,58,52,52.72727272727272,19.545699488219572,27,13,14,48.148148148148145,35,5,85,51,54,32,23,Wolfsburg,24,Germany - 1. Bundesliga
201,Julian Korb,759,588.0,171,77.4703557312253,88,61,27,69.31818181818183,445,390,55,87.64044943820225,37,7,30,18.91891891891892,16.002226346889486,15,3,12,20.0,6,1,14,8,11,6,15,Borussia Mönchengladbach,17,Germany - 1. Bundesliga
202,Julian Schieber,31,16.0,15,51.61290322580645,5,1,4,20.0,11,10,1,90.9090909090909,0,0,0,0.0,11.957256440384516,0,0,0,0.0,1,1,2,0,2,0,4,Hertha Berlin,6,Germany - 1. Bundesliga
203,Julian Weigl,2277,2097.0,180,92.09486166007905,282,231,51,81.91489361702128,1758,1697,61,96.5301478953356,108,63,45,58.333333333333336,18.068996680486638,4,4,0,100.0,15,0,25,17,7,3,66,Borussia Dortmund,30,Germany - 1. Bundesliga
204,Jérôme Boateng,1285,1100.0,185,85.60311284046692,226,149,77,65.929203539823,740,717,23,96.89189189189189,189,89,100,47.08994708994709,23.72211117554876,11,4,7,36.36363636363637,9,3,4,4,2,2,5,Bayern Munich,19,Germany - 1. Bundesliga
205,Jérôme Gondorf,872,521.0,351,59.747706422018354,186,82,104,44.086021505376344,331,247,84,74.62235649546828,140,50,90,35.714285714285715,18.29193503598578,17,8,9,47.05882352941176,12,4,37,25,11,7,73,Darmstadt 98,33,Germany - 1. Bundesliga
206,Júnior Enrique Díaz Campbell,275,168.0,107,61.09090909090909,65,33,32,50.76923076923077,53,45,8,84.90566037735849,57,25,32,43.859649122807014,21.112432854518747,11,1,10,9.090909090909092,4,0,4,0,2,0,9,Darmstadt 98,12,Germany - 1. Bundesliga
207,Kaan Ayhan,38,30.0,8,78.94736842105263,8,4,4,50.0,21,20,1,95.23809523809523,10,5,5,50.0,25.96527143071579,0,0,0,0.0,0,0,0,0,0,0,1,Eintracht Frankfurt,2,Germany - 1. Bundesliga
208,Karim Bellarabi,875,577.0,298,65.94285714285715,92,59,33,64.13043478260869,581,452,129,77.79690189328744,49,17,32,34.69387755102041,14.67941787071358,67,12,55,17.91044776119403,31,11,144,75,84,44,69,Bayer Leverkusen,33,Germany - 1. Bundesliga
209,Karim Onisiwo,72,44.0,28,61.111111111111114,6,1,5,16.666666666666664,39,29,10,74.35897435897436,8,4,4,50.0,16.52977246998,10,6,4,60.0,4,1,12,5,9,5,11,FSV Mainz 05,9,Germany - 1. Bundesliga
210,Kazuki Nagasawa,16,10.0,6,62.5,1,1,0,100.0,7,6,1,85.71428571428571,0,0,0,0.0,11.851942570515,1,0,1,0.0,0,0,0,0,0,0,1,FC Köln,1,Germany - 1. Bundesliga
211,Kenan Karaman,505,356.0,149,70.49504950495049,41,22,19,53.65853658536586,359,300,59,83.56545961002786,24,5,19,20.833333333333336,14.441061411549624,16,8,8,50.0,14,2,51,27,20,11,39,Hannover 96,23,Germany - 1. Bundesliga
212,Kevin De Bruyne,107,80.0,27,74.76635514018692,8,7,1,87.5,65,57,8,87.6923076923077,15,7,8,46.666666666666664,18.89961986829533,9,1,8,11.11111111111111,3,0,8,5,3,2,3,Wolfsburg,2,Germany - 1. Bundesliga
213,Kevin Großkreutz,448,339.0,109,75.66964285714286,48,28,20,58.333333333333336,212,180,32,84.90566037735849,32,9,23,28.125,16.303036975122858,17,7,10,41.17647058823529,6,0,5,3,3,1,7,VfB Stuttgart,10,Germany - 1. Bundesliga
214,Kevin Kampl,1050,848.0,202,80.76190476190476,174,104,70,59.77011494252874,741,661,80,89.20377867746289,69,27,42,39.130434782608695,16.830247807298743,15,7,8,46.666666666666664,15,2,38,24,22,13,21,Bayer Leverkusen,23,Germany - 1. Bundesliga
215,Kevin Kuranyi,183,105.0,78,57.377049180327866,21,8,13,38.095238095238095,80,54,26,67.5,6,4,2,66.66666666666666,13.577081832653114,1,0,1,0.0,4,0,13,5,7,2,8,Hoffenheim,14,Germany - 1. Bundesliga
216,Kevin Vogt,861,692.0,169,80.37166085946573,139,88,51,63.30935251798561,455,425,30,93.4065934065934,106,61,45,57.54716981132076,21.894282851822716,11,3,8,27.27272727272727,11,2,12,7,3,1,32,FC Köln,23,Germany - 1. Bundesliga
217,Kevin Volland,921,523.0,398,56.78610206297503,123,61,62,49.59349593495935,496,344,152,69.35483870967742,102,37,65,36.27450980392157,16.964740327276612,93,23,70,24.731182795698924,35,7,93,49,58,27,86,Hoffenheim,33,Germany - 1. Bundesliga
218,Kingsley Coman,878,704.0,174,80.18223234624145,24,15,9,62.5,639,585,54,91.54929577464789,58,22,36,37.93103448275862,15.38630403537485,98,37,61,37.755102040816325,31,6,92,63,69,48,59,Bayern Munich,23,Germany - 1. Bundesliga
219,Klaas-Jan Huntelaar,520,386.0,134,74.23076923076923,41,21,20,51.21951219512195,326,286,40,87.73006134969326,13,7,6,53.84615384615385,12.389903360932292,14,5,9,35.714285714285715,22,3,18,10,12,7,48,Schalke 04,31,Germany - 1. Bundesliga
220,Koen Casteels,486,352.0,134,72.42798353909465,27,7,20,25.925925925925924,201,201,0,100.0,229,100,129,43.66812227074236,35.80974639295111,0,0,0,0.0,0,0,0,0,0,0,1,Wolfsburg,13,Germany - 1. Bundesliga
221,Konstantin Engel,87,46.0,41,52.87356321839081,20,8,12,40.0,20,15,5,75.0,14,2,12,14.285714285714285,21.979564861431722,2,0,2,0.0,1,0,2,1,0,0,2,Ingolstadt,4,Germany - 1. Bundesliga
222,Konstantin Rausch,633,330.0,303,52.13270142180095,83,30,53,36.144578313253014,270,190,80,70.37037037037037,186,43,143,23.118279569892472,21.473297075826085,70,18,52,25.71428571428571,31,5,27,7,15,5,29,Darmstadt 98,31,Germany - 1. Bundesliga
223,Konstantinos Stafylidis,381,268.0,113,70.34120734908137,45,26,19,57.77777777777777,149,136,13,91.2751677852349,79,28,51,35.44303797468354,23.65020563208,21,6,15,28.57142857142857,3,0,8,6,3,1,6,Augsburg,11,Germany - 1. Bundesliga
224,Kyriakos Papadopoulos,381,282.0,99,74.01574803149606,33,13,20,39.39393939393939,185,173,12,93.51351351351352,37,6,31,16.216216216216218,19.35306090408,0,0,0,0.0,2,0,3,2,0,0,6,Bayer Leverkusen,16,Germany - 1. Bundesliga
225,Lars Bender,545,421.0,124,77.24770642201835,84,50,34,59.523809523809526,329,299,30,90.88145896656535,38,17,21,44.73684210526316,15.81835072668903,4,2,2,50.0,6,1,11,6,6,2,13,Bayer Leverkusen,11,Germany - 1. Bundesliga
226,Lars Edi Stindl,1413,1127.0,286,79.7593772116065,150,98,52,65.33333333333333,1040,904,136,86.92307692307692,40,19,21,47.5,14.088477979882345,24,7,17,29.166666666666668,49,8,48,21,30,11,71,Borussia Mönchengladbach,30,Germany - 1. Bundesliga
227,Leandro Putaro,12,9.0,3,75.0,2,1,1,50.0,7,7,0,100.0,0,0,0,0.0,12.429133096980001,0,0,0,0.0,0,0,3,1,2,0,0,Wolfsburg,4,Germany - 1. Bundesliga
228,Leon Aderemi Balogun,705,522.0,183,74.04255319148936,70,29,41,41.42857142857143,317,297,20,93.69085173501577,95,30,65,31.57894736842105,21.755252472373787,4,1,3,25.0,3,0,14,8,3,1,18,FSV Mainz 05,21,Germany - 1. Bundesliga
229,Leon Andreasen,389,269.0,120,69.1516709511568,65,35,30,53.84615384615385,187,166,21,88.77005347593582,62,22,40,35.483870967741936,19.28680237987126,12,3,9,25.0,12,1,6,3,2,2,12,Hannover 96,15,Germany - 1. Bundesliga
230,Leon Goretzka,952,783.0,169,82.24789915966386,86,52,34,60.46511627906976,586,539,47,91.97952218430035,56,27,29,48.214285714285715,16.74085071521647,7,1,6,14.285714285714285,22,3,48,29,13,6,39,Schalke 04,25,Germany - 1. Bundesliga
231,Leon Guwara,45,31.0,14,68.88888888888889,4,2,2,50.0,28,20,8,71.42857142857143,3,1,2,33.33333333333333,15.296396042656001,1,0,1,0.0,0,0,4,2,3,1,4,Werder Bremen,1,Germany - 1. Bundesliga
232,Leonardo Bittencourt,866,603.0,263,69.63048498845265,91,52,39,57.14285714285714,528,437,91,82.76515151515152,61,23,38,37.704918032786885,16.020912242085174,43,12,31,27.906976744186046,28,4,60,30,34,17,73,FC Köln,29,Germany - 1. Bundesliga
233,Leroy Sané,616,477.0,139,77.43506493506493,48,30,18,62.5,475,393,82,82.73684210526315,13,4,9,30.76923076923077,14.20509694854974,26,12,14,46.15384615384615,21,6,161,83,100,54,44,Schalke 04,33,Germany - 1. Bundesliga
234,Levin Mete Öztunali,375,231.0,144,61.6,23,15,8,65.21739130434783,232,163,69,70.25862068965517,19,9,10,47.368421052631575,13.4200642862592,39,14,25,35.8974358974359,15,3,73,36,43,21,22,Werder Bremen,25,Germany - 1. Bundesliga
235,Lewis Harry Holtby,1795,1382.0,413,76.991643454039,237,137,100,57.80590717299579,983,874,109,88.91149542217701,250,120,130,48.0,19.626287960652085,33,13,20,39.39393939393939,37,2,71,40,25,11,72,Hamburger SV,34,Germany - 1. Bundesliga
236,Loris Karius,1265,730.0,535,57.70750988142292,153,28,125,18.30065359477124,382,382,0,100.0,757,236,521,31.175693527080583,42.23668457176335,0,0,0,0.0,0,0,1,1,0,0,6,FSV Mainz 05,34,Germany - 1. Bundesliga
237,Luc Castaignos,208,137.0,71,65.86538461538461,22,5,17,22.727272727272727,124,95,29,76.61290322580645,7,0,7,0.0,13.016755198730769,7,1,6,14.285714285714285,6,1,15,11,9,7,16,Eintracht Frankfurt,19,Germany - 1. Bundesliga
238,Luca Caldirola,685,416.0,269,60.72992700729927,187,74,113,39.57219251336899,166,148,18,89.1566265060241,190,59,131,31.05263157894737,24.023937958164787,8,1,7,12.5,5,0,2,0,2,0,61,Darmstadt 98,34,Germany - 1. Bundesliga
239,Luca-Milan Zander,35,23.0,12,65.71428571428571,2,1,1,50.0,14,10,4,71.42857142857143,4,3,1,75.0,15.520166372283429,0,0,0,0.0,0,0,0,0,0,0,1,Werder Bremen,2,Germany - 1. Bundesliga
240,Luiz Gustavo Dias,1087,955.0,132,87.85648574057038,115,79,36,68.69565217391305,756,719,37,95.1058201058201,68,35,33,51.470588235294116,19.33377396983702,7,3,4,42.857142857142854,6,1,13,9,4,3,31,Wolfsburg,22,Germany - 1. Bundesliga
241,Lukas Fröde,50,29.0,21,57.99999999999999,5,2,3,40.0,13,12,1,92.3076923076923,6,2,4,33.33333333333333,15.3799764282,0,0,0,0.0,1,0,0,0,0,0,3,Werder Bremen,6,Germany - 1. Bundesliga
242,Lukas Hinterseer,543,328.0,215,60.40515653775322,51,21,30,41.17647058823529,307,231,76,75.2442996742671,14,3,11,21.428571428571427,11.830004680163668,12,3,9,25.0,11,0,36,8,26,6,40,Ingolstadt,28,Germany - 1. Bundesliga
243,Lukas Klünter,5,1.0,4,20.0,1,0,1,0.0,2,1,1,50.0,0,0,0,0.0,8.434986986736,0,0,0,0.0,0,0,0,0,0,0,0,FC Köln,1,Germany - 1. Bundesliga
244,Lukas Rupp,978,732.0,246,74.84662576687117,139,74,65,53.23741007194245,599,516,83,86.14357262103506,69,17,52,24.637681159420293,15.35334818851141,20,5,15,25.0,29,4,48,30,19,9,25,VfB Stuttgart,29,Germany - 1. Bundesliga
245,Lukáš Hrádecký,1342,828.0,514,61.698956780924,159,48,111,30.18867924528302,366,364,2,99.4535519125683,839,338,501,40.286054827175214,42.47603556785812,0,0,0,0.0,0,0,0,0,0,0,2,Eintracht Frankfurt,34,Germany - 1. Bundesliga
246,László Kleinheisler,78,59.0,19,75.64102564102564,13,8,5,61.53846153846154,49,44,5,89.79591836734694,9,3,6,33.33333333333333,16.866282907135385,5,1,4,20.0,1,0,10,5,3,1,7,Werder Bremen,6,Germany - 1. Bundesliga
247,Mahmoud Dahoud,1279,1071.0,208,83.73729476153244,129,86,43,66.66666666666666,890,808,82,90.78651685393258,58,31,27,53.44827586206896,17.46348789894136,1,1,0,100.0,23,7,36,28,11,8,41,Borussia Mönchengladbach,32,Germany - 1. Bundesliga
248,Makoto Hasebe,1412,1049.0,363,74.29178470254958,215,124,91,57.674418604651166,719,639,80,88.87343532684284,172,65,107,37.7906976744186,19.180559439174388,28,6,22,21.428571428571427,26,2,13,11,5,4,46,Eintracht Frankfurt,32,Germany - 1. Bundesliga
249,Manuel Neuer,1288,1071.0,217,83.15217391304348,55,11,44,20.0,665,661,4,99.3984962406015,373,171,202,45.84450402144772,29.937216269096833,0,0,0,0.0,0,0,2,2,0,0,2,Bayern Munich,34,Germany - 1. Bundesliga
250,Manuel Schmiedebach,1000,733.0,267,73.3,172,86,86,50.0,566,498,68,87.98586572438163,122,44,78,36.0655737704918,18.23885871625584,13,2,11,15.384615384615385,18,1,22,16,6,6,34,Hannover 96,22,Germany - 1. Bundesliga
251,Marc Stendera,1078,781.0,297,72.44897959183673,202,113,89,55.940594059405946,652,581,71,89.11042944785275,190,74,116,38.94736842105263,19.52242398061113,27,7,20,25.925925925925924,23,1,59,42,23,18,42,Eintracht Frankfurt,26,Germany - 1. Bundesliga
252,Marcel  Hilßner,12,7.0,5,58.333333333333336,3,1,2,33.33333333333333,6,6,0,100.0,3,1,2,33.33333333333333,18.9428288148,0,0,0,0.0,0,0,0,0,0,0,1,Werder Bremen,1,Germany - 1. Bundesliga
253,Marcel Hartel,48,34.0,14,70.83333333333334,0,0,0,0.0,33,27,6,81.81818181818183,3,0,3,0.0,16.386268235145,0,0,0,0.0,0,0,7,3,6,2,2,FC Köln,6,Germany - 1. Bundesliga
254,Marcel Heller,605,307.0,298,50.743801652892564,43,17,26,39.53488372093023,246,168,78,68.29268292682927,81,25,56,30.864197530864196,16.455574201320594,97,28,69,28.865979381443296,22,5,57,30,42,25,47,Darmstadt 98,33,Germany - 1. Bundesliga
255,Marcel Risse,1504,912.0,592,60.63829787234043,254,95,159,37.40157480314961,574,455,119,79.26829268292683,398,134,264,33.66834170854271,23.51282886739101,125,35,90,28.000000000000004,60,5,82,48,43,30,22,FC Köln,33,Germany - 1. Bundesliga
256,Marcel Schmelzer,1602,1320.0,282,82.39700374531836,125,92,33,73.6,1032,942,90,91.27906976744185,79,31,48,39.24050632911392,15.656923975835504,65,22,43,33.84615384615385,22,4,22,10,15,7,38,Borussia Dortmund,26,Germany - 1. Bundesliga
257,Marcel Schäfer,772,590.0,182,76.42487046632125,68,51,17,75.0,408,373,35,91.42156862745098,89,44,45,49.43820224719101,18.195747644197304,45,16,29,35.55555555555556,32,2,14,5,11,2,12,Wolfsburg,21,Germany - 1. Bundesliga
258,Marcelo Alfonso Díaz Rojas,377,319.0,58,84.61538461538461,55,41,14,74.54545454545455,233,215,18,92.27467811158799,41,18,23,43.90243902439025,19.253018434493793,2,0,2,0.0,6,0,3,1,2,0,6,Hamburger SV,11,Germany - 1. Bundesliga
259,Marcelo Antônio Guedes Filho,922,742.0,180,80.4772234273319,122,53,69,43.44262295081967,483,471,12,97.51552795031056,143,50,93,34.96503496503497,23.773931529871234,0,0,0,0.0,2,0,4,3,0,0,6,Hannover 96,19,Germany - 1. Bundesliga
260,Marco Höger,118,84.0,34,71.1864406779661,23,16,7,69.56521739130434,67,60,7,89.55223880597015,9,5,4,55.55555555555556,17.689110126717967,4,1,3,25.0,0,0,0,0,0,0,5,Schalke 04,5,Germany - 1. Bundesliga
261,Marco Jhonfai Fabián De La Mora,431,330.0,101,76.5661252900232,49,27,22,55.10204081632652,267,244,23,91.38576779026218,43,22,21,51.162790697674424,16.916013617203713,20,6,14,30.0,17,2,21,13,14,11,19,Eintracht Frankfurt,11,Germany - 1. Bundesliga
262,Marco Reus,814,650.0,164,79.85257985257985,63,39,24,61.904761904761905,596,531,65,89.09395973154362,54,19,35,35.18518518518518,15.434105937860345,37,14,23,37.83783783783784,42,3,65,31,43,20,36,Borussia Dortmund,26,Germany - 1. Bundesliga
263,Marco Russ,1021,815.0,206,79.82370225269344,125,73,52,58.4,572,545,27,95.27972027972028,87,29,58,33.33333333333333,18.916702289977433,5,0,5,0.0,4,2,16,9,5,3,30,Eintracht Frankfurt,28,Germany - 1. Bundesliga
264,Marco Sailer,66,38.0,28,57.57575757575758,8,1,7,12.5,30,25,5,83.33333333333334,3,0,3,0.0,13.950534594961091,2,0,2,0.0,3,0,4,1,2,0,9,Darmstadt 98,14,Germany - 1. Bundesliga
265,Mario Götze,547,470.0,77,85.92321755027422,45,32,13,71.11111111111111,433,400,33,92.37875288683603,20,9,11,45.0,12.974316251591517,18,7,11,38.88888888888889,14,4,27,18,16,12,16,Bayern Munich,14,Germany - 1. Bundesliga
266,Mario Vrančić,335,216.0,119,64.4776119402985,56,23,33,41.07142857142857,143,121,22,84.61538461538461,65,23,42,35.38461538461539,19.95003309332203,14,5,9,35.714285714285715,14,1,11,8,9,6,25,Darmstadt 98,22,Germany - 1. Bundesliga
267,Marius Wolf,16,8.0,8,50.0,2,0,2,0.0,7,6,1,85.71428571428571,2,0,2,0.0,17.588655169965,1,0,1,0.0,0,0,1,0,1,0,1,Hannover 96,2,Germany - 1. Bundesliga
268,Mark Uth,388,284.0,104,73.19587628865979,33,19,14,57.57575757575758,256,212,44,82.8125,20,8,12,40.0,15.392233220431548,9,3,6,33.33333333333333,14,1,38,16,26,9,23,Hoffenheim,25,Germany - 1. Bundesliga
269,Markus Feulner,441,316.0,125,71.65532879818595,53,27,26,50.943396226415096,199,174,25,87.43718592964824,49,17,32,34.69387755102041,18.8601419357551,23,6,17,26.08695652173913,7,0,21,11,12,6,20,Augsburg,19,Germany - 1. Bundesliga
270,Markus Suttner,618,385.0,233,62.297734627831716,123,60,63,48.78048780487805,163,145,18,88.95705521472392,164,54,110,32.926829268292686,23.402196740620195,38,11,27,28.947368421052634,15,0,14,10,10,6,5,Ingolstadt,18,Germany - 1. Bundesliga
271,Marlon Frey,97,69.0,28,71.1340206185567,19,15,4,78.94736842105263,42,38,4,90.47619047619048,13,9,4,69.23076923076923,19.333880829397113,0,0,0,0.0,0,0,5,4,4,3,2,Bayer Leverkusen,9,Germany - 1. Bundesliga
272,Mart Ristl,28,22.0,6,78.57142857142857,2,1,1,50.0,19,16,3,84.21052631578947,1,0,1,0.0,13.35225098766857,0,0,0,0.0,1,0,0,0,0,0,1,VfB Stuttgart,3,Germany - 1. Bundesliga
273,Martin Harnik,335,223.0,112,66.56716417910448,35,19,16,54.285714285714285,183,142,41,77.59562841530054,16,7,9,43.75,14.643786044219103,15,5,10,33.33333333333333,9,0,23,12,14,6,10,VfB Stuttgart,19,Germany - 1. Bundesliga
274,Martin Hinteregger,414,327.0,87,78.98550724637681,45,24,21,53.333333333333336,251,228,23,90.83665338645417,40,9,31,22.5,19.133926668956523,4,1,3,25.0,1,0,3,1,1,0,3,Borussia Mönchengladbach,10,Germany - 1. Bundesliga
275,Martin Stranzl,119,104.0,15,87.39495798319328,4,1,3,25.0,75,73,2,97.33333333333334,11,3,8,27.27272727272727,20.271686466191596,1,0,1,0.0,0,0,0,0,0,0,3,Borussia Mönchengladbach,3,Germany - 1. Bundesliga
276,Marvin Friedrich,1,0.0,1,0.0,0,0,0,0.0,0,0,0,0.0,1,0,1,0.0,65.019948192,1,0,1,0.0,0,0,0,0,0,0,0,Schalke 04,2,Germany - 1. Bundesliga
277,Marvin Matip,1056,811.0,245,76.79924242424242,136,62,74,45.588235294117645,488,461,27,94.4672131147541,148,49,99,33.108108108108105,21.678728403401593,5,1,4,20.0,5,1,4,4,1,1,24,Ingolstadt,33,Germany - 1. Bundesliga
278,Marvin Plattenhardt,1774,1359.0,415,76.6065388951522,179,117,62,65.36312849162012,873,820,53,93.92898052691866,234,67,167,28.63247863247863,18.924564541521306,96,21,75,21.875,29,4,31,12,19,7,41,Hertha Berlin,33,Germany - 1. Bundesliga
279,Marvin Schulz,267,239.0,28,89.51310861423221,15,9,6,60.0,206,195,11,94.66019417475728,11,0,11,0.0,18.980764732740674,0,0,0,0.0,0,1,0,0,0,0,3,Borussia Mönchengladbach,8,Germany - 1. Bundesliga
280,Marvin Wanitzek,5,4.0,1,80.0,1,0,1,0.0,1,1,0,100.0,0,0,0,0.0,16.24073301504,0,0,0,0.0,0,0,0,0,0,0,0,VfB Stuttgart,1,Germany - 1. Bundesliga
281,Marwin Hitz,1229,795.0,434,64.68673718470302,160,50,110,31.25,357,355,2,99.43977591036415,748,326,422,43.58288770053476,44.17547441925325,0,0,0,0.0,1,0,0,0,0,0,9,Augsburg,33,Germany - 1. Bundesliga
282,Mathew Leckie,926,646.0,280,69.76241900647948,104,54,50,51.92307692307693,497,421,76,84.70824949698189,43,15,28,34.883720930232556,14.11197869690203,28,9,19,32.142857142857146,29,0,121,63,61,27,60,Ingolstadt,32,Germany - 1. Bundesliga
283,Matija Nastasić,6,6.0,0,100.0,0,0,0,0.0,5,5,0,100.0,0,0,0,0.0,19.472629507799997,0,0,0,0.0,0,0,0,0,0,0,0,Schalke 04,1,Germany - 1. Bundesliga
284,Mats Hummels,2349,2019.0,330,85.9514687100894,320,185,135,57.8125,1583,1523,60,96.20972836386608,222,80,142,36.03603603603604,21.09746398325318,7,2,5,28.57142857142857,5,2,18,10,7,1,20,Borussia Dortmund,30,Germany - 1. Bundesliga
285,Matthias Ginter,1336,1094.0,242,81.88622754491018,104,66,38,63.46153846153846,795,730,65,91.82389937106919,70,31,39,44.285714285714285,16.865203423297906,45,17,28,37.77777777777778,13,4,18,11,11,6,28,Borussia Dortmund,24,Germany - 1. Bundesliga
286,Matthias Lehmann,1363,1116.0,247,81.8782098312546,212,122,90,57.54716981132076,802,761,41,94.88778054862843,143,59,84,41.25874125874126,19.671400537152987,6,1,5,16.666666666666664,16,2,7,5,2,2,34,FC Köln,32,Germany - 1. Bundesliga
287,Matthias Ostrzolek,1634,1183.0,451,72.39902080783354,197,104,93,52.79187817258884,715,617,98,86.2937062937063,216,73,143,33.7962962962963,18.86766545500788,54,20,34,37.03703703703704,22,2,41,22,19,6,61,Hamburger SV,32,Germany - 1. Bundesliga
288,Matthias Zimmermann,79,53.0,26,67.08860759493672,9,3,6,33.33333333333333,32,27,5,84.375,13,2,11,15.384615384615385,19.189233839137213,3,0,3,0.0,1,0,3,2,1,0,0,VfB Stuttgart,2,Germany - 1. Bundesliga
289,Maurice Multhaup,18,13.0,5,72.22222222222221,0,0,0,0.0,8,8,0,100.0,1,0,1,0.0,12.78085999576,1,0,1,0.0,0,0,0,0,0,0,5,Ingolstadt,4,Germany - 1. Bundesliga
290,Max Christiansen,457,310.0,147,67.83369803063457,66,43,23,65.15151515151516,236,202,34,85.59322033898306,51,18,33,35.294117647058826,16.228636203346344,14,3,11,21.428571428571427,8,1,13,5,5,1,27,Ingolstadt,18,Germany - 1. Bundesliga
291,Max Kruse,1119,895.0,224,79.98212689901698,100,73,27,73.0,707,619,88,87.55304101838756,98,72,26,73.46938775510205,17.486255770945416,49,15,34,30.612244897959183,45,6,54,33,27,17,19,Wolfsburg,32,Germany - 1. Bundesliga
292,Max Meyer,1023,856.0,167,83.67546432062561,94,66,28,70.2127659574468,785,710,75,90.44585987261146,43,17,26,39.53488372093023,15.122767559065338,12,2,10,16.666666666666664,37,6,59,36,36,24,58,Schalke 04,32,Germany - 1. Bundesliga
293,Maximilian Arnold,1252,1055.0,197,84.26517571884983,174,113,61,64.9425287356322,810,750,60,92.5925925925926,126,69,57,54.761904761904766,19.741141399872077,15,6,9,40.0,44,2,16,13,4,3,87,Wolfsburg,31,Germany - 1. Bundesliga
294,Maximilian Beister,1,0.0,1,0.0,1,0,1,0.0,1,0,1,0.0,0,0,0,0.0,15.5952785376,0,0,0,0.0,0,0,0,0,0,0,1,FSV Mainz 05,1,Germany - 1. Bundesliga
295,Maximilian Eggestein,62,44.0,18,70.96774193548387,10,5,5,50.0,37,31,6,83.78378378378379,5,2,3,40.0,16.54724064868258,1,1,0,100.0,4,0,1,1,1,1,2,Werder Bremen,7,Germany - 1. Bundesliga
296,Maximilian Mittelstädt,73,56.0,17,76.71232876712328,11,5,6,45.45454545454545,45,39,6,86.66666666666667,8,3,5,37.5,18.505234132007672,2,2,0,100.0,1,1,2,0,1,0,3,Hertha Berlin,3,Germany - 1. Bundesliga
297,Medhi Amine El Mouttaqi Benatia,822,740.0,82,90.02433090024331,61,37,24,60.65573770491803,620,603,17,97.25806451612902,43,16,27,37.2093023255814,18.367762414297225,0,0,0,0.0,1,1,4,4,0,0,8,Bayern Munich,14,Germany - 1. Bundesliga
298,Melvyn Lorenzen,24,13.0,11,54.166666666666664,0,0,0,0.0,16,9,7,56.25,0,0,0,0.0,14.51240166348,2,1,1,50.0,0,0,9,3,2,1,4,Werder Bremen,9,Germany - 1. Bundesliga
299,Mevlüt Erdinç,49,40.0,9,81.63265306122449,2,1,1,50.0,28,25,3,89.28571428571429,1,1,0,100.0,12.531657671338774,1,0,1,0.0,3,1,10,3,8,3,8,Hannover 96,11,Germany - 1. Bundesliga
300,Michael Gregoritsch,595,372.0,223,62.52100840336134,114,45,69,39.473684210526315,269,221,48,82.15613382899627,36,7,29,19.444444444444446,15.029299521744806,10,2,8,20.0,18,0,21,9,7,2,27,Hamburger SV,25,Germany - 1. Bundesliga
301,Miiko Martín Albornoz Inola,1039,747.0,292,71.89605389797883,145,80,65,55.172413793103445,405,363,42,89.62962962962962,211,76,135,36.018957345971565,20.300121734230913,56,13,43,23.214285714285715,29,1,28,18,14,10,40,Hannover 96,23,Germany - 1. Bundesliga
302,Mijat Gaćinović,123,72.0,51,58.536585365853654,11,3,8,27.27272727272727,73,55,18,75.34246575342466,16,2,14,12.5,17.84901930923122,7,0,7,0.0,2,0,10,2,7,1,9,Eintracht Frankfurt,7,Germany - 1. Bundesliga
303,Mike-Steven Bähre,4,3.0,1,75.0,0,0,0,0.0,3,3,0,100.0,0,0,0,0.0,11.617629393600001,0,0,0,0.0,0,0,1,0,0,0,0,Hannover 96,1,Germany - 1. Bundesliga
304,Milos Veljkovic,18,14.0,4,77.77777777777779,1,1,0,100.0,8,7,1,87.5,3,1,2,33.33333333333333,20.0613983836,0,0,0,0.0,0,0,1,0,0,0,1,Werder Bremen,3,Germany - 1. Bundesliga
305,Miloš Jojić,222,155.0,67,69.81981981981981,21,11,10,52.38095238095239,117,98,19,83.76068376068376,37,16,21,43.24324324324324,17.838133163017297,9,2,7,22.22222222222222,15,0,14,7,7,4,7,FC Köln,15,Germany - 1. Bundesliga
306,Miloš Pantović,1,1.0,0,100.0,1,1,0,100.0,0,0,0,0.0,0,0,0,0.0,38.954942359200004,0,0,0,0.0,0,0,0,0,0,0,0,Bayern Munich,1,Germany - 1. Bundesliga
307,Mitchell James Langerak,57,31.0,26,54.385964912280706,6,4,2,66.66666666666666,10,10,0,100.0,36,12,24,33.33333333333333,45.085441724715785,0,0,0,0.0,0,0,0,0,0,0,0,VfB Stuttgart,2,Germany - 1. Bundesliga
308,Mitchell Weiser,1228,888.0,340,72.31270358306189,125,63,62,50.4,661,553,108,83.66111951588502,99,28,71,28.28282828282828,15.899282997415446,48,11,37,22.916666666666664,17,4,97,52,47,23,69,Hertha Berlin,29,Germany - 1. Bundesliga
309,Moritz Hartmann,574,367.0,207,63.937282229965156,46,21,25,45.65217391304348,307,246,61,80.13029315960912,30,10,20,33.33333333333333,13.24501253199345,22,6,16,27.27272727272727,19,1,24,11,12,7,39,Ingolstadt,30,Germany - 1. Bundesliga
310,Moritz Leitner,244,213.0,31,87.29508196721312,28,27,1,96.42857142857143,176,169,7,96.02272727272727,17,9,8,52.94117647058824,16.81290948103967,5,0,5,0.0,4,1,9,6,2,1,8,Borussia Dortmund,9,Germany - 1. Bundesliga
311,Mustafa Batuhan Altıntaş,6,4.0,2,66.66666666666666,1,0,1,0.0,2,2,0,100.0,0,0,0,0.0,14.5197598098,0,0,0,0.0,0,0,0,0,0,0,0,Hamburger SV,1,Germany - 1. Bundesliga
312,Márcio Rafael Ferreira de Souza,1920,1755.0,165,91.40625,214,180,34,84.11214953271028,1384,1338,46,96.67630057803468,93,55,38,59.13978494623656,17.053164563862374,40,16,24,40.0,15,2,21,9,13,5,25,Bayern Munich,25,Germany - 1. Bundesliga
313,Mërgim Mavraj,387,331.0,56,85.52971576227391,33,16,17,48.484848484848484,225,219,6,97.33333333333334,39,14,25,35.8974358974359,22.647696280383258,0,0,0,0.0,0,0,2,1,0,0,12,FC Köln,11,Germany - 1. Bundesliga
314,Nabil Bahoui,56,31.0,25,55.35714285714286,4,2,2,50.0,21,17,4,80.95238095238095,12,5,7,41.66666666666667,18.82519855367143,2,0,2,0.0,3,0,4,4,2,2,1,Hamburger SV,6,Germany - 1. Bundesliga
315,Nadiem Amiri,630,463.0,167,73.4920634920635,65,41,24,63.07692307692307,401,343,58,85.53615960099751,76,24,52,31.57894736842105,18.45089220601943,23,11,12,47.82608695652174,31,4,57,27,21,10,41,Hoffenheim,25,Germany - 1. Bundesliga
316,Neven Subotić,454,398.0,56,87.66519823788546,49,29,20,59.183673469387756,299,289,10,96.65551839464884,40,18,22,45.0,21.167612972057974,1,0,1,0.0,2,0,1,1,0,0,4,Borussia Dortmund,6,Germany - 1. Bundesliga
317,Nicklas Bendtner,104,70.0,34,67.3076923076923,16,6,10,37.5,59,47,12,79.66101694915254,4,1,3,25.0,15.3971808642,1,0,1,0.0,3,0,1,0,1,0,4,Wolfsburg,13,Germany - 1. Bundesliga
318,Nico Elvedi,1063,888.0,175,83.53715898400753,99,65,34,65.65656565656566,669,631,38,94.31988041853513,42,11,31,26.190476190476193,15.967732581637026,6,2,4,33.33333333333333,2,2,14,8,4,1,17,Borussia Mönchengladbach,21,Germany - 1. Bundesliga
319,Nico Rinderknecht,2,2.0,0,100.0,0,0,0,0.0,2,2,0,100.0,0,0,0,0.0,11.4793567974,0,0,0,0.0,0,0,0,0,0,0,0,Eintracht Frankfurt,1,Germany - 1. Bundesliga
320,Nico Schulz,15,11.0,4,73.33333333333333,2,0,2,0.0,10,7,3,70.0,1,0,1,0.0,14.566140802127999,0,0,0,0.0,1,0,4,1,3,1,1,Borussia Mönchengladbach,2,Germany - 1. Bundesliga
321,Nicolai Müller,686,463.0,223,67.4927113702624,81,46,35,56.79012345679012,429,339,90,79.02097902097903,30,7,23,23.333333333333332,14.490410291668443,27,11,16,40.74074074074074,20,5,64,32,26,13,38,Hamburger SV,29,Germany - 1. Bundesliga
322,Niklas Stark,794,688.0,106,86.64987405541562,69,42,27,60.86956521739131,464,446,18,96.12068965517241,65,25,40,38.46153846153847,21.65374882573209,0,0,0,0.0,1,0,7,5,2,1,30,Hertha Berlin,21,Germany - 1. Bundesliga
323,Niklas Süle,1691,1441.0,250,85.21584861028977,166,92,74,55.42168674698795,1070,1035,35,96.72897196261682,173,71,102,41.040462427745666,21.970920475739323,2,1,1,50.0,5,0,3,3,0,0,21,Hoffenheim,33,Germany - 1. Bundesliga
324,Niko Bungert,873,729.0,144,83.50515463917526,90,39,51,43.333333333333336,464,449,15,96.76724137931035,96,38,58,39.58333333333333,22.24726976108454,0,0,0,0.0,1,0,3,2,0,0,15,FSV Mainz 05,20,Germany - 1. Bundesliga
325,Noah-Joel Sarenren-Bazee,60,30.0,30,50.0,4,0,4,0.0,28,18,10,64.28571428571429,2,1,1,50.0,12.534379800887999,8,4,4,50.0,3,3,11,10,8,8,10,Hannover 96,5,Germany - 1. Bundesliga
326,Nuri Şahin,509,452.0,57,88.8015717092338,68,50,18,73.52941176470588,395,377,18,95.44303797468355,27,14,13,51.85185185185185,17.516964104296267,1,0,1,0.0,5,2,2,1,0,0,10,Borussia Dortmund,9,Germany - 1. Bundesliga
327,Odisseas Vlachodimos,60,39.0,21,65.0,3,1,2,33.33333333333333,24,24,0,100.0,32,11,21,34.375,37.20202250208,0,0,0,0.0,0,0,0,0,0,0,0,VfB Stuttgart,3,Germany - 1. Bundesliga
328,Oliver Baumann,1478,941.0,537,63.667117726657644,171,31,140,18.128654970760234,559,557,2,99.6422182468694,777,257,520,33.07593307593308,39.09304628825699,0,0,0,0.0,2,0,0,0,0,0,6,Hoffenheim,33,Germany - 1. Bundesliga
329,Oliver Hüsing,1,0.0,1,0.0,0,0,0,0.0,0,0,0,0.0,1,0,1,0.0,35.489674512,0,0,0,0.0,0,0,0,0,0,0,0,Werder Bremen,1,Germany - 1. Bundesliga
330,Oliver Sorg,747,524.0,223,70.14725568942436,119,55,64,46.21848739495798,314,288,26,91.71974522292994,108,29,79,26.851851851851855,19.190801785898795,16,3,13,18.75,6,0,15,6,4,2,25,Hannover 96,20,Germany - 1. Bundesliga
331,Oscar Wendt,1740,1356.0,384,77.93103448275862,179,93,86,51.955307262569825,1015,935,80,92.11822660098522,151,37,114,24.503311258278146,17.22836089321324,53,18,35,33.9622641509434,25,2,29,16,16,9,16,Borussia Mönchengladbach,30,Germany - 1. Bundesliga
332,Pablo Ezequiel De Blasis,622,405.0,217,65.11254019292605,100,50,50,50.0,306,243,63,79.41176470588235,74,34,40,45.94594594594595,17.411479665372347,33,10,23,30.303030303030305,17,4,52,27,30,16,33,FSV Mainz 05,26,Germany - 1. Bundesliga
333,Papiss Mison Djilobodji,667,447.0,220,67.01649175412294,159,69,90,43.39622641509434,291,273,18,93.81443298969072,177,60,117,33.89830508474576,26.30866878924018,7,2,5,28.57142857142857,7,0,12,12,4,4,10,Werder Bremen,14,Germany - 1. Bundesliga
334,Pascal Groß,2026,1275.0,751,62.93188548864757,427,193,234,45.19906323185012,889,727,162,81.77727784026997,494,176,318,35.62753036437247,20.78048638872622,112,28,84,25.0,95,4,32,24,22,14,57,Ingolstadt,32,Germany - 1. Bundesliga
335,Patrick Herrmann,222,158.0,64,71.17117117117117,15,7,8,46.666666666666664,151,120,31,79.47019867549669,9,5,4,55.55555555555556,14.491244735127568,12,5,7,41.66666666666667,10,1,14,6,10,3,22,Borussia Mönchengladbach,18,Germany - 1. Bundesliga
336,Paul Seguin,76,57.0,19,75.0,8,3,5,37.5,47,46,1,97.87234042553192,10,2,8,20.0,17.587856689114734,3,1,2,33.33333333333333,1,0,1,0,0,0,2,Wolfsburg,4,Germany - 1. Bundesliga
337,Paul Verhaegh,1325,1064.0,261,80.30188679245282,165,94,71,56.96969696969697,668,620,48,92.81437125748504,165,61,104,36.96969696969697,20.01480098849769,46,14,32,30.434782608695656,16,2,9,6,6,4,19,Augsburg,25,Germany - 1. Bundesliga
338,Pavel Kadeřábek,1045,747.0,298,71.48325358851675,124,61,63,49.193548387096776,432,373,59,86.3425925925926,106,28,78,26.41509433962264,17.557926701054537,47,12,35,25.53191489361702,10,1,18,10,13,6,27,Hoffenheim,28,Germany - 1. Bundesliga
339,Paweł Olkowski,545,379.0,166,69.54128440366972,64,32,32,50.0,259,224,35,86.48648648648648,58,15,43,25.862068965517242,17.339719978538422,14,4,10,28.57142857142857,2,0,17,6,10,2,15,FC Köln,19,Germany - 1. Bundesliga
340,Per Ciljan Skjelbred,1551,1318.0,233,84.97743391360413,153,99,54,64.70588235294117,1032,967,65,93.7015503875969,83,42,41,50.602409638554214,17.507611433156054,5,0,5,0.0,6,2,22,18,3,3,39,Hertha Berlin,31,Germany - 1. Bundesliga
341,Peter Niemeyer,703,394.0,309,56.04551920341394,181,73,108,40.331491712707184,211,178,33,84.36018957345972,114,38,76,33.33333333333333,19.17325164601823,2,0,2,0.0,5,0,3,2,1,1,51,Darmstadt 98,31,Germany - 1. Bundesliga
342,Peter Pekarík,611,475.0,136,77.74140752864157,77,52,25,67.53246753246754,278,256,22,92.08633093525181,66,31,35,46.96969696969697,17.049989588264484,27,11,16,40.74074074074074,5,1,20,8,11,5,16,Hertha Berlin,12,Germany - 1. Bundesliga
343,Philip Heise,90,66.0,24,73.33333333333333,14,8,6,57.14285714285714,38,31,7,81.57894736842105,16,7,9,43.75,20.799902446848,2,1,1,50.0,0,0,4,1,2,0,6,VfB Stuttgart,5,Germany - 1. Bundesliga
344,Philipp Bargfrede,511,375.0,136,73.38551859099805,87,43,44,49.42528735632184,263,241,22,91.63498098859316,53,18,35,33.9622641509434,19.1150163897027,2,0,2,0.0,5,1,8,4,1,0,22,Werder Bremen,14,Germany - 1. Bundesliga
345,Philipp Hosiner,154,106.0,48,68.83116883116884,13,6,7,46.15384615384615,73,61,12,83.56164383561644,14,3,11,21.428571428571427,14.956260173812986,11,2,9,18.181818181818183,4,0,9,5,7,4,11,FC Köln,15,Germany - 1. Bundesliga
346,Philipp Lahm,2127,1924.0,203,90.45604137282558,213,173,40,81.2206572769953,1475,1412,63,95.72881355932203,114,71,43,62.28070175438597,17.132681127021495,37,14,23,37.83783783783784,46,1,15,10,10,6,21,Bayern Munich,26,Germany - 1. Bundesliga
347,Philipp Max,1031,761.0,270,73.81183317167799,114,55,59,48.24561403508772,459,415,44,90.41394335511983,148,51,97,34.45945945945946,19.66243686178801,66,23,43,34.84848484848485,14,0,9,4,5,1,21,Augsburg,26,Germany - 1. Bundesliga
348,Philipp Ochs,246,183.0,63,74.39024390243902,20,12,8,60.0,152,126,26,82.89473684210526,16,1,15,6.25,15.55046118049756,2,0,2,0.0,6,1,6,3,3,2,5,Hoffenheim,13,Germany - 1. Bundesliga
349,Phillipp Klement,24,17.0,7,70.83333333333334,3,1,2,33.33333333333333,16,15,1,93.75,5,0,5,0.0,20.98423436241,0,0,0,0.0,0,0,0,0,0,0,0,FSV Mainz 05,2,Germany - 1. Bundesliga
350,Pierre Bengtsson,714,508.0,206,71.1484593837535,104,49,55,47.11538461538461,292,262,30,89.72602739726028,104,30,74,28.846153846153843,20.16311778221244,17,5,12,29.411764705882355,9,0,10,2,9,1,12,FSV Mainz 05,16,Germany - 1. Bundesliga
351,Pierre-Emerick Aubameyang,552,367.0,185,66.48550724637681,30,12,18,40.0,333,271,62,81.38138138138137,19,7,12,36.84210526315789,12.95841769350913,50,17,33,34.0,25,5,28,14,21,10,16,Borussia Dortmund,31,Germany - 1. Bundesliga
352,Pierre-Emile Højbjerg,783,682.0,101,87.10089399744572,106,79,27,74.52830188679245,553,523,30,94.57504520795659,64,39,25,60.9375,18.04975740150345,3,1,2,33.33333333333333,6,1,26,15,8,3,36,Schalke 04,23,Germany - 1. Bundesliga
353,Pierre-Michel Lasogga,491,336.0,155,68.43177189409369,64,26,38,40.625,250,202,48,80.80000000000001,16,7,9,43.75,13.555529345874866,13,2,11,15.384615384615385,16,2,28,15,14,7,34,Hamburger SV,30,Germany - 1. Bundesliga
354,Piotr Trochowski,77,60.0,17,77.92207792207793,14,8,6,57.14285714285714,47,44,3,93.61702127659575,12,4,8,33.33333333333333,19.03911906672,1,0,1,0.0,3,0,1,0,1,0,5,Augsburg,5,Germany - 1. Bundesliga
355,Pirmin Schwegler,743,597.0,146,80.34993270524899,91,52,39,57.14285714285714,467,438,29,93.79014989293361,69,24,45,34.78260869565217,17.797149132679138,6,1,5,16.666666666666664,9,0,13,7,4,1,30,Hoffenheim,21,Germany - 1. Bundesliga
356,Przemysław Tytoń,919,549.0,370,59.73884657236126,115,29,86,25.217391304347824,270,268,2,99.25925925925925,547,184,363,33.63802559414991,42.690431264623285,0,0,0,0.0,1,0,0,0,0,0,3,VfB Stuttgart,30,Germany - 1. Bundesliga
357,Raffael Caetano de Araújo,1184,948.0,236,80.06756756756756,98,65,33,66.3265306122449,842,742,100,88.12351543942994,77,30,47,38.961038961038966,14.493379501219255,38,12,26,31.57894736842105,49,10,88,55,48,27,68,Borussia Mönchengladbach,31,Germany - 1. Bundesliga
358,Ragnar Klavan,1501,1266.0,235,84.3437708194537,173,80,93,46.24277456647399,844,823,21,97.51184834123224,220,82,138,37.27272727272727,25.4597701933132,2,2,0,100.0,6,0,2,2,0,0,16,Augsburg,31,Germany - 1. Bundesliga
359,Ralf Fährmann,1333,901.0,432,67.59189797449362,102,27,75,26.47058823529412,437,435,2,99.54233409610984,721,302,419,41.88626907073509,39.4651515685633,0,0,0,0.0,0,0,0,0,0,0,5,Schalke 04,34,Germany - 1. Bundesliga
360,Ramazan Özcan,1102,515.0,587,46.73321234119782,502,157,345,31.274900398406373,148,147,1,99.32432432432432,893,314,579,35.162374020156776,55.54173999647303,0,0,0,0.0,0,0,4,3,0,0,8,Ingolstadt,28,Germany - 1. Bundesliga
361,Raúl Marcelo Bobadilla,506,384.0,122,75.8893280632411,39,27,12,69.23076923076923,295,254,41,86.10169491525423,49,23,26,46.93877551020408,15.776780620758544,20,6,14,30.0,26,2,69,41,43,24,65,Augsburg,27,Germany - 1. Bundesliga
362,René Adler,831,434.0,397,52.226233453670275,113,11,102,9.734513274336283,175,173,2,98.85714285714286,562,176,386,31.316725978647685,45.1216946663792,0,0,0,0.0,0,1,1,1,0,0,4,Hamburger SV,24,Germany - 1. Bundesliga
363,Ricardo Iván Rodríguez Araya,1563,1266.0,297,80.99808061420346,154,103,51,66.88311688311688,903,854,49,94.57364341085271,254,121,133,47.63779527559055,20.39509237424361,68,19,49,27.941176470588236,33,3,24,19,5,4,19,Wolfsburg,24,Germany - 1. Bundesliga
364,Robbie Kruse,170,114.0,56,67.05882352941175,10,4,6,40.0,101,84,17,83.16831683168317,9,0,9,0.0,11.64339646080353,11,1,10,9.090909090909092,5,0,5,1,4,1,16,VfB Stuttgart,12,Germany - 1. Bundesliga
365,Robert Bauer,724,462.0,262,63.812154696132595,142,73,69,51.40845070422535,239,206,33,86.19246861924687,126,36,90,28.57142857142857,20.089479749910165,16,5,11,31.25,7,0,11,8,5,3,29,Ingolstadt,24,Germany - 1. Bundesliga
366,Robert Lewandowski,765,608.0,157,79.47712418300654,51,33,18,64.70588235294117,583,505,78,86.62092624356775,17,8,9,47.05882352941176,13.011162914005459,13,2,11,15.384615384615385,16,2,53,29,38,21,55,Bayern Munich,32,Germany - 1. Bundesliga
367,Roberto Hilbert,467,299.0,168,64.02569593147751,95,46,49,48.421052631578945,188,156,32,82.97872340425532,90,31,59,34.44444444444444,21.18376363015041,19,6,13,31.57894736842105,6,1,23,16,11,7,7,Bayer Leverkusen,12,Germany - 1. Bundesliga
368,Robin Knoche,608,528.0,80,86.8421052631579,46,23,23,50.0,398,380,18,95.47738693467338,60,23,37,38.333333333333336,22.026756671737104,0,0,0,0.0,3,0,2,1,0,0,5,Wolfsburg,11,Germany - 1. Bundesliga
369,Roel Brouwers,185,173.0,12,93.51351351351352,5,4,1,80.0,142,138,4,97.1830985915493,3,0,3,0.0,19.607517829198702,0,0,0,0.0,0,0,1,0,1,0,2,Borussia Mönchengladbach,8,Germany - 1. Bundesliga
370,Roger de Oliveira Bernardo,811,542.0,269,66.83107274969173,183,70,113,38.25136612021858,307,279,28,90.87947882736157,129,38,91,29.457364341085274,20.83789205527472,4,0,4,0.0,6,0,24,18,5,3,85,Ingolstadt,29,Germany - 1. Bundesliga
371,Romain Brégerie,378,246.0,132,65.07936507936508,88,45,43,51.13636363636363,132,118,14,89.39393939393939,71,25,46,35.2112676056338,21.364636920918286,2,0,2,0.0,4,0,1,0,0,0,7,Ingolstadt,21,Germany - 1. Bundesliga
372,Roman Bürki,1012,770.0,242,76.08695652173914,73,7,66,9.58904109589041,532,528,4,99.24812030075188,332,101,231,30.42168674698795,33.08966004794727,0,0,0,0.0,0,0,2,2,0,0,6,Borussia Dortmund,33,Germany - 1. Bundesliga
373,Roman Neustädter,1418,1270.0,148,89.56276445698167,103,65,38,63.10679611650486,924,891,33,96.42857142857143,89,36,53,40.44943820224719,20.987667390214103,0,0,0,0.0,3,0,6,4,0,0,10,Schalke 04,30,Germany - 1. Bundesliga
374,Roman Weidenfeller,29,18.0,11,62.06896551724138,2,0,2,0.0,12,12,0,100.0,16,5,11,31.25,36.33604520151724,0,0,0,0.0,0,0,0,0,0,0,0,Borussia Dortmund,1,Germany - 1. Bundesliga
375,Ron-Robert Zieler,1227,841.0,386,68.54115729421353,152,38,114,25.0,389,387,2,99.48586118251927,632,256,376,40.50632911392405,39.744196445129774,0,0,0,0.0,0,0,0,0,0,0,5,Hannover 96,34,Germany - 1. Bundesliga
376,Ronaldo Aparecido Rodrigues,1790,1552.0,238,86.70391061452514,197,119,78,60.40609137055838,1153,1113,40,96.53078924544666,171,80,91,46.783625730994146,21.05128881466029,4,2,2,50.0,9,0,11,11,2,2,26,Wolfsburg,29,Germany - 1. Bundesliga
377,Ronny Heberson Furtado de Araújo,10,8.0,2,80.0,2,2,0,100.0,7,6,1,85.71428571428571,3,2,1,66.66666666666666,19.047274252848002,0,0,0,0.0,0,0,0,0,0,0,1,Hertha Berlin,1,Germany - 1. Bundesliga
378,Roy Beerens,25,18.0,7,72.0,2,1,1,50.0,19,14,5,73.68421052631578,2,2,0,100.0,14.285604222028802,3,2,1,66.66666666666666,1,0,2,1,1,1,2,Hertha Berlin,2,Germany - 1. Bundesliga
379,Rune Almenning Jarstein,1399,878.0,521,62.75911365260901,171,34,137,19.883040935672515,464,462,2,99.56896551724138,773,265,508,34.28201811125485,41.67767628121098,0,0,0,0.0,0,0,1,1,0,0,4,Hertha Berlin,29,Germany - 1. Bundesliga
380,Russell Canouse,8,7.0,1,87.5,1,0,1,0.0,6,6,0,100.0,1,0,1,0.0,18.3800399607,0,0,0,0.0,0,0,0,0,0,0,0,Hoffenheim,1,Germany - 1. Bundesliga
381,Salif Sané,1531,1177.0,354,76.87785760940562,253,137,116,54.1501976284585,859,801,58,93.24796274738067,167,69,98,41.31736526946108,19.457198937273937,11,4,7,36.36363636363637,9,0,46,33,7,5,63,Hannover 96,31,Germany - 1. Bundesliga
382,Salomon Armand Magloire Kalou,666,511.0,155,76.72672672672672,65,39,26,60.0,469,397,72,84.64818763326227,23,9,14,39.130434782608695,13.673370467619245,25,7,18,28.000000000000004,20,2,81,43,46,25,42,Hertha Berlin,32,Germany - 1. Bundesliga
383,Sambou Yatabaré,223,127.0,96,56.95067264573991,25,14,11,56.00000000000001,92,70,22,76.08695652173914,28,10,18,35.714285714285715,17.10170644232696,25,4,21,16.0,5,1,20,14,12,9,8,Werder Bremen,8,Germany - 1. Bundesliga
384,Sandro Sirigu,28,9.0,19,32.142857142857146,3,1,2,33.33333333333333,16,7,9,43.75,6,0,6,0.0,20.757850096757146,3,2,1,66.66666666666666,0,2,2,1,0,0,0,Darmstadt 98,5,Germany - 1. Bundesliga
385,Sandro Wagner,914,453.0,461,49.562363238512035,172,64,108,37.2093023255814,292,232,60,79.45205479452055,65,26,39,40.0,15.127110332640077,25,6,19,24.0,18,3,31,14,16,7,78,Darmstadt 98,32,Germany - 1. Bundesliga
386,Santiago García,1304,896.0,408,68.71165644171779,185,85,100,45.94594594594595,467,410,57,87.79443254817987,181,66,115,36.46408839779006,19.625715831336073,61,21,40,34.42622950819672,28,2,34,21,18,11,68,Werder Bremen,29,Germany - 1. Bundesliga
387,Sascha Mölders,7,2.0,5,28.57142857142857,2,0,2,0.0,2,1,1,50.0,0,0,0,0.0,12.737002407942855,0,0,0,0.0,0,0,1,0,1,0,0,Augsburg,4,Germany - 1. Bundesliga
388,Sascha Riether,813,647.0,166,79.58179581795818,92,53,39,57.608695652173914,406,379,27,93.34975369458128,95,32,63,33.68421052631579,19.37350836857535,35,8,27,22.857142857142858,11,0,6,0,3,0,8,Schalke 04,17,Germany - 1. Bundesliga
389,Sead Kolašinac,990,760.0,230,76.76767676767676,89,52,37,58.42696629213483,508,437,71,86.0236220472441,74,30,44,40.54054054054054,16.589145307181166,30,14,16,46.666666666666664,15,0,24,12,17,8,18,Schalke 04,23,Germany - 1. Bundesliga
390,Sebastian Boenisch,383,250.0,133,65.27415143603133,76,36,40,47.368421052631575,134,112,22,83.5820895522388,51,12,39,23.52941176470588,18.818001876717492,11,2,9,18.181818181818183,3,0,6,5,2,1,6,Bayer Leverkusen,8,Germany - 1. Bundesliga
391,Sebastian Jung,374,299.0,75,79.94652406417111,36,22,14,61.111111111111114,206,183,23,88.83495145631069,37,17,20,45.94594594594595,18.4649148842169,17,10,7,58.82352941176471,11,1,9,7,4,3,6,Wolfsburg,11,Germany - 1. Bundesliga
392,Sebastian Langkamp,1190,1024.0,166,86.05042016806723,97,46,51,47.42268041237113,744,718,26,96.50537634408603,119,45,74,37.81512605042017,21.710165836256472,0,0,0,0.0,2,1,4,3,1,1,31,Hertha Berlin,22,Germany - 1. Bundesliga
393,Sebastian Rode,311,273.0,38,87.78135048231512,27,22,5,81.48148148148148,234,222,12,94.87179487179486,11,7,4,63.63636363636363,15.563076826531834,2,1,1,50.0,2,1,5,4,3,2,5,Bayern Munich,15,Germany - 1. Bundesliga
394,Sebastian Rudy,964,733.0,231,76.03734439834025,147,87,60,59.183673469387756,613,532,81,86.7862969004894,99,52,47,52.52525252525253,18.103097714857096,13,3,10,23.076923076923077,19,1,26,13,8,1,26,Hoffenheim,24,Germany - 1. Bundesliga
395,Serdar Taşçı,194,173.0,21,89.17525773195877,15,11,4,73.33333333333333,150,147,3,98.0,6,4,2,66.66666666666666,17.301877790247836,0,0,0,0.0,0,0,1,1,0,0,1,Bayern Munich,3,Germany - 1. Bundesliga
396,Sereso Geoffroy Gonzaroua Dié,956,798.0,158,83.47280334728033,136,85,51,62.5,627,568,59,90.59011164274322,85,42,43,49.411764705882355,19.778187331211047,8,2,6,25.0,15,2,60,39,23,13,28,VfB Stuttgart,23,Germany - 1. Bundesliga
397,Shinji Kagawa,1436,1218.0,218,84.81894150417827,158,120,38,75.9493670886076,1056,977,79,92.51893939393939,99,68,31,68.68686868686868,15.483541399835767,27,10,17,37.03703703703704,32,7,43,25,22,12,42,Borussia Dortmund,29,Germany - 1. Bundesliga
398,Sidney Sam,9,5.0,4,55.55555555555556,2,1,1,50.0,8,4,4,50.0,0,0,0,0.0,11.142877201120001,0,0,0,0.0,0,0,0,0,0,0,1,Schalke 04,2,Germany - 1. Bundesliga
399,Simon Zoller,276,189.0,87,68.47826086956522,21,10,11,47.61904761904761,151,125,26,82.78145695364239,15,4,11,26.666666666666668,15.464808368175651,19,5,14,26.31578947368421,8,1,13,5,9,4,12,FC Köln,24,Germany - 1. Bundesliga
400,Slobodan Medojević,252,199.0,53,78.96825396825396,33,19,14,57.57575757575758,174,157,17,90.22988505747126,10,2,8,20.0,16.00091036286,3,0,3,0.0,3,1,4,4,2,2,9,Eintracht Frankfurt,12,Germany - 1. Bundesliga
401,Slobodan Rajković,212,118.0,94,55.660377358490564,58,18,40,31.03448275862069,45,38,7,84.44444444444444,65,20,45,30.76923076923077,25.038149943824152,0,0,0,0.0,1,1,2,2,0,0,9,Darmstadt 98,14,Germany - 1. Bundesliga
402,Sokratis Papastathopoulos,1862,1671.0,191,89.7422126745435,157,89,68,56.68789808917197,1341,1317,24,98.2102908277405,116,31,85,26.72413793103448,19.816104560815297,3,1,2,33.33333333333333,3,0,8,7,2,2,32,Borussia Dortmund,25,Germany - 1. Bundesliga
403,Sonny Kittel,95,62.0,33,65.26315789473685,9,3,6,33.33333333333333,53,41,12,77.35849056603774,7,2,5,28.57142857142857,14.716256625473685,4,2,2,50.0,1,0,6,3,5,2,9,Eintracht Frankfurt,8,Germany - 1. Bundesliga
404,Stefan Aigner,762,541.0,221,70.99737532808399,52,24,28,46.15384615384615,439,363,76,82.6879271070615,47,15,32,31.914893617021278,14.123126975279998,51,16,35,31.372549019607842,18,4,48,18,25,10,56,Eintracht Frankfurt,31,Germany - 1. Bundesliga
405,Stefan Bell,1563,1229.0,334,78.63083813179782,211,86,125,40.758293838862556,759,720,39,94.86166007905138,277,98,179,35.37906137184115,24.32828322974096,2,0,2,0.0,3,2,13,10,1,0,17,FSV Mainz 05,30,Germany - 1. Bundesliga
406,Stefan Kießling,634,398.0,236,62.77602523659306,85,30,55,35.294117647058826,264,210,54,79.54545454545455,19,4,15,21.052631578947366,11.700113054714915,6,2,4,33.33333333333333,10,3,42,15,34,12,74,Bayer Leverkusen,30,Germany - 1. Bundesliga
407,Stefan Lex,160,99.0,61,61.875,14,5,9,35.714285714285715,84,65,19,77.38095238095238,9,2,7,22.22222222222222,13.6670571219906,12,2,10,16.666666666666664,14,0,7,2,5,2,21,Ingolstadt,20,Germany - 1. Bundesliga
408,Stefan Reinartz,841,706.0,135,83.94768133174792,116,71,45,61.206896551724135,544,506,38,93.01470588235294,76,43,33,56.57894736842105,18.405127497024687,0,0,0,0.0,5,1,6,4,1,1,6,Eintracht Frankfurt,15,Germany - 1. Bundesliga
409,Stefan Wannenwetsch,9,6.0,3,66.66666666666666,0,0,0,0.0,7,5,2,71.42857142857143,0,0,0,0.0,11.65343868952,0,0,0,0.0,0,0,0,0,0,0,0,Ingolstadt,1,Germany - 1. Bundesliga
410,Steven Zuber,220,148.0,72,67.27272727272727,17,9,8,52.94117647058824,136,104,32,76.47058823529412,18,7,11,38.88888888888889,14.651975628772362,11,3,8,27.27272727272727,7,0,22,10,13,7,9,Hoffenheim,12,Germany - 1. Bundesliga
411,Suat Serdar,82,64.0,18,78.04878048780488,7,3,4,42.857142857142854,58,49,9,84.48275862068965,5,5,0,100.0,16.816911516992192,1,0,1,0.0,1,0,6,5,2,1,5,FSV Mainz 05,12,Germany - 1. Bundesliga
412,Sven Bender,1163,1053.0,110,90.54170249355116,131,95,36,72.51908396946564,873,855,18,97.9381443298969,68,29,39,42.64705882352941,18.28608762399725,1,0,1,0.0,7,0,9,7,3,2,8,Borussia Dortmund,19,Germany - 1. Bundesliga
413,Sven Schipplock,257,171.0,86,66.53696498054474,22,13,9,59.09090909090909,141,118,23,83.68794326241135,9,3,6,33.33333333333333,13.379555567578834,8,4,4,50.0,10,4,16,5,8,2,24,Hamburger SV,20,Germany - 1. Bundesliga
414,Sven Ulreich,18,12.0,6,66.66666666666666,0,0,0,0.0,7,7,0,100.0,9,3,6,33.33333333333333,32.76575445312,0,0,0,0.0,0,0,0,0,0,0,0,Bayern Munich,1,Germany - 1. Bundesliga
415,Szabolcs Huszti,678,474.0,204,69.91150442477876,100,49,51,49.0,367,328,39,89.3732970027248,132,42,90,31.818181818181817,18.94196422046867,46,17,29,36.95652173913043,32,1,18,6,6,2,36,Eintracht Frankfurt,15,Germany - 1. Bundesliga
416,Takashi Inui,10,7.0,3,70.0,0,0,0,0.0,6,5,1,83.33333333333334,1,1,0,100.0,15.631447181544,1,1,0,100.0,1,0,1,0,0,0,1,Eintracht Frankfurt,1,Germany - 1. Bundesliga
417,Tarik Elyounoussi,160,117.0,43,73.125,15,9,6,60.0,113,93,20,82.30088495575221,8,3,5,37.5,14.2415746869105,9,3,6,33.33333333333333,5,1,10,6,4,1,13,Hoffenheim,6,Germany - 1. Bundesliga
418,Theodor Gebre Selassie,1419,1030.0,389,72.58632840028189,140,87,53,62.142857142857146,580,521,59,89.82758620689654,99,34,65,34.34343434343434,16.508361094180465,47,21,26,44.680851063829785,23,2,23,10,11,6,49,Werder Bremen,33,Germany - 1. Bundesliga
419,Thiago Alcântara do Nascimento,1590,1396.0,194,87.79874213836479,210,161,49,76.66666666666667,1117,1052,65,94.18084153983885,163,101,62,61.963190184049076,18.327919577557132,16,8,8,50.0,32,3,56,42,18,13,45,Bayern Munich,27,Germany - 1. Bundesliga
420,Thomas Kessler,27,16.0,11,59.25925925925925,1,1,0,100.0,2,2,0,100.0,21,10,11,47.61904761904761,51.34676006133333,0,0,0,0.0,0,0,1,1,0,0,0,FC Köln,1,Germany - 1. Bundesliga
421,Thomas Kraft,247,150.0,97,60.72874493927125,25,6,19,24.0,81,81,0,100.0,139,45,94,32.37410071942446,41.63026211583158,0,0,0,0.0,0,0,0,0,0,0,3,Hertha Berlin,6,Germany - 1. Bundesliga
422,Thomas Müller,1112,846.0,266,76.07913669064749,89,59,30,66.29213483146067,733,621,112,84.72032742155525,47,19,28,40.42553191489361,15.058722529390144,51,22,29,43.13725490196079,57,3,49,29,32,19,35,Bayern Munich,31,Germany - 1. Bundesliga
423,Thorgan Hazard,823,600.0,223,72.90400972053463,65,41,24,63.07692307692307,516,433,83,83.91472868217055,87,32,55,36.7816091954023,16.809180132203256,36,6,30,16.666666666666664,31,3,57,38,37,24,29,Borussia Mönchengladbach,29,Germany - 1. Bundesliga
424,Tim Dierßen,3,1.0,2,33.33333333333333,1,0,1,0.0,1,1,0,100.0,1,0,1,0.0,28.081462963199996,1,0,1,0.0,0,0,0,0,0,0,0,Hannover 96,1,Germany - 1. Bundesliga
425,Tim Matavž,71,43.0,28,60.56338028169014,7,2,5,28.57142857142857,33,27,6,81.81818181818183,3,1,2,33.33333333333333,13.348167441566197,8,2,6,25.0,4,0,6,5,3,2,12,Augsburg,11,Germany - 1. Bundesliga
426,Timm Klose,485,434.0,51,89.48453608247424,40,24,16,60.0,295,286,9,96.94915254237289,41,21,20,51.21951219512195,22.19815697061229,0,0,0,0.0,0,0,2,2,0,0,4,Wolfsburg,8,Germany - 1. Bundesliga
427,Timo Baumgartl,688,544.0,144,79.06976744186046,104,45,59,43.269230769230774,377,354,23,93.89920424403184,92,24,68,26.08695652173913,22.150824814413838,0,0,0,0.0,0,0,2,0,0,0,19,VfB Stuttgart,19,Germany - 1. Bundesliga
428,Timo Horn,1003,597.0,406,59.52143569292123,193,60,133,31.088082901554404,272,270,2,99.26470588235294,635,238,397,37.480314960629926,46.2992680617509,0,0,0,0.0,1,0,0,0,0,0,10,FC Köln,33,Germany - 1. Bundesliga
429,Timo Werner,562,382.0,180,67.97153024911033,47,20,27,42.5531914893617,331,271,60,81.87311178247734,16,5,11,31.25,12.795723093277152,31,6,25,19.35483870967742,17,3,48,18,33,13,48,VfB Stuttgart,33,Germany - 1. Bundesliga
430,Timothy Chandler,309,202.0,107,65.37216828478964,52,25,27,48.07692307692308,117,97,20,82.90598290598291,50,18,32,36.0,18.57648261840932,20,6,14,30.0,0,0,5,1,4,1,14,Eintracht Frankfurt,12,Germany - 1. Bundesliga
431,Tin Jedvaj,470,321.0,149,68.29787234042554,102,54,48,52.94117647058824,200,171,29,85.5,56,20,36,35.714285714285715,19.533302494371572,11,4,7,36.36363636363637,4,0,13,7,7,4,13,Bayer Leverkusen,15,Germany - 1. Bundesliga
432,Tobias Kempe,437,237.0,200,54.23340961098398,61,26,35,42.62295081967213,170,136,34,80.0,106,36,70,33.9622641509434,19.312466412639544,36,12,24,33.33333333333333,26,3,32,15,16,5,16,Darmstadt 98,31,Germany - 1. Bundesliga
433,Tobias Levels,928,725.0,203,78.125,96,51,45,53.125,379,339,40,89.44591029023746,81,27,54,33.33333333333333,16.719863259426205,19,6,13,31.57894736842105,5,2,12,7,9,5,18,Ingolstadt,16,Germany - 1. Bundesliga
434,Tobias Sippel,75,56.0,19,74.66666666666667,8,0,8,0.0,47,47,0,100.0,22,3,19,13.636363636363635,32.3795150484096,0,0,0,0.0,0,0,0,0,0,0,0,Borussia Mönchengladbach,2,Germany - 1. Bundesliga
435,Tobias Strobl,1128,926.0,202,82.09219858156028,145,85,60,58.620689655172406,668,620,48,92.81437125748504,116,57,59,49.137931034482754,19.227241114153404,18,7,11,38.88888888888889,10,1,18,8,7,1,37,Hoffenheim,26,Germany - 1. Bundesliga
436,Tobias Werner,193,116.0,77,60.10362694300518,16,6,10,37.5,74,63,11,85.13513513513513,53,17,36,32.075471698113205,21.36943613928124,17,6,11,35.294117647058826,15,1,8,5,4,3,7,Augsburg,13,Germany - 1. Bundesliga
437,Tohouri Zahoui Constant Djakpa,413,266.0,147,64.40677966101694,77,36,41,46.75324675324675,166,146,20,87.95180722891565,79,23,56,29.11392405063291,20.605222067334626,19,4,15,21.052631578947366,7,0,11,3,7,2,10,Eintracht Frankfurt,11,Germany - 1. Bundesliga
438,Tolga Ciğerci,664,540.0,124,81.32530120481928,63,37,26,58.730158730158735,412,384,28,93.20388349514563,68,24,44,35.294117647058826,18.816456763056145,13,5,8,38.46153846153847,7,2,27,15,10,4,20,Hertha Berlin,18,Germany - 1. Bundesliga
439,Tom Mickel,24,17.0,7,70.83333333333334,8,4,4,50.0,4,4,0,100.0,17,10,7,58.82352941176471,49.4399085495,0,0,0,0.0,0,0,0,0,0,0,0,Hamburger SV,1,Germany - 1. Bundesliga
440,Tomáš Pekhart,19,14.0,5,73.68421052631578,4,2,2,50.0,7,7,0,100.0,0,0,0,0.0,13.717791319225263,1,1,0,100.0,1,0,0,0,0,0,0,Ingolstadt,4,Germany - 1. Bundesliga
441,Toni Šunjić,516,401.0,115,77.71317829457365,50,27,23,54.0,264,253,11,95.83333333333334,59,23,36,38.983050847457626,20.02995031139163,0,0,0,0.0,2,0,4,4,0,0,12,VfB Stuttgart,19,Germany - 1. Bundesliga
442,Tony Jantschke,607,500.0,107,82.37232289950576,55,28,27,50.90909090909091,412,379,33,91.99029126213593,39,12,27,30.76923076923077,18.804336910244718,1,0,1,0.0,2,0,0,0,0,0,14,Borussia Mönchengladbach,12,Germany - 1. Bundesliga
443,Uffe Manich Bech,212,147.0,65,69.33962264150944,19,8,11,42.10526315789473,118,99,19,83.89830508474576,14,6,8,42.857142857142854,13.751866452341886,15,4,11,26.666666666666668,8,1,15,5,9,4,12,Hannover 96,11,Germany - 1. Bundesliga
444,Uilson de Souza Paula Júnior,1285,962.0,323,74.86381322957199,139,91,48,65.46762589928058,679,580,99,85.41973490427098,107,45,62,42.05607476635514,16.68222362723841,54,23,31,42.592592592592595,36,3,40,17,23,11,13,Schalke 04,23,Germany - 1. Bundesliga
445,Ulisses Alexandre Garcia Lopes,243,174.0,69,71.60493827160494,32,15,17,46.875,148,126,22,85.13513513513513,18,8,10,44.44444444444444,17.529282025063704,11,4,7,36.36363636363637,5,0,17,9,9,4,6,Werder Bremen,11,Germany - 1. Bundesliga
446,Valentin Stocker,212,125.0,87,58.9622641509434,21,5,16,23.809523809523807,108,83,25,76.85185185185185,20,6,14,30.0,16.513316849151508,15,4,11,26.666666666666668,8,0,19,8,15,5,8,Hertha Berlin,20,Germany - 1. Bundesliga
447,Valmir Sulejmani,33,20.0,13,60.60606060606061,6,4,2,66.66666666666666,23,18,5,78.26086956521739,0,0,0,0.0,12.874268795018182,2,0,2,0.0,0,0,4,2,3,2,3,Hannover 96,4,Germany - 1. Bundesliga
448,Vedad Ibišević,571,392.0,179,68.65148861646234,83,41,42,49.39759036144578,303,235,68,77.55775577557755,24,15,9,62.5,13.678011882151313,7,1,6,14.285714285714285,17,4,33,15,19,10,43,Hertha Berlin,26,Germany - 1. Bundesliga
449,Vladimír Darida,1710,1356.0,354,79.2982456140351,166,97,69,58.43373493975904,1082,985,97,91.03512014787431,171,66,105,38.59649122807017,17.092492587669472,43,6,37,13.953488372093023,33,2,25,18,11,9,56,Hertha Berlin,31,Germany - 1. Bundesliga
450,Vladlen Yurchenko,156,124.0,32,79.48717948717949,34,21,13,61.76470588235294,91,84,7,92.3076923076923,26,13,13,50.0,19.06600426196769,0,0,0,0.0,3,0,0,0,0,0,3,Bayer Leverkusen,7,Germany - 1. Bundesliga
451,Václav Kadlec,15,13.0,2,86.66666666666667,2,1,1,50.0,9,9,0,100.0,0,0,0,0.0,18.875010875759997,1,0,1,0.0,0,0,2,0,1,0,3,Eintracht Frankfurt,5,Germany - 1. Bundesliga
452,Waldemar Anton,246,187.0,59,76.01626016260163,29,17,12,58.620689655172406,146,128,18,87.67123287671232,30,12,18,40.0,18.32901796377073,1,0,1,0.0,1,0,2,2,0,0,5,Hannover 96,8,Germany - 1. Bundesliga
453,Wendell Nascimento Borges,1584,1201.0,383,75.82070707070707,190,114,76,60.0,795,704,91,88.55345911949686,165,55,110,33.33333333333333,16.70146556662591,39,8,31,20.51282051282051,18,0,39,18,24,10,42,Bayer Leverkusen,28,Germany - 1. Bundesliga
454,Xabier Alonso Olano,2351,2105.0,246,89.53636750319014,347,259,88,74.63976945244957,1729,1662,67,96.12492770387507,214,117,97,54.67289719626168,18.72525473282885,16,3,13,18.75,39,2,5,3,2,0,40,Bayern Munich,26,Germany - 1. Bundesliga
455,Yann Sommer,1375,961.0,414,69.89090909090909,80,14,66,17.5,612,610,2,99.67320261437908,559,158,401,28.264758497316638,35.07898080602304,0,0,0,0.0,0,0,0,0,0,0,2,Borussia Mönchengladbach,32,Germany - 1. Bundesliga
456,Yanni Regäsel,676,503.0,173,74.40828402366864,89,58,31,65.1685393258427,293,261,32,89.07849829351537,66,18,48,27.27272727272727,17.525527911151244,25,5,20,20.0,7,0,16,5,9,1,15,Eintracht Frankfurt,16,Germany - 1. Bundesliga
457,Yannick Gerhardt,795,616.0,179,77.48427672955975,94,61,33,64.8936170212766,505,450,55,89.10891089108911,56,18,38,32.142857142857146,18.36836756996649,24,7,17,29.166666666666668,18,4,43,22,22,11,52,FC Köln,29,Germany - 1. Bundesliga
458,Yoshinori Muto,265,182.0,83,68.67924528301886,25,12,13,48.0,169,129,40,76.33136094674556,12,6,6,50.0,12.71953462893283,14,8,6,57.14285714285714,10,2,39,19,27,13,25,FSV Mainz 05,20,Germany - 1. Bundesliga
459,Younès Belhanda,408,321.0,87,78.67647058823529,43,26,17,60.46511627906976,290,253,37,87.24137931034483,31,16,15,51.61290322580645,15.028656497408823,6,2,4,33.33333333333333,19,1,32,17,17,9,14,Schalke 04,15,Germany - 1. Bundesliga
460,Yunus Mallı,873,620.0,253,71.01947308132875,97,58,39,59.79381443298969,555,459,96,82.70270270270271,36,15,21,41.66666666666667,14.748726348872989,32,10,22,31.25,38,4,109,49,66,27,47,FSV Mainz 05,34,Germany - 1. Bundesliga
461,Yūya Ōsako,487,366.0,121,75.15400410677618,76,46,30,60.526315789473685,286,251,35,87.76223776223776,40,25,15,62.5,16.858670029126078,23,9,14,39.130434782608695,17,0,28,18,19,12,42,FC Köln,25,Germany - 1. Bundesliga
462,Zlatko Junuzović,1071,679.0,392,63.39869281045751,171,78,93,45.614035087719294,497,423,74,85.11066398390342,289,103,186,35.6401384083045,21.266320098805377,71,22,49,30.985915492957744,69,9,45,21,26,10,59,Werder Bremen,30,Germany - 1. Bundesliga
463,Zoltán Stieber,2,2.0,0,100.0,0,0,0,0.0,2,2,0,100.0,0,0,0,0.0,18.112531669200003,0,0,0,0.0,0,0,0,0,0,0,0,Hamburger SV,1,Germany - 1. Bundesliga
464,Ádám Szalai,264,182.0,82,68.93939393939394,29,19,10,65.51724137931035,149,122,27,81.87919463087249,4,1,3,25.0,12.447379921617273,7,0,7,0.0,8,1,26,18,13,9,12,Hannover 96,16,Germany - 1. Bundesliga
465,Álvaro Domínguez Soto,302,246.0,56,81.45695364238411,39,11,28,28.205128205128204,184,183,1,99.45652173913044,45,12,33,26.666666666666668,23.09972379862649,0,0,0,0.0,1,0,2,1,1,0,8,Borussia Mönchengladbach,6,Germany - 1. Bundesliga
466,Änis Ben-Hatira,168,115.0,53,68.45238095238095,24,11,13,45.83333333333333,98,82,16,83.6734693877551,12,7,5,58.333333333333336,15.72145446870857,9,5,4,55.55555555555556,3,1,26,15,12,6,17,Eintracht Frankfurt,9,Germany - 1. Bundesliga
467,Ömer Toprak,722,554.0,168,76.73130193905817,116,58,58,50.0,361,342,19,94.73684210526315,142,57,85,40.140845070422536,22.342279331374403,0,0,0,0.0,6,0,8,6,0,0,13,Bayer Leverkusen,19,Germany - 1. Bundesliga
468,Özkan Yıldırım,7,7.0,0,100.0,0,0,0,0.0,7,7,0,100.0,0,0,0,0.0,9.016666090148572,0,0,0,0.0,0,0,1,0,0,0,0,Werder Bremen,1,Germany - 1. Bundesliga
469,Ørjan Håskjold Nyland,214,93.0,121,43.45794392523364,96,29,67,30.208333333333332,17,16,1,94.11764705882352,186,68,118,36.55913978494624,58.046074902706536,0,0,0,0.0,0,0,0,0,0,0,0,Ingolstadt,6,Germany - 1. Bundesliga
470,İlkay Gündoğan,2007,1760.0,247,87.69307424015945,292,217,75,74.31506849315068,1492,1409,83,94.43699731903486,131,58,73,44.274809160305345,18.191332028757667,13,3,10,23.076923076923077,20,3,66,48,23,15,51,Borussia Dortmund,25,Germany - 1. Bundesliga
471,Łukasz Piszczek,1281,1055.0,226,82.35753317720531,124,90,34,72.58064516129032,847,777,70,91.73553719008265,77,31,46,40.25974025974026,16.308692615983137,34,11,23,32.35294117647059,16,3,15,9,4,0,11,Borussia Dortmund,20,Germany - 1. Bundesliga
472,Łukasz Załuska,32,19.0,13,59.375,5,2,3,40.0,1,1,0,100.0,27,15,12,55.55555555555556,51.16351172535,0,0,0,0.0,0,0,0,0,0,0,0,Darmstadt 98,1,Germany - 1. Bundesliga
0,Aaron Mattia Tabacchi,9,6.0,3,66.66666666666666,0,0,0,0.0,4,4,0,100.0,1,1,0,100.0,21.567552191199997,3,0,3,0.0,1,0,0,0,0,0,0,Bologna,1,Italy - Serie A
1,Abdelhamid El Kaoutari,271,223.0,48,82.28782287822878,36,19,17,52.77777777777778,159,152,7,95.59748427672956,28,11,17,39.285714285714285,18.349814983007825,0,0,0,0.0,2,0,4,2,0,0,5,Palermo,7,Italy - Serie A
2,Abdoulay Konko,1065,817.0,248,76.71361502347418,147,84,63,57.14285714285714,596,543,53,91.10738255033557,111,35,76,31.53153153153153,16.383644109026704,33,7,26,21.21212121212121,7,0,32,21,17,11,10,Lazio,18,Italy - Serie A
3,Accursio Bentivegna,6,4.0,2,66.66666666666666,1,1,0,100.0,5,4,1,80.0,0,0,0,0.0,11.455161986759999,1,0,1,0.0,0,0,1,1,1,1,0,Palermo,1,Italy - Serie A
4,Achraf Lazaar,1357,911.0,446,67.13338246131173,214,119,95,55.60747663551402,637,550,87,86.34222919937206,225,64,161,28.444444444444443,18.661941987050493,92,19,73,20.652173913043477,17,1,80,44,28,12,40,Palermo,30,Italy - Serie A
5,Adam Masina,1570,1161.0,409,73.94904458598725,190,85,105,44.73684210526316,793,706,87,89.02900378310214,156,51,105,32.69230769230769,17.112954882419817,44,14,30,31.818181818181817,22,3,53,27,30,11,32,Bologna,33,Italy - Serie A
6,Adem Ljajić,906,749.0,157,82.6710816777042,73,52,21,71.23287671232876,666,605,61,90.84084084084084,65,23,42,35.38461538461539,14.93343216171576,35,11,24,31.428571428571427,51,3,55,29,34,14,22,Inter Milan,26,Italy - Serie A
7,Adriano Russo,229,175.0,54,76.41921397379913,22,7,15,31.818181818181817,106,102,4,96.22641509433963,43,17,26,39.53488372093023,21.459511635120002,2,1,1,50.0,5,0,0,0,0,0,4,Frosinone,10,Italy - Serie A
8,Afriyie Acquah,702,503.0,199,71.65242165242165,106,62,44,58.490566037735846,420,358,62,85.23809523809524,75,32,43,42.66666666666667,18.818305216234975,39,14,25,35.8974358974359,22,3,53,28,19,10,45,Torino,29,Italy - Serie A
9,Albano Benjamín Bizzarri,1099,595.0,504,54.14012738853503,144,28,116,19.444444444444446,194,194,0,100.0,739,251,488,33.96481732070365,44.77147070176466,0,0,0,0.0,0,0,2,2,0,0,4,Chievo,35,Italy - Serie A
10,Alberto Brignoli,44,19.0,25,43.18181818181818,10,1,9,10.0,9,9,0,100.0,32,7,25,21.875,46.76642742084545,0,0,0,0.0,0,0,0,0,0,0,1,Sampdoria,1,Italy - Serie A
11,Alberto Facundo Costa,932,727.0,205,78.00429184549357,159,89,70,55.9748427672956,552,514,38,93.11594202898551,155,60,95,38.70967741935484,20.95778037866678,19,3,16,15.789473684210526,17,0,11,9,2,2,14,Fiorentina,19,Italy - Serie A
12,Alberto Gilardino,539,402.0,137,74.58256029684601,50,22,28,44.0,305,271,34,88.85245901639345,8,4,4,50.0,10.709281402641617,8,4,4,50.0,20,1,24,9,12,4,45,Palermo,33,Italy - Serie A
13,Alberto Grassi,381,294.0,87,77.16535433070865,40,24,16,60.0,228,206,22,90.35087719298247,26,10,16,38.46153846153847,14.929916265600001,8,2,6,25.0,8,0,17,6,8,4,26,Atalanta,13,Italy - Serie A
14,Alberto Paloschi,382,243.0,139,63.61256544502618,39,14,25,35.8974358974359,214,172,42,80.37383177570094,14,5,9,35.714285714285715,13.200856844556817,5,1,4,20.0,9,2,26,11,13,6,23,Chievo,21,Italy - Serie A
15,Alberto Pelagotti,181,130.0,51,71.8232044198895,3,0,3,0.0,80,80,0,100.0,71,21,50,29.577464788732392,33.69198754488929,0,0,0,0.0,0,0,0,0,0,0,1,Empoli,6,Italy - Serie A
16,Aleandro Rosi,950,686.0,264,72.21052631578947,120,53,67,44.166666666666664,354,320,34,90.3954802259887,118,37,81,31.35593220338983,18.310035943971283,51,17,34,33.33333333333333,12,0,40,13,24,4,42,Frosinone,27,Italy - Serie A
17,Alejandro Darío Gómez,1414,961.0,453,67.96322489391797,132,79,53,59.84848484848485,817,704,113,86.16891064871481,227,69,158,30.396475770925107,17.72142263907678,135,36,99,26.666666666666668,62,7,126,74,62,40,90,Atalanta,34,Italy - Serie A
18,Alejandro Miguel Rodriguez,3,1.0,2,33.33333333333333,0,0,0,0.0,1,0,1,0.0,0,0,0,0.0,8.8444279296,0,0,0,0.0,0,0,0,0,0,0,0,Sampdoria,6,Italy - Serie A
19,Aleksandar Tonev,270,171.0,99,63.33333333333333,20,9,11,45.0,162,114,48,70.37037037037037,33,14,19,42.42424242424242,16.862183453450665,26,11,15,42.30769230769231,10,1,21,13,10,6,8,Frosinone,22,Italy - Serie A
20,Aleksandar Trajkovski,553,410.0,143,74.14104882459313,32,19,13,59.375,366,325,41,88.79781420765028,54,16,38,29.629629629629626,15.31268757447624,46,13,33,28.26086956521739,22,1,47,24,21,8,39,Palermo,32,Italy - Serie A
21,Alessandro Diamanti,603,390.0,213,64.6766169154229,110,49,61,44.54545454545455,285,258,27,90.52631578947368,139,48,91,34.53237410071942,21.54196424879045,64,20,44,31.25,21,1,29,16,14,8,50,Atalanta,16,Italy - Serie A
22,Alessandro Florenzi,1879,1451.0,428,77.2219265566791,248,153,95,61.693548387096776,935,861,74,92.08556149732621,297,140,157,47.13804713804714,19.72005211035685,83,31,52,37.34939759036144,35,3,49,23,24,11,27,AS Roma,33,Italy - Serie A
23,Alessandro Frara,449,299.0,150,66.59242761692651,68,24,44,35.294117647058826,241,209,32,86.72199170124482,68,19,49,27.941176470588236,18.86932303242174,14,2,12,14.285714285714285,7,0,10,6,6,3,17,Frosinone,20,Italy - Serie A
24,Alessandro Gamberini,657,527.0,130,80.2130898021309,48,18,30,37.5,366,358,8,97.81420765027322,80,25,55,31.25,19.734999897035507,1,1,0,100.0,2,1,3,3,0,0,8,Chievo,22,Italy - Serie A
25,Alessandro Gazzi,608,512.0,96,84.21052631578947,63,39,24,61.904761904761905,340,324,16,95.29411764705881,42,22,20,52.38095238095239,19.170775778203183,1,1,0,100.0,10,0,4,3,0,0,8,Torino,15,Italy - Serie A
26,Alessandro Longhi,179,130.0,49,72.62569832402235,24,12,12,50.0,76,73,3,96.05263157894737,23,4,19,17.391304347826086,17.402898197427486,4,0,4,0.0,1,1,1,1,0,0,2,Sassuolo,6,Italy - Serie A
27,Alessandro Matri,185,109.0,76,58.91891891891892,24,15,9,62.5,107,79,28,73.83177570093457,14,7,7,50.0,14.270651518666378,13,2,11,15.384615384615385,6,1,13,4,5,1,15,Lazio,19,Italy - Serie A
28,Alessandro Piu,61,47.0,14,77.04918032786885,4,3,1,75.0,44,38,6,86.36363636363636,3,2,1,66.66666666666666,12.768298500877377,1,0,1,0.0,1,0,3,3,1,1,7,Empoli,10,Italy - Serie A
29,Alessio Cerci,463,299.0,164,64.57883369330453,25,18,7,72.0,260,211,49,81.15384615384616,70,21,49,30.0,16.69574668246756,53,15,38,28.30188679245283,20,2,62,26,30,15,38,AC Milan,24,Italy - Serie A
30,Alessio Romagnoli,1583,1373.0,210,86.73404927353127,127,79,48,62.20472440944882,977,948,29,97.0317297850563,160,79,81,49.375,20.31199229514451,4,1,3,25.0,6,0,16,11,1,1,23,AC Milan,34,Italy - Serie A
31,Alex Ferrari,674,530.0,144,78.63501483679525,91,59,32,64.83516483516483,343,301,42,87.75510204081633,50,18,32,36.0,16.879454014902198,15,2,13,13.333333333333334,4,0,31,18,18,9,25,Bologna,21,Italy - Serie A
32,Alex Nicolao Telles,1174,889.0,285,75.72402044293015,139,83,56,59.71223021582733,628,570,58,90.76433121019109,152,62,90,40.78947368421053,18.069214607641225,57,14,43,24.561403508771928,24,1,37,22,18,9,13,Inter Milan,21,Italy - Serie A
33,Alex Rodrigo Dias da Costa,943,830.0,113,88.01696712619301,59,34,25,57.6271186440678,574,558,16,97.21254355400697,51,17,34,33.33333333333333,19.644679379039747,1,1,0,100.0,5,1,4,4,0,0,10,AC Milan,25,Italy - Serie A
34,Alex Sandro Lobo Silva,1048,846.0,202,80.72519083969466,84,54,30,64.28571428571429,575,522,53,90.78260869565217,88,41,47,46.590909090909086,16.966872672090457,69,26,43,37.68115942028986,38,3,48,28,33,17,41,Juventus,22,Italy - Serie A
35,Alexander Farnerud,69,53.0,16,76.81159420289855,7,6,1,85.71428571428571,36,35,1,97.22222222222221,12,6,6,50.0,18.74780266069565,4,1,3,25.0,3,0,2,1,1,0,1,Torino,5,Italy - Serie A
36,Alexander Merkel,38,26.0,12,68.42105263157895,6,4,2,66.66666666666666,23,21,2,91.30434782608695,3,1,2,33.33333333333333,16.97297579770737,2,0,2,0.0,0,0,0,0,0,0,0,Udinese,1,Italy - Serie A
37,Ali Adnan Kadhim Al Tameemi,1002,647.0,355,64.57085828343313,127,73,54,57.48031496062992,392,330,62,84.18367346938776,157,39,118,24.840764331210192,18.470374344283112,87,23,64,26.436781609195403,19,1,48,33,26,16,29,Udinese,28,Italy - Serie A
38,Aljaž Struna,926,694.0,232,74.94600431965442,135,70,65,51.85185185185185,494,461,33,93.31983805668015,111,31,80,27.927927927927925,17.938336290439565,22,8,14,36.36363636363637,8,0,9,4,2,0,8,Palermo,22,Italy - Serie A
39,Allan Marques Loureiro,1861,1585.0,276,85.16926383664696,198,140,58,70.70707070707071,1425,1307,118,91.71929824561403,89,44,45,49.43820224719101,14.624029081093386,25,4,21,16.0,35,5,95,49,41,18,75,Napoli,35,Italy - Serie A
40,Amadou Diawara,1662,1387.0,275,83.45367027677497,235,129,106,54.8936170212766,1094,1023,71,93.51005484460696,149,45,104,30.201342281879196,19.26476286125632,3,2,1,66.66666666666666,21,1,30,23,5,1,19,Bologna,34,Italy - Serie A
41,Amauri Carvalho de Oliveira,4,3.0,1,75.0,0,0,0,0.0,0,0,0,0.0,0,0,0,0.0,9.1732429692,0,0,0,0.0,1,0,0,0,0,0,0,Torino,1,Italy - Serie A
42,Anderson Hernanes de Carvalho Andrade,671,592.0,79,88.22652757078987,78,64,14,82.05128205128204,465,440,25,94.6236559139785,48,33,15,68.75,18.836322059304322,7,3,4,42.857142857142854,12,1,22,11,9,2,12,Juventus,16,Italy - Serie A
43,Andrea Barzagli,1959,1726.0,233,88.10617662072487,203,135,68,66.50246305418719,1263,1230,33,97.38717339667458,179,90,89,50.27932960893855,20.100198020430874,12,2,10,16.666666666666664,11,0,14,9,2,2,22,Juventus,31,Italy - Serie A
44,Andrea Belotti,536,406.0,130,75.74626865671642,49,33,16,67.3469387755102,357,301,56,84.31372549019608,16,9,7,56.25,13.706163350700447,18,5,13,27.77777777777778,22,3,38,19,20,11,105,Torino,35,Italy - Serie A
45,Andrea Bertolacci,987,807.0,180,81.7629179331307,143,107,36,74.82517482517483,721,646,75,89.59778085991678,58,29,29,50.0,16.339841221077737,12,4,8,33.33333333333333,20,1,37,18,18,6,65,AC Milan,27,Italy - Serie A
46,Andrea Coda,70,59.0,11,84.28571428571429,6,1,5,16.666666666666664,47,44,3,93.61702127659575,9,3,6,33.33333333333333,22.953470783122288,0,0,0,0.0,0,0,0,0,0,0,1,Sampdoria,4,Italy - Serie A
47,Andrea Consigli,1316,928.0,388,70.51671732522796,85,19,66,22.35294117647059,531,528,3,99.43502824858757,665,285,380,42.857142857142854,36.43562841451167,0,0,0,0.0,0,0,1,1,0,0,7,Sassuolo,37,Italy - Serie A
48,Andrea Conti,431,325.0,106,75.4060324825986,31,15,16,48.38709677419355,232,206,26,88.79310344827587,38,14,24,36.84210526315789,16.18741419955935,10,4,6,40.0,3,1,13,6,6,3,18,Atalanta,14,Italy - Serie A
49,Andrea Costa,1384,1178.0,206,85.11560693641619,111,45,66,40.54054054054054,966,922,44,95.44513457556936,143,65,78,45.45454545454545,18.352371793379305,1,0,1,0.0,1,0,3,2,1,0,18,Empoli,24,Italy - Serie A
50,Andrea Lazzari,188,128.0,60,68.08510638297872,37,24,13,64.86486486486487,82,69,13,84.14634146341463,52,26,26,50.0,21.842220898558722,11,3,8,27.27272727272727,19,0,1,1,0,0,6,Carpi,8,Italy - Serie A
51,Andrea Masiello,1281,970.0,311,75.72209211553474,165,84,81,50.90909090909091,589,547,42,92.86926994906621,242,103,139,42.561983471074385,21.59380587454033,42,12,30,28.57142857142857,10,1,5,4,0,0,19,Atalanta,29,Italy - Serie A
52,Andrea Poli,277,237.0,40,85.5595667870036,32,26,6,81.25,199,186,13,93.46733668341709,7,5,2,71.42857142857143,14.957388924040721,5,1,4,20.0,7,1,7,7,3,3,15,AC Milan,18,Italy - Serie A
53,Andrea Ranocchia,668,549.0,119,82.18562874251496,61,25,36,40.98360655737705,365,352,13,96.43835616438356,88,30,58,34.090909090909086,22.380777437265376,0,0,0,0.0,2,0,4,3,0,0,19,Inter Milan,23,Italy - Serie A
54,Andrea Rispoli,780,541.0,239,69.35897435897435,93,55,38,59.13978494623656,352,303,49,86.07954545454545,99,40,59,40.4040404040404,17.364531074701848,65,18,47,27.692307692307693,13,4,17,10,7,3,12,Palermo,22,Italy - Serie A
55,Andrea Seculin,116,57.0,59,49.137931034482754,30,10,20,33.33333333333333,23,23,0,100.0,84,25,59,29.761904761904763,48.41523706508689,0,0,0,0.0,0,0,0,0,0,0,0,Chievo,3,Italy - Serie A
56,Andrés Fabián Ponce Núñez,3,2.0,1,66.66666666666666,0,0,0,0.0,2,2,0,100.0,0,0,0,0.0,11.68597786752,0,0,0,0.0,0,0,0,0,0,0,0,Sampdoria,1,Italy - Serie A
57,Angelo Esmael da Costa Júnior,149,95.0,54,63.758389261744966,14,1,13,7.142857142857142,49,49,0,100.0,80,26,54,32.5,40.821718422201336,0,0,0,0.0,1,0,0,0,0,0,0,Bologna,5,Italy - Serie A
58,Angelo Palombo,206,165.0,41,80.09708737864078,38,18,20,47.368421052631575,133,122,11,91.72932330827066,21,5,16,23.809523809523807,20.374750659774758,0,0,0,0.0,0,0,3,2,1,0,12,Sampdoria,7,Italy - Serie A
59,Ante Rebić,292,199.0,93,68.15068493150685,23,10,13,43.47826086956522,211,163,48,77.25118483412322,25,4,21,16.0,14.701985727997808,25,5,20,20.0,4,0,40,23,20,12,13,Hellas Verona,14,Italy - Serie A
60,Anthony Mounier,725,488.0,237,67.3103448275862,86,47,39,54.65116279069767,440,349,91,79.31818181818183,71,26,45,36.61971830985916,16.033905546741185,33,9,24,27.27272727272727,28,2,73,32,39,19,41,Bologna,30,Italy - Serie A
61,Anton Ciprian Tătărușanu,1128,857.0,271,75.97517730496453,35,6,29,17.142857142857142,564,563,1,99.822695035461,391,133,258,34.015345268542205,32.180687370942124,0,0,0,0.0,0,0,1,1,0,0,2,Fiorentina,37,Italy - Serie A
62,Antonino La Gumina,14,11.0,3,78.57142857142857,1,1,0,100.0,10,10,0,100.0,0,0,0,0.0,9.135233287971428,0,0,0,0.0,0,0,1,0,0,0,0,Palermo,3,Italy - Serie A
63,Antonio Candreva,1266,867.0,399,68.48341232227489,119,65,54,54.621848739495796,737,629,108,85.3459972862958,188,65,123,34.57446808510639,17.285740588163033,150,27,123,18.0,33,3,77,34,46,21,54,Lazio,30,Italy - Serie A
64,Antonio Cassano,814,541.0,273,66.46191646191646,110,53,57,48.18181818181818,488,387,101,79.30327868852459,76,29,47,38.15789473684211,15.89336929089641,29,7,22,24.137931034482758,33,3,23,10,15,5,54,Sampdoria,24,Italy - Serie A
65,Antonio Di Gaudio,392,268.0,124,68.36734693877551,52,28,24,53.84615384615385,232,187,45,80.60344827586206,24,7,17,29.166666666666668,14.432559701974899,28,6,22,21.428571428571427,10,3,62,33,40,21,51,Carpi,29,Italy - Serie A
66,Antonio Di Natale,345,214.0,131,62.02898550724638,31,13,18,41.935483870967744,135,116,19,85.92592592592592,76,31,45,40.78947368421053,19.64423985777913,27,2,25,7.4074074074074066,22,3,8,5,6,4,11,Udinese,23,Italy - Serie A
67,Antonio Floro Flores,501,328.0,173,65.46906187624751,65,29,36,44.61538461538462,286,229,57,80.06993006993007,62,25,37,40.32258064516129,17.154700811377726,10,1,9,10.0,16,2,54,31,30,17,48,Sassuolo,28,Italy - Serie A
68,Antonio Mirante,1111,668.0,443,60.12601260126013,104,23,81,22.115384615384613,252,251,1,99.60317460317461,722,290,432,40.16620498614959,42.55513111289779,0,0,0,0.0,0,0,3,3,0,0,5,Bologna,33,Italy - Serie A
69,Antonio Nocerino,38,31.0,7,81.57894736842105,3,1,2,33.33333333333333,29,27,2,93.10344827586206,2,2,0,100.0,16.637996361789472,1,0,1,0.0,1,0,2,1,1,1,3,AC Milan,2,Italy - Serie A
70,Antonio Rüdiger,1569,1365.0,204,86.9980879541109,135,74,61,54.81481481481482,1011,990,21,97.92284866468842,161,59,102,36.64596273291926,21.074703236980955,7,2,5,28.57142857142857,6,0,10,6,2,1,16,AS Roma,30,Italy - Serie A
71,Archimede Morleo,208,140.0,68,67.3076923076923,31,13,18,41.935483870967744,85,74,11,87.05882352941177,23,5,18,21.73913043478261,18.47977284861,12,4,8,33.33333333333333,4,0,3,2,1,0,11,Bologna,5,Italy - Serie A
72,Arlind Afrim Ajeti,329,235.0,94,71.42857142857143,38,13,25,34.21052631578947,137,130,7,94.8905109489051,68,25,43,36.76470588235294,24.241591993992948,0,0,0,0.0,3,0,1,1,0,0,7,Frosinone,16,Italy - Serie A
73,Armando Izzo,1449,1157.0,292,79.84817115251897,147,64,83,43.53741496598639,858,811,47,94.52214452214453,190,79,111,41.578947368421055,19.417419344325964,6,3,3,50.0,9,1,25,15,8,4,51,Genoa,33,Italy - Serie A
74,Artur Ioniţă,863,685.0,178,79.37427578215527,85,57,28,67.05882352941175,528,486,42,92.04545454545455,37,18,19,48.64864864864865,15.151178421396294,16,5,11,31.25,19,2,33,18,19,11,36,Hellas Verona,31,Italy - Serie A
75,Assane Demoya Gnoukouri,50,42.0,8,84.0,3,2,1,66.66666666666666,37,34,3,91.8918918918919,1,0,1,0.0,15.7364571482064,0,0,0,0.0,1,0,0,0,0,0,0,Inter Milan,2,Italy - Serie A
76,Assane Dioussé El Hadji,716,603.0,113,84.21787709497207,110,70,40,63.63636363636363,540,494,46,91.48148148148148,43,16,27,37.2093023255814,17.03858412154525,1,0,1,0.0,3,0,6,5,0,0,11,Empoli,15,Italy - Serie A
77,Berat Djimsiti,141,106.0,35,75.177304964539,12,1,11,8.333333333333332,90,86,4,95.55555555555556,19,2,17,10.526315789473683,19.738778480956597,0,0,0,0.0,0,0,1,1,0,0,5,Atalanta,3,Italy - Serie A
78,Blerim Džemaili,835,663.0,172,79.40119760479043,118,70,48,59.32203389830508,552,496,56,89.85507246376811,90,44,46,48.888888888888886,19.220576921425724,20,5,15,25.0,25,2,28,16,14,6,55,Genoa,27,Italy - Serie A
79,Boris Radunović,32,20.0,12,62.5,2,1,1,50.0,14,14,0,100.0,17,5,12,29.411764705882355,38.0421558894375,0,0,0,0.0,0,0,0,0,0,0,0,Atalanta,1,Italy - Serie A
80,Borja Valero Iglesias,2341,2018.0,323,86.20247757368645,316,255,61,80.69620253164557,1715,1605,110,93.58600583090379,195,107,88,54.871794871794876,17.032864084856488,54,17,37,31.48148148148148,72,6,81,53,35,22,109,Fiorentina,37,Italy - Serie A
81,Boukary Dramé,1289,1013.0,276,78.58805275407292,133,81,52,60.902255639097746,707,645,62,91.23055162659122,129,41,88,31.782945736434108,17.303964978616477,51,12,39,23.52941176470588,16,0,36,28,15,10,32,Atalanta,25,Italy - Serie A
82,Boško Janković,237,130.0,107,54.85232067510548,34,8,26,23.52941176470588,96,81,15,84.375,35,7,28,20.0,18.38042479491038,24,6,18,25.0,3,0,11,6,2,1,5,Hellas Verona,15,Italy - Serie A
83,Boštjan Cesar,1135,912.0,223,80.35242290748899,106,48,58,45.28301886792453,621,607,14,97.74557165861513,181,66,115,36.46408839779006,21.704826278036936,1,0,1,0.0,2,0,5,5,1,1,30,Chievo,31,Italy - Serie A
84,Bruno Miguel Borges Fernandes,1135,785.0,350,69.16299559471366,185,105,80,56.75675675675676,629,550,79,87.44038155802862,190,74,116,38.94736842105263,19.840662687724016,60,9,51,15.0,37,4,55,30,20,10,52,Udinese,31,Italy - Serie A
85,Bruno da Silva Peres,1262,1013.0,249,80.26941362916006,110,65,45,59.09090909090909,618,562,56,90.93851132686083,161,83,78,51.5527950310559,20.279288872971726,84,32,52,38.095238095238095,29,4,128,80,43,25,37,Torino,31,Italy - Serie A
86,Bryan Cristante,69,49.0,20,71.01449275362319,12,4,8,33.33333333333333,43,36,7,83.72093023255815,10,3,7,30.0,18.613804115206957,0,0,0,0.0,0,0,4,2,2,0,3,Palermo,4,Italy - Serie A
87,Carlos Arturo Bacca Ahumada,679,479.0,200,70.54491899852725,43,27,16,62.7906976744186,434,351,83,80.87557603686636,20,11,9,55.00000000000001,13.67878366614963,29,8,21,27.586206896551722,41,2,53,29,36,17,28,AC Milan,38,Italy - Serie A
88,Carlos Emilio Carmona Tello,243,209.0,34,86.0082304526749,18,12,6,66.66666666666666,173,164,9,94.79768786127167,14,6,8,42.857142857142854,16.310570725579257,2,1,1,50.0,3,0,4,2,1,0,9,Atalanta,8,Italy - Serie A
89,Carlos Joaquín Correa,652,524.0,128,80.3680981595092,71,52,19,73.23943661971832,457,391,66,85.55798687089715,44,27,17,61.36363636363637,16.25395179517399,9,2,7,22.22222222222222,20,1,70,36,43,18,43,Sampdoria,25,Italy - Serie A
90,Carlos Mario Carbonero Mancilla,544,457.0,87,84.00735294117648,46,35,11,76.08695652173914,379,345,34,91.02902374670184,24,11,13,45.83333333333333,14.984542973935588,11,5,6,45.45454545454545,11,2,30,17,11,5,25,Sampdoria,14,Italy - Serie A
91,Cesare Bovo,1325,1090.0,235,82.26415094339623,216,122,94,56.481481481481474,675,655,20,97.03703703703704,293,141,152,48.122866894197955,26.26631566528048,7,2,5,28.57142857142857,14,0,8,7,0,0,5,Torino,21,Italy - Serie A
92,Christian Abbiati,26,13.0,13,50.0,0,0,0,0.0,10,10,0,100.0,14,3,11,21.428571428571427,36.225144248732306,0,0,0,0.0,0,0,0,0,0,0,0,AC Milan,1,Italy - Serie A
93,Christian Maggio,274,218.0,56,79.56204379562044,11,5,6,45.45454545454545,131,121,10,92.36641221374046,27,7,20,25.925925925925924,16.406237215140436,10,3,7,30.0,2,0,6,3,2,1,12,Napoli,8,Italy - Serie A
94,Ciro Immobile,273,179.0,94,65.56776556776556,23,10,13,43.47826086956522,155,119,36,76.77419354838709,18,10,8,55.55555555555556,15.991697704734065,27,7,20,25.925925925925924,19,2,34,16,23,10,20,Torino,14,Italy - Serie A
95,Claud Adjapong,13,11.0,2,84.61538461538461,0,0,0,0.0,7,6,1,85.71428571428571,0,0,0,0.0,13.102352209107693,0,0,0,0.0,0,0,0,0,0,0,0,Sassuolo,2,Italy - Serie A
96,Claudio Marchisio,1509,1318.0,191,87.3426110006627,218,157,61,72.01834862385321,885,855,30,96.61016949152543,236,148,88,62.71186440677966,20.942176323451132,13,8,5,61.53846153846154,20,2,23,16,7,5,21,Juventus,23,Italy - Serie A
97,Cristian Daniel Ansaldi,1086,772.0,314,71.08655616942909,169,99,70,58.57988165680473,553,493,60,89.1500904159132,170,62,108,36.470588235294116,20.07518663136,66,16,50,24.242424242424242,19,4,52,31,26,14,48,Genoa,24,Italy - Serie A
98,Cristian Eduardo Zapata Valencia,658,539.0,119,81.91489361702128,53,24,29,45.28301886792453,388,372,16,95.87628865979381,83,36,47,43.373493975903614,21.28166342698541,0,0,0,0.0,3,0,6,4,0,0,12,AC Milan,16,Italy - Serie A
99,Cristian Molinaro,1093,829.0,264,75.8462946020128,116,60,56,51.724137931034484,486,436,50,89.7119341563786,185,80,105,43.24324324324324,20.780574061384883,70,19,51,27.142857142857142,22,0,49,26,21,13,27,Torino,27,Italy - Serie A
100,Cristian Raimondi,362,251.0,111,69.33701657458563,44,23,21,52.27272727272727,152,124,28,81.57894736842105,40,8,32,20.0,15.969058123158895,14,1,13,7.142857142857142,4,0,7,3,3,0,24,Atalanta,18,Italy - Serie A
101,Cristian Tello Herrera,510,395.0,115,77.45098039215686,27,19,8,70.37037037037037,359,303,56,84.40111420612814,28,14,14,50.0,15.590817926222117,42,19,23,45.23809523809524,18,4,59,32,47,25,17,Fiorentina,15,Italy - Serie A
102,Cristian Zaccardo,956,685.0,271,71.65271966527197,142,77,65,54.22535211267606,430,384,46,89.30232558139535,146,44,102,30.136986301369863,19.005381759922344,31,9,22,29.03225806451613,8,0,16,9,6,2,28,Carpi,27,Italy - Serie A
103,Cyril Théréau,1214,899.0,315,74.05271828665569,98,55,43,56.12244897959183,748,654,94,87.43315508021391,40,12,28,30.0,13.19283424432972,36,10,26,27.77777777777778,46,3,73,37,38,22,69,Udinese,36,Italy - Serie A
104,Daniel Ciofani,608,377.0,231,62.00657894736842,95,35,60,36.84210526315789,274,224,50,81.75182481751825,23,5,18,21.73913043478261,13.669806485825644,4,1,3,25.0,35,1,33,16,17,5,53,Frosinone,37,Italy - Serie A
105,Daniel Pavlovic,993,636.0,357,64.04833836858006,171,86,85,50.29239766081871,303,265,38,87.45874587458746,270,90,180,33.33333333333333,22.3697436102902,59,20,39,33.89830508474576,41,5,8,4,5,3,13,Frosinone,22,Italy - Serie A
106,Daniele Baselli,903,663.0,240,73.421926910299,99,54,45,54.54545454545454,496,443,53,89.31451612903226,159,61,98,38.36477987421384,19.559456632651695,38,9,29,23.684210526315788,50,2,76,42,30,13,41,Torino,35,Italy - Serie A
107,Daniele Croce,893,754.0,139,84.43449048152296,67,52,15,77.61194029850746,648,604,44,93.20987654320987,36,16,20,44.44444444444444,13.318666495321747,24,6,18,25.0,20,1,50,18,10,2,57,Empoli,28,Italy - Serie A
108,Daniele De Rossi,1462,1294.0,168,88.50889192886456,228,157,71,68.85964912280701,864,832,32,96.29629629629629,210,140,70,66.66666666666666,21.649964624056416,3,3,0,100.0,14,2,7,4,2,0,24,AS Roma,23,Italy - Serie A
109,Daniele Gastaldello,1075,890.0,185,82.7906976744186,127,64,63,50.39370078740157,530,509,21,96.0377358490566,157,80,77,50.955414012738856,22.222097779101322,1,0,1,0.0,2,2,2,2,0,0,24,Bologna,26,Italy - Serie A
110,Daniele Padelli,1073,782.0,291,72.87977632805219,43,13,30,30.23255813953488,462,460,2,99.56709956709958,443,163,280,36.794582392776526,34.63366485588794,0,0,0,0.0,1,0,2,2,0,0,3,Torino,35,Italy - Serie A
111,Daniele Rugani,788,707.0,81,89.72081218274111,70,40,30,57.14285714285714,588,575,13,97.78911564625851,41,13,28,31.70731707317073,18.93682221055127,0,0,0,0.0,1,0,6,5,1,1,14,Juventus,17,Italy - Serie A
112,Daniele Verde,44,29.0,15,65.9090909090909,6,3,3,50.0,25,20,5,80.0,3,0,3,0.0,15.02299171926,3,0,3,0.0,0,0,7,5,5,5,1,Frosinone,5,Italy - Serie A
113,Danilo Cataldi,931,742.0,189,79.69924812030075,134,77,57,57.46268656716418,609,555,54,91.13300492610837,84,32,52,38.095238095238095,18.04193677387102,18,3,15,16.666666666666664,20,3,10,4,2,1,15,Lazio,20,Italy - Serie A
114,Danilo D''Ambrosio,946,718.0,228,75.8985200845666,124,71,53,57.25806451612904,481,427,54,88.77338877338877,98,27,71,27.55102040816326,17.161976413251246,20,8,12,40.0,9,0,31,12,13,3,19,Inter Milan,20,Italy - Serie A
115,Danilo Fernando Avelar,192,113.0,79,58.854166666666664,27,11,16,40.74074074074074,63,55,8,87.3015873015873,64,22,42,34.375,23.39665375905,27,6,21,22.22222222222222,6,2,3,1,2,0,7,Torino,6,Italy - Serie A
116,Danilo Larangeira,1223,922.0,301,75.38838920686835,183,77,106,42.07650273224044,511,483,28,94.52054794520548,279,127,152,45.51971326164875,24.51524978036016,3,1,2,33.33333333333333,2,0,3,3,0,0,25,Udinese,34,Italy - Serie A
117,Danilo Soddimo,853,549.0,304,64.36107854630716,133,70,63,52.63157894736842,449,369,80,82.18262806236079,142,43,99,30.28169014084507,18.73227358364961,65,13,52,20.0,37,2,102,47,46,19,49,Frosinone,28,Italy - Serie A
118,Dario Dainelli,580,454.0,126,78.27586206896552,75,32,43,42.66666666666667,285,271,14,95.08771929824562,125,62,63,49.6,22.74133220995655,3,2,1,66.66666666666666,3,0,2,1,0,0,6,Chievo,18,Italy - Serie A
119,Darko Lazović,342,208.0,134,60.81871345029239,23,8,15,34.78260869565217,202,161,41,79.70297029702971,52,10,42,19.230769230769234,17.191184626960002,28,7,21,25.0,11,2,31,13,24,9,4,Genoa,15,Italy - Serie A
120,David López Silva,578,503.0,75,87.0242214532872,49,34,15,69.38775510204081,453,426,27,94.03973509933775,13,4,9,30.76923076923077,13.544265191294118,6,2,4,33.33333333333333,6,1,10,5,6,1,5,Napoli,25,Italy - Serie A
121,Davide Astori,2338,2090.0,248,89.39264328485885,199,116,83,58.291457286432156,1676,1632,44,97.3747016706444,244,132,112,54.09836065573771,19.799877005116475,2,2,0,100.0,5,0,23,20,0,0,30,Fiorentina,33,Italy - Serie A
122,Davide Bassi,37,18.0,19,48.64864864864865,4,1,3,25.0,9,9,0,100.0,25,8,17,32.0,42.26283924791351,0,0,0,0.0,0,0,0,0,0,0,0,Atalanta,1,Italy - Serie A
123,Davide Bertoncini,118,86.0,32,72.88135593220339,22,9,13,40.909090909090914,50,49,1,98.0,32,14,18,43.75,24.508370666391865,0,0,0,0.0,1,0,0,0,0,0,7,Frosinone,5,Italy - Serie A
124,Davide Biondini,512,356.0,156,69.53125,80,41,39,51.24999999999999,287,251,36,87.45644599303137,58,26,32,44.827586206896555,17.62265556859078,21,6,15,28.57142857142857,7,0,11,6,6,2,20,Sassuolo,22,Italy - Serie A
125,Davide Brivio,653,491.0,162,75.19142419601837,77,48,29,62.33766233766234,353,319,34,90.36827195467421,67,19,48,28.35820895522388,16.443429746068116,26,5,21,19.230769230769234,6,0,6,2,3,0,7,Atalanta,14,Italy - Serie A
126,Davide Calabria,246,179.0,67,72.76422764227642,32,16,16,50.0,122,113,9,92.62295081967213,41,17,24,41.46341463414634,18.62001787242439,8,4,4,50.0,6,0,6,3,1,0,7,AC Milan,6,Italy - Serie A
127,Davide Santon,646,541.0,105,83.74613003095975,69,42,27,60.86956521739131,396,379,17,95.70707070707071,60,27,33,45.0,17.809961504421175,26,8,18,30.76923076923077,5,1,18,8,12,5,10,Inter Milan,12,Italy - Serie A
128,Davide Zappacosta,750,542.0,208,72.26666666666667,64,37,27,57.8125,294,258,36,87.75510204081633,101,42,59,41.584158415841586,19.17224696193485,76,20,56,26.31578947368421,13,1,44,12,26,5,10,Torino,25,Italy - Serie A
129,Diego Falcinelli,224,172.0,52,76.78571428571429,16,8,8,50.0,140,124,16,88.57142857142857,7,3,4,42.857142857142854,12.293400077643215,6,2,4,33.33333333333333,15,1,17,10,11,7,34,Sassuolo,26,Italy - Serie A
130,Diego López Rodríguez,245,189.0,56,77.14285714285715,14,5,9,35.714285714285715,78,78,0,100.0,120,65,55,54.166666666666664,36.35625426694824,0,0,0,0.0,1,0,0,0,0,0,0,AC Milan,8,Italy - Serie A
131,Diego Perotti,1461,1099.0,362,75.22245037645449,151,100,51,66.22516556291392,989,877,112,88.67542972699697,148,48,100,32.432432432432435,16.133019596961315,109,37,72,33.94495412844037,58,9,89,60,53,40,64,Genoa,31,Italy - Serie A
132,Diego Sebastián Laxalt Suárez,1533,1132.0,401,73.84213959556425,142,72,70,50.70422535211267,893,759,134,84.99440089585666,111,35,76,31.53153153153153,15.96887399362192,66,21,45,31.818181818181817,26,4,75,31,38,17,49,Genoa,35,Italy - Serie A
133,Diego Ángel Capel Trinidad,273,218.0,55,79.85347985347985,25,19,6,76.0,192,170,22,88.54166666666666,29,20,9,68.96551724137932,16.39176609321758,17,6,11,35.294117647058826,9,0,12,8,4,2,46,Genoa,21,Italy - Serie A
134,Diogo José Rosário Gomes Figueiras,264,198.0,66,75.0,29,10,19,34.48275862068966,161,139,22,86.33540372670807,19,5,14,26.31578947368421,16.379417151853634,6,1,5,16.666666666666664,1,0,7,4,6,3,4,Genoa,9,Italy - Serie A
135,Djamel Eddine Mesbah,276,216.0,60,78.26086956521739,26,15,11,57.692307692307686,167,148,19,88.62275449101796,25,7,18,28.000000000000004,16.986170141626957,9,2,7,22.22222222222222,4,0,7,1,2,0,9,Sampdoria,7,Italy - Serie A
136,Domenico Berardi,1076,702.0,374,65.24163568773234,137,73,64,53.284671532846716,576,466,110,80.90277777777779,149,50,99,33.557046979865774,18.852049199748848,68,15,53,22.058823529411764,31,6,71,36,38,21,85,Sassuolo,29,Italy - Serie A
137,Domenico Maietta,811,694.0,117,85.57336621454994,101,50,51,49.504950495049506,466,450,16,96.56652360515021,109,50,59,45.87155963302752,22.09571333222116,0,0,0,0.0,1,0,11,4,4,1,11,Bologna,19,Italy - Serie A
138,Dominik Furman,17,15.0,2,88.23529411764706,1,0,1,0.0,14,13,1,92.85714285714286,0,0,0,0.0,19.17676714116706,0,0,0,0.0,0,0,0,0,0,0,0,Hellas Verona,1,Italy - Serie A
139,Dries Mertens,578,422.0,156,73.01038062283737,67,38,29,56.71641791044776,371,309,62,83.28840970350404,44,18,26,40.909090909090914,16.142924537735293,43,12,31,27.906976744186046,26,5,66,26,51,19,38,Napoli,33,Italy - Serie A
140,Duván Esteban Zapata Banguera,326,206.0,120,63.190184049079754,36,15,21,41.66666666666667,169,136,33,80.4733727810651,23,4,19,17.391304347826086,14.539325977380368,20,5,15,25.0,8,2,35,15,23,8,47,Udinese,25,Italy - Serie A
141,Dušan Basta,1306,1035.0,271,79.24961715160796,146,79,67,54.109589041095894,756,700,56,92.5925925925926,143,39,104,27.27272727272727,17.602572463126126,44,5,39,11.363636363636363,10,0,25,11,15,7,21,Lazio,23,Italy - Serie A
142,Dávid Ivan,547,451.0,96,82.44972577696527,36,26,10,72.22222222222221,378,344,34,91.005291005291,22,7,15,31.818181818181817,14.4467515203532,8,1,7,12.5,10,0,8,2,4,0,14,Sampdoria,21,Italy - Serie A
143,Edenílson Andrade dos Santos,1209,871.0,338,72.04301075268818,162,93,69,57.407407407407405,592,511,81,86.31756756756756,141,54,87,38.297872340425535,17.045087415557717,66,16,50,24.242424242424242,24,0,73,33,25,7,26,Udinese,29,Italy - Serie A
144,Eder Citadin Martins,717,555.0,162,77.40585774058577,55,35,20,63.63636363636363,500,436,64,87.2,46,24,22,52.17391304347826,15.199804071111965,32,11,21,34.375,20,3,56,27,32,15,53,Sampdoria,33,Italy - Serie A
145,Edin Džeko,598,384.0,214,64.21404682274247,77,39,38,50.649350649350644,313,245,68,78.27476038338658,31,18,13,58.06451612903226,14.309584580695786,14,3,11,21.428571428571427,15,4,41,21,25,13,53,AS Roma,31,Italy - Serie A
146,Edoardo Goldaniga,363,247.0,116,68.04407713498622,60,21,39,35.0,139,128,11,92.08633093525181,86,34,52,39.53488372093023,23.948719930046277,2,0,2,0.0,2,0,2,1,1,0,21,Palermo,17,Italy - Serie A
147,Edson Braafheid,162,115.0,47,70.98765432098766,18,7,11,38.88888888888889,70,61,9,87.14285714285714,23,6,17,26.08695652173913,16.86519714584,6,2,4,33.33333333333333,0,0,2,1,0,0,5,Lazio,5,Italy - Serie A
148,Elseid Hysaj,2525,2151.0,374,85.18811881188118,170,113,57,66.47058823529412,1493,1394,99,93.36905559276624,138,51,87,36.95652173913043,14.177039424800506,67,8,59,11.940298507462686,24,2,64,32,27,9,44,Napoli,37,Italy - Serie A
149,Emanuele Giaccherini,1138,840.0,298,73.81370826010544,116,68,48,58.620689655172406,688,592,96,86.04651162790698,137,58,79,42.33576642335766,17.23787724435817,55,23,32,41.81818181818181,43,0,74,35,54,24,50,Bologna,28,Italy - Serie A
150,Emanuele Suagher,135,104.0,31,77.03703703703704,19,6,13,31.57894736842105,66,63,3,95.45454545454545,22,6,16,27.27272727272727,21.664052812016,0,0,0,0.0,1,0,0,0,0,0,3,Carpi,9,Italy - Serie A
151,Emanuele Terranova,133,121.0,12,90.97744360902256,5,2,3,40.0,70,68,2,97.14285714285714,25,20,5,80.0,23.317710494394586,0,0,0,0.0,0,0,1,1,0,0,2,Sassuolo,6,Italy - Serie A
152,Emerson Palmieri dos Santos,101,81.0,20,80.19801980198021,8,4,4,50.0,65,61,4,93.84615384615384,8,2,6,25.0,15.599007846477623,4,1,3,25.0,1,0,5,1,4,1,1,AS Roma,8,Italy - Serie A
153,Emil Hallfreðsson,938,672.0,266,71.64179104477611,105,61,44,58.0952380952381,529,474,55,89.60302457466919,117,42,75,35.8974358974359,17.820671898933902,54,14,40,25.925925925925924,26,1,39,27,13,7,25,Udinese,27,Italy - Serie A
154,Emil Krafth,95,73.0,22,76.84210526315789,11,8,3,72.72727272727273,49,39,10,79.59183673469387,4,3,1,75.0,14.92596603972379,3,0,3,0.0,1,0,0,0,0,0,3,Bologna,4,Italy - Serie A
155,Emiliano Moretti,2049,1779.0,270,86.82284040995609,231,147,84,63.63636363636363,1326,1285,41,96.9079939668175,244,114,130,46.72131147540984,21.73293882870501,6,3,3,50.0,13,1,3,2,0,0,31,Torino,35,Italy - Serie A
156,Emiliano Viviano,1331,791.0,540,59.429000751314796,189,50,139,26.455026455026452,344,340,4,98.83720930232558,875,348,527,39.77142857142857,45.46611248763462,0,0,0,0.0,1,0,0,0,0,0,8,Sampdoria,37,Italy - Serie A
157,Emmanuel Agyemang-Badu,932,712.0,220,76.39484978540773,139,84,55,60.431654676258994,572,519,53,90.73426573426573,83,34,49,40.963855421686745,16.936716776778155,15,6,9,40.0,20,1,46,25,11,5,90,Udinese,33,Italy - Serie A
158,Enzo Maresca,675,550.0,125,81.48148148148148,113,65,48,57.52212389380531,405,379,26,93.58024691358024,94,45,49,47.87234042553192,19.536551705448534,6,0,6,0.0,9,0,13,6,1,0,28,Palermo,15,Italy - Serie A
159,Erick Antonio Pulgar Farfán,359,305.0,54,84.958217270195,46,36,10,78.26086956521739,239,227,12,94.97907949790795,22,14,8,63.63636363636363,17.627962984395545,4,0,4,0.0,2,0,16,9,5,3,6,Bologna,13,Italy - Serie A
160,Eros Pisano,1572,1071.0,501,68.12977099236642,258,116,142,44.96124031007752,576,513,63,89.0625,377,134,243,35.54376657824933,21.41142905074626,95,31,64,32.631578947368425,24,0,27,16,13,7,48,Hellas Verona,34,Italy - Serie A
161,Ervin Zukanović,999,823.0,176,82.38238238238237,132,74,58,56.060606060606055,598,573,25,95.81939799331104,134,51,83,38.059701492537314,20.360636191556033,8,3,5,37.5,5,1,3,3,0,0,9,Sampdoria,25,Italy - Serie A
162,Etrit Berisha,236,169.0,67,71.61016949152543,14,3,11,21.428571428571427,82,81,1,98.78048780487805,116,52,64,44.827586206896555,36.467453849213896,0,0,0,0.0,0,0,0,0,0,0,0,Lazio,11,Italy - Serie A
163,Eugenio Lamanna,355,231.0,124,65.07042253521126,16,6,10,37.5,116,116,0,100.0,180,58,122,32.22222222222222,38.58341882877228,0,0,0,0.0,1,0,0,0,0,0,1,Genoa,13,Italy - Serie A
164,Ezequiel Muñoz,634,510.0,124,80.4416403785489,41,21,20,51.21951219512195,373,347,26,93.02949061662198,54,20,34,37.03703703703704,18.59352659848959,0,0,0,0.0,1,0,4,3,0,0,12,Genoa,18,Italy - Serie A
165,Fabio Daprelà,105,79.0,26,75.23809523809524,21,12,9,57.14285714285714,52,48,4,92.3076923076923,18,8,10,44.44444444444444,18.799157883593143,1,0,1,0.0,0,0,1,1,0,0,3,Palermo,7,Italy - Serie A
166,Fabio Della Giovanna,5,3.0,2,60.0,2,1,1,50.0,3,3,0,100.0,1,0,1,0.0,21.1854620232,0,0,0,0.0,0,0,0,0,0,0,0,Inter Milan,1,Italy - Serie A
167,Fabio Quagliarella,594,391.0,203,65.82491582491582,61,35,26,57.377049180327866,299,244,55,81.60535117056857,52,36,16,69.23076923076923,15.447378565699394,21,7,14,33.33333333333333,17,1,30,16,14,7,49,Torino,32,Italy - Serie A
168,Fabrizio Alastra,48,39.0,9,81.25,1,1,0,100.0,20,20,0,100.0,23,15,8,65.21739130434783,33.573088618229995,0,0,0,0.0,0,0,0,0,0,0,0,Palermo,2,Italy - Serie A
169,Fabrizio Cacciatore,1545,1215.0,330,78.64077669902912,190,110,80,57.89473684210527,710,659,51,92.8169014084507,208,90,118,43.269230769230774,19.55453142315029,39,15,24,38.46153846153847,22,3,22,7,11,3,16,Chievo,29,Italy - Serie A
170,Fabrizio Poli,321,222.0,99,69.1588785046729,65,24,41,36.92307692307693,139,130,9,93.5251798561151,57,16,41,28.07017543859649,20.042434070903553,8,1,7,12.5,2,0,2,0,2,0,7,Carpi,10,Italy - Serie A
171,Facundo Sebastián Roncaglia,1918,1685.0,233,87.85192909280501,183,115,68,62.841530054644814,1261,1218,43,96.59000793021411,146,64,82,43.83561643835616,18.389323480142817,8,2,6,25.0,8,0,9,5,1,0,31,Fiorentina,30,Italy - Serie A
172,Faouzi Ghoulam,2456,2026.0,430,82.49185667752444,242,174,68,71.900826446281,1569,1456,113,92.79796048438496,134,44,90,32.83582089552239,15.256703035470197,113,21,92,18.58407079646018,28,3,42,19,24,8,48,Napoli,34,Italy - Serie A
173,Federico Barba,531,468.0,63,88.13559322033898,38,10,28,26.31578947368421,362,357,5,98.61878453038673,55,27,28,49.09090909090909,18.518018287955258,0,0,0,0.0,0,0,0,0,0,0,8,Empoli,10,Italy - Serie A
174,Federico Bernardeschi,1095,846.0,249,77.26027397260275,103,52,51,50.48543689320388,722,644,78,89.19667590027701,153,66,87,43.13725490196079,17.74402327774619,41,11,30,26.82926829268293,35,4,101,54,53,28,68,Fiorentina,33,Italy - Serie A
175,Federico Bonazzoli,23,21.0,2,91.30434782608695,1,0,1,0.0,18,18,0,100.0,0,0,0,0.0,14.905234449391305,0,0,0,0.0,1,0,1,1,1,1,3,Sampdoria,4,Italy - Serie A
176,Federico Dionisi,616,395.0,221,64.12337662337663,73,36,37,49.31506849315068,366,260,106,71.03825136612022,35,12,23,34.285714285714285,14.380505621726494,33,5,28,15.151515151515152,25,3,87,39,45,21,90,Frosinone,32,Italy - Serie A
177,Federico Marchetti,819,578.0,241,70.57387057387058,57,13,44,22.807017543859647,279,279,0,100.0,406,172,234,42.364532019704434,37.19820290769055,0,0,0,0.0,1,0,1,1,0,0,8,Lazio,29,Italy - Serie A
178,Federico Mattiello,80,56.0,24,70.0,19,14,5,73.68421052631578,30,25,5,83.33333333333334,9,1,8,11.11111111111111,19.672478595909,8,2,6,25.0,3,1,0,0,0,0,3,Chievo,1,Italy - Serie A
179,Federico Peluso,1653,1225.0,428,74.10768300060496,228,135,93,59.210526315789465,734,658,76,89.64577656675749,141,46,95,32.62411347517731,16.662522004639623,59,16,43,27.11864406779661,20,1,35,9,14,3,38,Sassuolo,34,Italy - Serie A
180,Federico Viviani,1211,935.0,276,77.20891824938067,220,141,79,64.0909090909091,582,536,46,92.09621993127148,284,151,133,53.16901408450704,23.562240481454268,34,10,24,29.411764705882355,38,6,14,12,4,4,35,Hellas Verona,19,Italy - Serie A
181,Felipe Anderson Pereira Gomes,1069,722.0,347,67.53975678203929,137,73,64,53.284671532846716,621,477,144,76.81159420289855,104,44,60,42.30769230769231,17.211860021555022,60,16,44,26.666666666666668,23,4,134,63,72,34,56,Lazio,35,Italy - Serie A
182,Felipe Dias da Silva dal Belo,879,681.0,198,77.47440273037543,127,58,69,45.66929133858268,458,434,24,94.75982532751091,148,62,86,41.891891891891895,20.7012684261944,7,2,5,28.57142857142857,3,1,8,6,0,0,18,Udinese,26,Italy - Serie A
183,Felipe Melo de Carvalho,1112,959.0,153,86.2410071942446,151,95,56,62.913907284768214,643,613,30,95.3343701399689,119,76,43,63.86554621848739,20.732457074298992,0,0,0,0.0,8,1,10,7,1,0,36,Inter Milan,26,Italy - Serie A
184,Ferdinando Coppola,42,21.0,21,50.0,8,1,7,12.5,9,9,0,100.0,32,11,21,34.375,43.457791218428575,0,0,0,0.0,0,0,0,0,0,0,0,Hellas Verona,1,Italy - Serie A
185,Fernando Llorente Torres,4,1.0,3,25.0,0,0,0,0.0,3,1,2,33.33333333333333,0,0,0,0.0,15.497322065999999,0,0,0,0.0,0,0,0,0,0,0,0,Juventus,1,Italy - Serie A
186,Fernando Lucas Martins,2190,1822.0,368,83.19634703196347,280,184,96,65.71428571428571,1340,1265,75,94.40298507462687,318,149,169,46.855345911949684,20.828390979096326,32,11,21,34.375,56,2,40,25,9,6,73,Sampdoria,35,Italy - Serie A
187,Filip Helander,720,583.0,137,80.97222222222223,71,25,46,35.2112676056338,417,404,13,96.88249400479616,90,23,67,25.555555555555554,21.11697021073,1,0,1,0.0,0,0,0,0,0,0,11,Hellas Verona,24,Italy - Serie A
188,Filip Đorđević,338,238.0,100,70.41420118343196,24,11,13,45.83333333333333,207,169,38,81.64251207729468,14,4,10,28.57142857142857,12.707003910795976,4,1,3,25.0,11,2,10,4,4,0,26,Lazio,27,Italy - Serie A
189,Filippo Costa,73,46.0,27,63.013698630136986,8,4,4,50.0,34,28,6,82.35294117647058,8,3,5,37.5,18.02236828057644,2,0,2,0.0,2,0,4,3,2,1,4,Chievo,6,Italy - Serie A
190,Filippo Falco,142,96.0,46,67.6056338028169,8,7,1,87.5,92,81,11,88.04347826086956,29,7,22,24.137931034482758,16.827920752502532,20,3,17,15.0,4,0,12,4,8,1,7,Bologna,9,Italy - Serie A
191,Filippo Porcari,89,70.0,19,78.65168539325843,21,14,7,66.66666666666666,47,41,6,87.2340425531915,14,10,4,71.42857142857143,20.065490895413934,0,0,0,0.0,3,0,0,0,0,0,3,Carpi,4,Italy - Serie A
192,Francesco Acerbi,1844,1609.0,235,87.25596529284165,192,121,71,63.020833333333336,1109,1085,24,97.83588818755635,222,121,101,54.5045045045045,20.79886275675176,0,0,0,0.0,3,0,16,14,2,2,29,Sassuolo,36,Italy - Serie A
193,Francesco Bardi,41,13.0,28,31.70731707317073,14,3,11,21.428571428571427,2,2,0,100.0,38,11,27,28.947368421052634,58.18834005084878,0,0,0,0.0,0,0,0,0,0,0,0,Frosinone,2,Italy - Serie A
194,Francesco Benussi,103,49.0,54,47.57281553398058,28,5,23,17.857142857142858,7,6,1,85.71428571428571,86,33,53,38.372093023255815,51.19040930127379,0,0,0,0.0,0,0,0,0,0,0,0,Carpi,4,Italy - Serie A
195,Francesco Lodi,1378,1049.0,329,76.12481857764877,291,193,98,66.32302405498281,765,694,71,90.71895424836602,282,127,155,45.0354609929078,21.48506057357556,33,6,27,18.181818181818183,33,1,12,8,6,3,14,Udinese,24,Italy - Serie A
196,Francesco Magnanelli,2381,1960.0,421,82.31835363292734,413,263,150,63.68038740920097,1440,1351,89,93.81944444444444,320,175,145,54.6875,20.288160966358234,5,1,4,20.0,29,1,16,12,1,1,96,Sassuolo,34,Italy - Serie A
197,Francesco Totti,307,229.0,78,74.5928338762215,56,34,22,60.71428571428571,180,158,22,87.77777777777777,50,30,20,60.0,19.286333875364953,8,2,6,25.0,10,3,8,4,6,3,13,AS Roma,13,Italy - Serie A
198,Franco Brienza,916,670.0,246,73.14410480349345,113,62,51,54.86725663716814,549,478,71,87.06739526411657,141,59,82,41.843971631205676,18.41192881038786,43,10,33,23.25581395348837,31,3,37,21,15,9,25,Bologna,29,Italy - Serie A
199,Franco Damián Vázquez,1555,1132.0,423,72.79742765273312,234,159,75,67.94871794871796,906,764,142,84.32671081677704,151,74,77,49.00662251655629,17.124238566993643,94,24,70,25.53191489361702,47,7,190,96,85,42,214,Palermo,36,Italy - Serie A
200,Franco Signorelli,15,13.0,2,86.66666666666667,2,1,1,50.0,8,7,1,87.5,0,0,0,0.0,14.63005697808,0,0,0,0.0,0,0,1,1,0,0,1,Empoli,1,Italy - Serie A
201,Franco Zuculini,16,14.0,2,87.5,2,1,1,50.0,13,12,1,92.3076923076923,0,0,0,0.0,15.8469026724,1,0,1,0.0,0,0,0,0,0,0,2,Bologna,1,Italy - Serie A
202,Fredy Alejandro Guarín Vásquez,494,355.0,139,71.86234817813765,90,53,37,58.88888888888889,302,263,39,87.08609271523179,60,23,37,38.333333333333336,18.728320262627367,23,2,21,8.695652173913043,13,1,33,22,11,7,10,Inter Milan,16,Italy - Serie A
203,Gabriel Alejandro Paletta,807,617.0,190,76.45600991325898,100,40,60,40.0,398,379,19,95.22613065326632,172,74,98,43.02325581395349,24.143241664650112,5,0,5,0.0,3,0,5,3,0,0,14,Atalanta,24,Italy - Serie A
204,Gabriel Moisés Antunes da Silva,939,623.0,316,66.3471778487753,122,54,68,44.26229508196721,392,333,59,84.94897959183673,142,44,98,30.985915492957744,18.127917442770094,54,13,41,24.074074074074073,9,2,30,20,10,4,49,Genoa,27,Italy - Serie A
205,Gabriel Vasconelos Ferreira,22,20.0,2,90.9090909090909,0,0,0,0.0,13,12,1,92.3076923076923,3,2,1,66.66666666666666,26.67556267065818,0,0,0,0.0,0,0,0,0,0,0,0,Napoli,1,Italy - Serie A
206,Gaetano Letizia,1587,1060.0,527,66.79269061121613,333,165,168,49.549549549549546,656,564,92,85.97560975609755,299,93,206,31.103678929765888,21.166003358134596,78,19,59,24.358974358974358,34,0,79,37,28,12,66,Carpi,35,Italy - Serie A
207,Gaetano Monachello,69,56.0,13,81.15942028985508,7,3,4,42.857142857142854,44,41,3,93.18181818181817,3,1,2,33.33333333333333,13.499518083349566,3,1,2,33.33333333333333,0,0,17,10,7,2,7,Atalanta,10,Italy - Serie A
208,Gary Alexis Medel Soto,1797,1590.0,207,88.48080133555926,194,127,67,65.4639175257732,1122,1087,35,96.88057040998217,163,90,73,55.21472392638037,19.798347525428834,8,1,7,12.5,12,1,12,7,1,0,26,Inter Milan,29,Italy - Serie A
209,Gastón Alexis Silva Perdomo,527,410.0,117,77.7988614800759,50,27,23,54.0,294,271,23,92.17687074829932,71,27,44,38.028169014084504,19.365819799668387,16,4,12,25.0,10,1,15,7,6,1,9,Torino,12,Italy - Serie A
210,Gastón Brugman,610,494.0,116,80.98360655737706,93,66,27,70.96774193548387,406,358,48,88.17733990147784,42,27,15,64.28571428571429,17.60605919596918,4,1,3,25.0,14,1,16,11,3,2,12,Palermo,14,Italy - Serie A
211,Gennaro Sardo,187,157.0,30,83.9572192513369,20,11,9,55.00000000000001,100,94,6,94.0,27,15,12,55.55555555555556,19.774077883561922,10,5,5,50.0,5,0,3,1,0,0,2,Chievo,6,Italy - Serie A
212,Geoffrey Kondogbia,1319,1156.0,163,87.64215314632298,147,103,44,70.06802721088435,1016,947,69,93.20866141732283,61,38,23,62.295081967213115,16.72338373526975,4,3,1,75.0,16,0,62,36,20,11,53,Inter Milan,25,Italy - Serie A
213,Germán Gustavo Denis,334,234.0,100,70.05988023952095,32,14,18,43.75,175,155,20,88.57142857142857,14,5,9,35.714285714285715,12.464176618383952,7,1,6,14.285714285714285,16,1,16,8,6,3,18,Atalanta,15,Italy - Serie A
214,Gervais Lombe Yao Kouassi,330,271.0,59,82.12121212121211,20,17,3,85.0,267,238,29,89.13857677902621,2,0,2,0.0,13.18573571894618,13,4,9,30.76923076923077,12,1,47,28,33,20,6,AS Roma,14,Italy - Serie A
215,Giacomo Bonaventura,1684,1250.0,434,74.22802850356295,171,93,78,54.385964912280706,1074,945,129,87.98882681564247,217,84,133,38.70967741935484,17.416081578009976,70,20,50,28.57142857142857,60,8,114,68,68,39,87,AC Milan,33,Italy - Serie A
216,Giampaolo Pazzini,370,238.0,132,64.32432432432432,40,19,21,47.5,196,166,30,84.6938775510204,22,9,13,40.909090909090914,14.221725392298161,9,0,9,0.0,11,0,19,10,14,7,61,Hellas Verona,30,Italy - Serie A
217,Giampiero Pinzi,488,403.0,85,82.58196721311475,62,40,22,64.51612903225806,329,304,25,92.40121580547113,49,25,24,51.02040816326531,17.57879229782213,3,2,1,66.66666666666666,5,0,6,2,3,2,14,Chievo,18,Italy - Serie A
218,Giancarlo González Castro,995,767.0,228,77.0854271356784,100,34,66,34.0,440,414,26,94.0909090909091,190,81,109,42.63157894736842,24.331407536183153,1,1,0,100.0,3,0,2,2,0,0,10,Palermo,35,Italy - Serie A
219,Gianluca Pegolo,62,39.0,23,62.903225806451616,6,1,5,16.666666666666664,7,7,0,100.0,42,21,21,50.0,42.5832343496129,0,0,0,0.0,0,0,0,0,0,0,0,Sassuolo,2,Italy - Serie A
220,Gianluigi Buffon,888,721.0,167,81.19369369369369,35,11,24,31.428571428571427,467,465,2,99.57173447537473,301,144,157,47.840531561461795,30.81958850719622,0,0,0,0.0,0,0,0,0,0,0,0,Juventus,35,Italy - Serie A
221,Gianluigi Donnarumma,908,632.0,276,69.60352422907489,71,16,55,22.535211267605636,386,383,3,99.22279792746113,400,137,263,34.25,35.744112482689424,0,0,0,0.0,0,0,0,0,0,0,6,AC Milan,30,Italy - Serie A
222,Gianpaolo Bellini,506,409.0,97,80.8300395256917,72,47,25,65.27777777777779,274,255,19,93.06569343065694,48,17,31,35.41666666666667,16.871648309301342,13,4,9,30.76923076923077,1,0,5,4,2,1,10,Atalanta,15,Italy - Serie A
223,Gilberto Moraes Junior,275,207.0,68,75.27272727272727,18,10,8,55.55555555555556,177,156,21,88.13559322033898,19,9,10,47.368421052631575,16.123786350409308,15,4,11,26.666666666666668,4,0,19,12,13,9,9,Hellas Verona,10,Italy - Serie A
224,Giorgio Chiellini,1411,1215.0,196,86.10914245216159,173,109,64,63.005780346820806,909,868,41,95.48954895489548,139,61,78,43.884892086330936,20.804001515785174,7,2,5,28.57142857142857,10,0,5,4,2,1,26,Juventus,24,Italy - Serie A
225,Giovanni Marchese,354,261.0,93,73.72881355932203,39,15,24,38.46153846153847,189,174,15,92.06349206349206,60,18,42,30.0,19.985885630194577,8,2,6,25.0,2,0,0,0,0,0,5,Genoa,11,Italy - Serie A
226,Giovanni Pasquale,124,89.0,35,71.7741935483871,23,17,6,73.91304347826086,52,45,7,86.53846153846155,17,5,12,29.411764705882355,19.356597841906453,10,3,7,30.0,2,0,3,1,0,0,0,Udinese,6,Italy - Serie A
227,Giulio Migliaccio,239,155.0,84,64.85355648535564,29,8,21,27.586206896551722,124,109,15,87.90322580645162,14,4,10,28.57142857142857,14.950302391599665,5,1,4,20.0,3,0,0,0,0,0,12,Atalanta,18,Italy - Serie A
228,Giuseppe Pezzella,288,192.0,96,66.66666666666666,47,25,22,53.191489361702125,124,110,14,88.70967741935483,52,13,39,25.0,18.182840231274998,19,6,13,31.57894736842105,4,0,14,10,4,2,9,Palermo,8,Italy - Serie A
229,Giuseppe Rossi,155,117.0,38,75.48387096774194,9,3,6,33.33333333333333,99,83,16,83.83838383838383,5,4,1,80.0,13.377967550598193,5,3,2,60.0,6,1,7,6,2,2,9,Fiorentina,11,Italy - Serie A
230,Giuseppe Vives,1438,1194.0,244,83.03198887343532,184,101,83,54.891304347826086,883,836,47,94.67723669309174,162,82,80,50.617283950617285,19.96628267880501,9,2,7,22.22222222222222,17,1,15,11,4,2,30,Torino,33,Italy - Serie A
231,Godfred Donsah,496,340.0,156,68.54838709677419,79,46,33,58.22784810126582,306,249,57,81.37254901960785,29,9,20,31.03448275862069,15.836292175746774,14,4,10,28.57142857142857,6,1,34,19,12,8,15,Bologna,20,Italy - Serie A
232,Gonzalo Gerardo Higuaín,943,721.0,222,76.45811240721103,84,49,35,58.333333333333336,648,554,94,85.49382716049382,66,40,26,60.60606060606061,15.592001099933318,22,7,15,31.818181818181817,47,2,65,39,41,21,38,Napoli,35,Italy - Serie A
233,Gonzalo Javier Rodríguez,2231,1931.0,300,86.55311519497984,178,72,106,40.44943820224719,1363,1312,51,96.2582538517975,245,104,141,42.44897959183673,22.90472237213992,1,0,1,0.0,7,0,25,14,2,0,33,Fiorentina,35,Italy - Serie A
234,Goran Pandev,273,201.0,72,73.62637362637363,24,16,8,66.66666666666666,196,165,31,84.18367346938776,14,11,3,78.57142857142857,15.09911389234813,6,0,6,0.0,15,0,21,13,14,8,36,Genoa,15,Italy - Serie A
235,Gregoire Defrel,583,475.0,108,81.47512864493997,29,18,11,62.06896551724138,444,400,44,90.09009009009009,13,2,11,15.384615384615385,12.172930913084171,11,2,9,18.181818181818183,22,4,46,21,29,14,48,Sassuolo,33,Italy - Serie A
236,Guglielmo Stendardo,407,331.0,76,81.32678132678133,33,11,22,33.33333333333333,266,258,8,96.99248120300751,47,17,30,36.17021276595745,20.003218733452776,1,0,1,0.0,1,0,3,3,0,0,18,Atalanta,15,Italy - Serie A
237,Guilherme dos Santos Torres,229,172.0,57,75.10917030567686,46,32,14,69.56521739130434,138,126,12,91.30434782608695,31,12,19,38.70967741935484,19.268950827408208,5,1,4,20.0,5,0,3,1,1,0,8,Udinese,5,Italy - Serie A
238,Iago Falqué Silva,603,487.0,116,80.76285240464345,58,38,20,65.51724137931035,408,382,26,93.62745098039215,73,29,44,39.726027397260275,17.62100953842746,36,10,26,27.77777777777778,17,2,15,9,10,4,10,AS Roma,22,Italy - Serie A
239,Ibrahima Mbaye,642,498.0,144,77.57009345794393,89,56,33,62.92134831460674,357,329,28,92.15686274509804,45,15,30,33.33333333333333,17.027949061925607,15,4,11,26.666666666666668,2,0,16,6,10,4,30,Bologna,15,Italy - Serie A
240,Ignazio Abate,1632,1254.0,378,76.83823529411765,275,165,110,60.0,831,761,70,91.57641395908543,225,79,146,35.11111111111111,19.356657183211325,50,15,35,30.0,18,1,38,21,19,11,18,AC Milan,27,Italy - Serie A
241,Igor Bubnjić,238,186.0,52,78.15126050420169,29,15,14,51.724137931034484,120,114,6,95.0,55,30,25,54.54545454545454,24.212649343540843,1,0,1,0.0,1,0,1,1,0,0,6,Carpi,9,Italy - Serie A
242,Ionuț Andrei Radu,6,3.0,3,50.0,0,0,0,0.0,2,2,0,100.0,3,0,3,0.0,44.22607644480001,0,0,0,0.0,0,0,0,0,0,0,0,Inter Milan,1,Italy - Serie A
243,Isaac Cofie,941,682.0,259,72.4760892667375,181,80,101,44.19889502762431,484,442,42,91.32231404958677,121,44,77,36.36363636363637,19.911519693105284,7,2,5,28.57142857142857,11,1,17,13,4,2,14,Carpi,29,Italy - Serie A
244,Issa Cissokho,421,343.0,78,81.47268408551069,51,35,16,68.62745098039215,278,247,31,88.84892086330936,26,14,12,53.84615384615385,16.64104768583943,23,7,16,30.434782608695656,7,1,6,4,0,0,8,Genoa,13,Italy - Serie A
245,Ivan Perišić,1255,902.0,353,71.87250996015936,112,66,46,58.92857142857143,764,649,115,84.9476439790576,85,31,54,36.470588235294116,15.69723111089957,95,17,78,17.894736842105264,21,6,61,32,38,22,18,Inter Milan,34,Italy - Serie A
246,Ivan Radovanović,1364,1085.0,279,79.54545454545455,184,96,88,52.17391304347826,783,730,53,93.23116219667943,170,80,90,47.05882352941176,20.07209798831349,9,3,6,33.33333333333333,8,0,14,10,4,1,32,Chievo,26,Italy - Serie A
247,Ivan Strinić,227,201.0,26,88.54625550660793,17,10,7,58.82352941176471,158,147,11,93.0379746835443,3,1,2,33.33333333333333,14.091152000989956,2,0,2,0.0,1,0,4,2,3,1,2,Napoli,5,Italy - Serie A
248,Ivaylo Chochev,854,649.0,205,75.99531615925058,100,61,39,61.0,521,477,44,91.55470249520154,48,11,37,22.916666666666664,15.085210955471663,16,5,11,31.25,10,2,13,8,4,3,19,Palermo,26,Italy - Serie A
249,Iván Rodrigo Piris Leguizamón,853,676.0,177,79.24970691676437,122,64,58,52.459016393442624,469,436,33,92.96375266524521,127,59,68,46.45669291338583,19.018581277388794,20,8,12,40.0,7,0,13,11,3,2,18,Udinese,27,Italy - Serie A
250,Jacopo Sala,867,615.0,252,70.93425605536332,106,56,50,52.83018867924528,478,404,74,84.51882845188284,102,34,68,33.33333333333333,17.86496005057661,65,18,47,27.692307692307693,17,1,38,15,23,11,23,Hellas Verona,23,Italy - Serie A
251,Jakub Błaszczykowski,464,362.0,102,78.01724137931035,29,18,11,62.06896551724138,328,293,35,89.32926829268293,31,8,23,25.806451612903224,14.54865831519207,17,2,15,11.76470588235294,10,1,12,4,6,3,15,Fiorentina,15,Italy - Serie A
252,Jasmin Kurtič,1069,786.0,283,73.5266604303087,117,66,51,56.41025641025641,690,594,96,86.08695652173914,96,37,59,38.54166666666667,16.119980523383575,55,13,42,23.636363636363637,14,0,33,24,15,10,39,Atalanta,32,Italy - Serie A
253,Jeison Fabián Murillo Cerón,1570,1360.0,210,86.62420382165605,123,66,57,53.65853658536586,1024,990,34,96.6796875,158,60,98,37.9746835443038,20.952667700161683,1,0,1,0.0,4,0,7,5,1,0,39,Inter Milan,34,Italy - Serie A
254,Jerry Uche Mbakogu,454,293.0,161,64.53744493392071,29,13,16,44.827586206896555,265,202,63,76.22641509433963,9,5,4,55.55555555555556,12.007224404624141,22,11,11,50.0,21,2,36,15,18,6,45,Carpi,24,Italy - Serie A
255,Jesús Joaquín Fernández Sáez de la Torre,691,485.0,206,70.18813314037627,81,45,36,55.55555555555556,418,365,53,87.32057416267942,108,31,77,28.703703703703702,17.506634307524283,50,7,43,14.000000000000002,33,1,48,30,34,23,34,Genoa,20,Italy - Serie A
256,Joan Verdú Fernández,160,147.0,13,91.875,10,7,3,70.0,124,120,4,96.7741935483871,6,3,3,50.0,15.3181524240225,1,0,1,0.0,4,0,1,1,0,0,5,Fiorentina,5,Italy - Serie A
257,Joel Chukwuma Obi,184,138.0,46,75.0,29,17,12,58.620689655172406,122,110,12,90.1639344262295,9,2,7,22.22222222222222,16.088041993159564,6,1,5,16.666666666666664,6,0,7,2,2,0,15,Torino,10,Italy - Serie A
258,Jonathan Ludovic Biabiany,372,280.0,92,75.26881720430107,22,16,6,72.72727272727273,227,207,20,91.18942731277532,28,13,15,46.42857142857143,15.940147675139999,39,11,28,28.205128205128204,16,1,46,27,17,11,17,Inter Milan,20,Italy - Serie A
259,Jonathan de Guzmán,37,18.0,19,48.64864864864865,2,0,2,0.0,13,9,4,69.23076923076923,7,1,6,14.285714285714285,18.19101297528,4,1,3,25.0,1,0,1,1,0,0,1,Carpi,5,Italy - Serie A
260,Jorge Luiz Frello Filho,3779,3327.0,452,88.03916379994708,492,365,127,74.1869918699187,2944,2826,118,95.99184782608695,302,119,183,39.40397350993378,15.55344994301376,32,7,25,21.875,63,4,31,18,6,3,64,Napoli,35,Italy - Serie A
261,Josef Alexander Martínez Mencia,154,122.0,32,79.22077922077922,13,6,7,46.15384615384615,90,82,8,91.11111111111111,11,7,4,63.63636363636363,16.415170024362077,1,0,1,0.0,13,1,10,7,8,5,16,Torino,20,Italy - Serie A
262,Joseph Alfred Duncan,1284,918.0,366,71.49532710280374,229,155,74,67.68558951965066,803,688,115,85.67870485678705,151,60,91,39.735099337748345,18.641736986105045,70,21,49,30.0,45,5,70,38,36,16,21,Sassuolo,33,Italy - Serie A
263,Josip Iličić,1078,830.0,248,76.99443413729128,124,78,46,62.903225806451616,733,643,90,87.72169167803547,133,58,75,43.609022556390975,17.26565541140638,38,9,29,23.684210526315788,41,5,63,37,34,21,50,Fiorentina,30,Italy - Serie A
264,Josip Posavec,39,22.0,17,56.41025641025641,3,0,3,0.0,6,6,0,100.0,29,13,16,44.827586206896555,44.30917806871384,0,0,0,0.0,0,0,0,0,0,0,0,Palermo,1,Italy - Serie A
265,José Manuel Reina Páez,1103,899.0,204,81.5049864007253,80,16,64,20.0,583,578,5,99.14236706689536,330,138,192,41.81818181818181,31.908052897944152,0,0,0,0.0,1,0,0,0,0,0,1,Napoli,37,Italy - Serie A
266,José Martín Cáceres Silva,300,279.0,21,93.0,13,12,1,92.3076923076923,222,219,3,98.64864864864865,13,5,8,38.46153846153847,17.1122886466776,5,2,3,40.0,2,0,1,1,1,1,3,Juventus,6,Italy - Serie A
267,José María Callejón Bueno,1446,1134.0,312,78.42323651452283,91,53,38,58.24175824175825,976,892,84,91.39344262295081,69,17,52,24.637681159420293,13.476745471527634,62,9,53,14.516129032258066,40,6,29,12,13,5,73,Napoli,38,Italy - Serie A
268,José Mauri,148,134.0,14,90.54054054054053,16,14,2,87.5,109,105,4,96.3302752293578,9,7,2,77.77777777777779,17.22570201174162,0,0,0,0.0,5,0,3,1,2,0,8,AC Milan,5,Italy - Serie A
269,José Rodolfo Pires Ribeiro,637,489.0,148,76.76609105180535,57,37,20,64.91228070175438,334,299,35,89.52095808383234,57,17,40,29.82456140350877,15.572986188794221,40,15,25,37.5,15,1,45,26,14,9,28,Sampdoria,17,Italy - Serie A
270,João Miranda de Souza Filho,1536,1268.0,268,82.55208333333334,159,61,98,38.36477987421384,907,879,28,96.91289966923925,231,76,155,32.900432900432904,22.687797158168436,4,2,2,50.0,2,3,15,12,1,1,41,Inter Milan,32,Italy - Serie A
271,Juan Camilo Zúñiga Mosquera,155,123.0,32,79.35483870967742,12,9,3,75.0,101,92,9,91.0891089108911,14,6,8,42.857142857142854,16.277763618144,5,3,2,60.0,2,1,9,4,4,1,13,Bologna,9,Italy - Serie A
272,Juan Guilherme Nunes Jesus,949,778.0,171,81.98103266596416,98,51,47,52.04081632653062,602,567,35,94.18604651162791,85,25,60,29.411764705882355,18.165956231608007,15,7,8,46.666666666666664,10,0,17,10,6,2,9,Inter Milan,19,Italy - Serie A
273,Juan Guillermo Cuadrado Bello,1072,885.0,187,82.55597014925374,70,46,24,65.71428571428571,717,644,73,89.8186889818689,90,54,36,60.0,16.444598410082683,54,22,32,40.74074074074074,39,4,99,64,65,42,95,Juventus,28,Italy - Serie A
274,Juan Ignacio Gómez Taleb,652,447.0,205,68.55828220858896,46,21,25,45.65217391304348,374,308,66,82.35294117647058,24,12,12,50.0,12.922601203400244,12,5,7,41.66666666666667,22,0,30,20,18,12,54,Hellas Verona,33,Italy - Serie A
275,Juan Manuel Iturbe Arévalo,99,68.0,31,68.68686868686868,7,4,3,57.14285714285714,58,46,12,79.3103448275862,4,2,2,50.0,15.450455220901818,2,0,2,0.0,6,0,16,8,7,3,17,AS Roma,12,Italy - Serie A
276,Juan Pablo Carrizo,45,31.0,14,68.88888888888889,0,0,0,0.0,20,20,0,100.0,23,9,14,39.130434782608695,36.35363220496,0,0,0,0.0,0,0,0,0,0,0,0,Inter Milan,2,Italy - Serie A
277,Jules Olivier Ntcham,535,433.0,102,80.93457943925235,88,62,26,70.45454545454545,377,341,36,90.45092838196287,44,24,20,54.54545454545454,18.825963284770992,13,3,10,23.076923076923077,18,0,22,16,9,7,8,Genoa,17,Italy - Serie A
278,Juraj Kucka,1074,795.0,279,74.02234636871509,149,83,66,55.70469798657718,667,579,88,86.80659670164917,75,31,44,41.333333333333336,16.97024790373542,27,6,21,22.22222222222222,28,2,79,40,43,20,53,AC Milan,30,Italy - Serie A
279,Jérémy Ménez,167,126.0,41,75.44910179640718,13,9,4,69.23076923076923,122,103,19,84.42622950819673,11,5,6,45.45454545454545,14.773726530172455,7,0,7,0.0,4,0,6,2,6,2,5,AC Milan,10,Italy - Serie A
280,Kalidou Koulibaly,2382,2068.0,314,86.81780016792612,189,71,118,37.56613756613756,1717,1659,58,96.62201514269074,191,54,137,28.272251308900525,18.37901181899456,3,1,2,33.33333333333333,9,0,16,12,1,1,21,Napoli,33,Italy - Serie A
281,Kamil Glik,1657,1461.0,196,88.17139408569705,82,36,46,43.90243902439025,1053,1024,29,97.24596391263059,179,94,85,52.513966480446925,22.557070688257475,1,0,1,0.0,3,0,6,4,1,0,50,Torino,33,Italy - Serie A
282,Kamil Wilczek,33,22.0,11,66.66666666666666,3,2,1,66.66666666666666,14,12,2,85.71428571428571,3,1,2,33.33333333333333,13.976848886018182,0,0,0,0.0,0,0,3,2,1,1,0,Carpi,3,Italy - Serie A
283,Karim Laribi,281,200.0,81,71.17437722419929,35,18,17,51.42857142857142,188,156,32,82.97872340425532,21,7,14,33.33333333333333,16.316694534421924,8,3,5,37.5,11,0,8,3,3,0,7,Sassuolo,11,Italy - Serie A
284,Keisuke Honda,981,751.0,230,76.55453618756371,70,48,22,68.57142857142857,664,588,76,88.55421686746988,83,32,51,38.55421686746988,15.238091527833982,49,14,35,28.57142857142857,37,3,55,32,34,19,37,AC Milan,30,Italy - Serie A
285,Keita Baldé Diao,670,501.0,169,74.77611940298507,24,16,8,66.66666666666666,446,387,59,86.7713004484305,50,19,31,38.0,14.600926273634865,80,22,58,27.500000000000004,38,1,85,44,55,30,48,Lazio,31,Italy - Serie A
286,Kevin Lasagna,376,232.0,144,61.702127659574465,49,21,28,42.857142857142854,180,138,42,76.66666666666667,23,4,19,17.391304347826086,14.79385668266234,20,4,16,20.0,20,1,26,10,18,7,18,Carpi,36,Italy - Serie A
287,Kevin Strootman,168,154.0,14,91.66666666666666,19,16,3,84.21052631578947,135,126,9,93.33333333333333,6,3,3,50.0,15.560048806542857,2,1,1,50.0,2,1,2,1,2,1,2,AS Roma,5,Italy - Serie A
288,Kevin-Prince Boateng,147,106.0,41,72.10884353741497,12,9,3,75.0,77,67,10,87.01298701298701,11,5,6,45.45454545454545,16.889499714269387,6,1,5,16.666666666666664,5,0,5,4,4,4,5,AC Milan,11,Italy - Serie A
289,Khouma El Hadji Babacar,175,126.0,49,72.0,18,9,9,50.0,115,95,20,82.6086956521739,3,0,3,0.0,12.300678364768457,4,1,3,25.0,5,1,11,5,9,4,19,Fiorentina,18,Italy - Serie A
290,Kingsley Coman,29,23.0,6,79.3103448275862,0,0,0,0.0,19,17,2,89.47368421052632,3,2,1,66.66666666666666,15.270718119219309,4,3,1,75.0,2,0,1,1,0,0,4,Juventus,1,Italy - Serie A
291,Konstantinos Manolas,1756,1524.0,232,86.78815489749431,136,73,63,53.67647058823529,1098,1077,21,98.08743169398907,147,59,88,40.136054421768705,19.24539952159025,2,0,2,0.0,3,1,6,4,2,1,35,AS Roma,37,Italy - Serie A
292,Kwadwo Asamoah,344,312.0,32,90.69767441860465,25,22,3,88.0,267,251,16,94.00749063670412,25,20,5,80.0,16.80487412692186,2,1,1,50.0,8,1,12,9,1,1,15,Juventus,11,Italy - Serie A
293,Kévin Constant,234,194.0,40,82.90598290598291,23,9,14,39.130434782608695,156,139,17,89.1025641025641,17,9,8,52.94117647058824,16.88254227244,5,2,3,40.0,4,0,5,2,3,2,1,Bologna,7,Italy - Serie A
294,Lazaros Christodoulopoulos,164,124.0,40,75.60975609756098,19,11,8,57.89473684210527,111,96,15,86.48648648648648,11,2,9,18.181818181818183,16.676637656588778,3,1,2,33.33333333333333,0,0,10,4,5,3,10,Sampdoria,10,Italy - Serie A
295,Leandro Castán da Silva,165,143.0,22,86.66666666666667,5,2,3,40.0,115,113,2,98.26086956521739,17,9,8,52.94117647058824,18.922719638679272,0,0,0,0.0,0,0,2,2,0,0,5,AS Roma,5,Italy - Serie A
296,Leandro Daniel Paredes,2087,1675.0,412,80.2587446094873,318,179,139,56.289308176100626,1419,1325,94,93.37561663143057,318,124,194,38.9937106918239,19.246623658253025,21,5,16,23.809523809523807,41,1,44,30,8,5,86,Empoli,33,Italy - Serie A
297,Leandro Greco,996,821.0,175,82.429718875502,130,89,41,68.46153846153847,620,577,43,93.06451612903226,98,53,45,54.08163265306123,19.01903710995036,20,2,18,10.0,20,0,36,19,10,8,45,Hellas Verona,26,Italy - Serie A
298,Leonardo Blanchard,916,635.0,281,69.32314410480349,236,99,137,41.94915254237288,327,310,17,94.80122324159022,276,113,163,40.94202898550724,27.420345969504364,4,1,3,25.0,5,0,8,7,1,1,18,Frosinone,28,Italy - Serie A
299,Leonardo Bonucci,2336,2022.0,314,86.5582191780822,251,126,125,50.199203187250994,1377,1335,42,96.94989106753813,310,158,152,50.967741935483865,23.346552351145004,3,0,3,0.0,13,1,20,15,4,2,31,Juventus,36,Italy - Serie A
300,Leonardo Pavoletti,450,317.0,133,70.44444444444444,47,16,31,34.04255319148936,241,212,29,87.96680497925311,20,9,11,45.0,13.3560524656928,2,1,1,50.0,18,3,13,7,8,5,38,Genoa,25,Italy - Serie A
301,Levan Mchedlidze,86,61.0,25,70.93023255813954,4,2,2,50.0,57,47,10,82.45614035087719,2,2,0,100.0,13.205302076386046,0,0,0,0.0,3,0,9,5,3,1,2,Empoli,13,Italy - Serie A
302,Lorenzo Ariaudo,303,262.0,41,86.46864686468648,16,8,8,50.0,195,191,4,97.94871794871794,33,15,18,45.45454545454545,19.123101675407526,0,0,0,0.0,0,0,0,0,0,0,9,Empoli,9,Italy - Serie A
303,Lorenzo Crisetig,194,156.0,38,80.41237113402062,22,11,11,50.0,143,126,17,88.11188811188812,12,4,8,33.33333333333333,17.220560245381854,1,0,1,0.0,2,0,6,4,0,0,9,Bologna,5,Italy - Serie A
304,Lorenzo De Silvestri,756,499.0,257,66.005291005291,96,43,53,44.79166666666667,309,278,31,89.96763754045307,107,24,83,22.429906542056074,17.30423891492381,45,11,34,24.444444444444443,11,2,9,7,5,4,20,Sampdoria,17,Italy - Serie A
305,Lorenzo Di Livio,8,8.0,0,100.0,1,1,0,100.0,7,7,0,100.0,0,0,0,0.0,12.05455777425,0,0,0,0.0,0,0,0,0,0,0,0,AS Roma,1,Italy - Serie A
306,Lorenzo Insigne,1718,1353.0,365,78.75436554132712,164,93,71,56.70731707317073,1240,1097,143,88.46774193548387,130,49,81,37.69230769230769,14.163277012314412,69,18,51,26.08695652173913,58,10,101,52,75,37,29,Napoli,37,Italy - Serie A
307,Lorenzo Lollo,700,489.0,211,69.85714285714286,130,64,66,49.23076923076923,389,334,55,85.8611825192802,64,21,43,32.8125,17.45195541135737,10,3,7,30.0,11,1,41,21,17,7,46,Carpi,27,Italy - Serie A
308,Lorenzo Pasciuti,844,511.0,333,60.54502369668246,142,61,81,42.95774647887324,301,252,49,83.72093023255815,205,64,141,31.21951219512195,20.866500690176302,61,17,44,27.86885245901639,25,3,23,14,11,6,16,Carpi,21,Italy - Serie A
309,Lorenzo Pellegrini,614,463.0,151,75.4071661237785,74,43,31,58.108108108108105,398,350,48,87.93969849246231,44,17,27,38.63636363636363,16.61465929864808,17,5,12,29.411764705882355,13,0,28,16,12,6,29,Sassuolo,19,Italy - Serie A
310,Lorenzo Tonelli,1353,1143.0,210,84.4789356984479,135,52,83,38.51851851851852,880,850,30,96.5909090909091,122,49,73,40.16393442622951,18.056906483509355,1,0,1,0.0,5,0,10,5,3,0,57,Empoli,26,Italy - Serie A
311,Luca Antei,169,136.0,33,80.4733727810651,13,6,7,46.15384615384615,102,97,5,95.09803921568627,21,6,15,28.57142857142857,19.91915448003181,0,0,0,0.0,0,1,0,0,0,0,5,Sassuolo,5,Italy - Serie A
312,Luca Antonelli,1555,1234.0,321,79.35691318327974,177,115,62,64.97175141242938,882,796,86,90.24943310657596,93,29,64,31.182795698924732,16.335189179787474,42,12,30,28.57142857142857,13,1,38,21,19,9,65,AC Milan,28,Italy - Serie A
313,Luca Bittante,381,303.0,78,79.52755905511812,37,20,17,54.054054054054056,221,194,27,87.78280542986425,32,12,20,37.5,16.26147837168,12,6,6,50.0,4,0,9,4,4,1,8,Empoli,16,Italy - Serie A
314,Luca Checchin,64,47.0,17,73.4375,5,0,5,0.0,38,35,3,92.10526315789474,7,2,5,28.57142857142857,19.6952887605375,0,0,0,0.0,0,0,0,0,0,0,1,Hellas Verona,4,Italy - Serie A
315,Luca Cigarini,1287,998.0,289,77.54467754467754,191,115,76,60.20942408376963,729,651,78,89.30041152263375,170,86,84,50.588235294117645,18.817281145982378,28,9,19,32.142857142857146,30,2,20,13,4,2,36,Atalanta,25,Italy - Serie A
316,Luca Lezzerini,50,32.0,18,64.0,2,0,2,0.0,20,20,0,100.0,25,7,18,28.000000000000004,35.839072092095996,0,0,0,0.0,0,0,1,1,0,0,0,Fiorentina,2,Italy - Serie A
317,Luca Marrone,845,656.0,189,77.63313609467455,131,62,69,47.32824427480916,473,434,39,91.75475687103594,123,54,69,43.90243902439025,20.484908554807383,12,5,7,41.66666666666667,21,3,21,16,6,5,25,Hellas Verona,21,Italy - Serie A
318,Luca Martinelli,48,40.0,8,83.33333333333334,4,1,3,25.0,24,24,0,100.0,8,4,4,50.0,23.963214137865,0,0,0,0.0,0,0,0,0,0,0,0,Empoli,1,Italy - Serie A
319,Luca Paganini,501,336.0,165,67.06586826347305,58,33,25,56.896551724137936,257,214,43,83.26848249027238,46,16,30,34.78260869565217,15.934800852322635,25,9,16,36.0,17,2,39,21,26,15,60,Frosinone,27,Italy - Serie A
320,Luca Rigoni,765,602.0,163,78.69281045751634,95,59,36,62.10526315789474,487,444,43,91.17043121149896,69,26,43,37.68115942028986,16.76665035540988,11,3,8,27.27272727272727,21,0,15,9,6,2,21,Palermo,28,Italy - Serie A
321,Luca Rizzo,549,397.0,152,72.31329690346084,62,43,19,69.35483870967742,380,317,63,83.42105263157895,25,10,15,40.0,14.743327171139672,27,8,19,29.629629629629626,12,2,44,19,20,9,24,Bologna,23,Italy - Serie A
322,Luca Rossettini,1310,983.0,327,75.0381679389313,189,80,109,42.32804232804233,635,603,32,94.96062992125984,236,72,164,30.508474576271187,21.94671491291267,14,3,11,21.428571428571427,6,1,2,0,1,0,20,Bologna,29,Italy - Serie A
323,Luca Siligardi,559,357.0,202,63.864042933810374,45,24,21,53.333333333333336,308,247,61,80.1948051948052,82,31,51,37.80487804878049,17.17563625781925,54,15,39,27.77777777777778,27,0,52,25,33,18,14,Hellas Verona,28,Italy - Serie A
324,Luca Toni,360,184.0,176,51.11111111111111,52,15,37,28.846153846153843,120,90,30,75.0,13,4,9,30.76923076923077,12.2389990305636,7,1,6,14.285714285714285,10,0,24,9,20,7,66,Hellas Verona,23,Italy - Serie A
325,Lucas Digne,2020,1564.0,456,77.42574257425743,160,96,64,60.0,1089,1016,73,93.29660238751147,199,61,138,30.65326633165829,15.443199940629388,102,25,77,24.509803921568626,24,2,40,22,20,11,32,AS Roma,33,Italy - Serie A
326,Lucas Nahuel Castro,1232,894.0,338,72.56493506493507,163,72,91,44.171779141104295,726,635,91,87.46556473829202,122,43,79,35.24590163934426,16.649759282461947,51,19,32,37.254901960784316,30,1,52,24,18,8,41,Chievo,34,Italy - Serie A
327,Lucas Rodrigo Biglia,1991,1692.0,299,84.98242089402311,254,183,71,72.04724409448819,1293,1232,61,95.28228924980665,243,119,124,48.971193415637856,19.511032745711482,24,6,18,25.0,49,3,21,19,2,2,58,Lazio,27,Italy - Serie A
328,Luigi Giorgi,18,17.0,1,94.44444444444444,1,1,0,100.0,16,16,0,100.0,1,1,0,100.0,12.93502055612,0,0,0,0.0,1,0,0,0,0,0,1,Atalanta,1,Italy - Serie A
329,Luis Fernando Muriel Fruto,512,363.0,149,70.8984375,60,32,28,53.333333333333336,331,269,62,81.2688821752266,20,13,7,65.0,14.354049764645156,17,5,12,29.411764705882355,21,5,94,45,64,31,41,Sampdoria,32,Italy - Serie A
330,Luiz Adriano de Souza da Silva,274,201.0,73,73.35766423357664,29,18,11,62.06896551724138,176,150,26,85.22727272727273,13,6,7,46.15384615384615,15.354086668588904,10,0,10,0.0,11,3,13,9,4,4,35,AC Milan,26,Italy - Serie A
331,M''Baye Babacar Niang,377,255.0,122,67.63925729442971,35,22,13,62.857142857142854,238,194,44,81.5126050420168,44,20,24,45.45454545454545,16.111021544989498,24,7,17,29.166666666666668,10,2,69,29,36,13,30,AC Milan,16,Italy - Serie A
332,Maicon Douglas Sisenando,840,680.0,160,80.95238095238095,86,49,37,56.97674418604651,515,471,44,91.45631067961165,71,27,44,38.028169014084504,16.14322577052514,35,11,24,31.428571428571427,9,2,15,13,8,7,11,AS Roma,15,Italy - Serie A
333,Manolo Gabbiadini,160,118.0,42,73.75,10,5,5,50.0,118,97,21,82.20338983050848,6,1,5,16.666666666666664,13.026928049342999,4,0,4,0.0,10,3,7,2,4,1,13,Napoli,23,Italy - Serie A
334,Manuel Locatelli,60,47.0,13,78.33333333333333,8,4,4,50.0,32,30,2,93.75,10,4,6,40.0,23.248010174447998,1,0,1,0.0,0,0,2,1,0,0,0,AC Milan,2,Italy - Serie A
335,Manuel Pasqual,759,589.0,170,77.60210803689066,66,36,30,54.54545454545454,442,412,30,93.21266968325791,104,23,81,22.115384615384613,18.187275049637314,51,13,38,25.49019607843137,21,2,5,2,0,0,18,Fiorentina,17,Italy - Serie A
336,Manuel Pucciarelli,1058,847.0,211,80.05671077504726,67,45,22,67.16417910447761,834,727,107,87.17026378896882,23,10,13,43.47826086956522,11.696565307468354,21,6,15,28.57142857142857,39,3,62,32,39,20,71,Empoli,38,Italy - Serie A
337,Manuel Rolando Iturra Urrutia,448,369.0,79,82.36607142857143,58,35,23,60.3448275862069,290,266,24,91.72413793103448,38,19,19,50.0,16.946378418058394,5,2,3,40.0,5,0,9,7,1,1,24,Udinese,17,Italy - Serie A
338,Marcel Büchel,886,713.0,173,80.47404063205418,93,51,42,54.83870967741935,620,560,60,90.32258064516128,71,27,44,38.028169014084504,15.705719277826184,14,3,11,21.428571428571427,19,1,29,18,11,7,23,Empoli,28,Italy - Serie A
339,Marcello Gazzola,222,177.0,45,79.72972972972973,22,12,10,54.54545454545454,102,93,9,91.17647058823529,23,11,12,47.82608695652174,17.230757449667028,9,3,6,33.33333333333333,0,1,3,2,0,0,2,Sassuolo,9,Italy - Serie A
340,Marcello Trotta,50,38.0,12,76.0,3,3,0,100.0,35,28,7,80.0,2,2,0,100.0,13.7679258005424,0,0,0,0.0,2,0,5,3,2,1,1,Sassuolo,8,Italy - Serie A
341,Marcelo Alejandro Estigarribia Balmori,17,10.0,7,58.82352941176471,0,0,0,0.0,8,6,2,75.0,1,0,1,0.0,13.867469967345883,1,0,1,0.0,0,0,1,0,0,0,4,Atalanta,4,Italy - Serie A
342,Marcelo Brozović,1841,1451.0,390,78.81586094513851,279,196,83,70.25089605734766,1105,988,117,89.41176470588236,230,103,127,44.78260869565218,19.162434545098023,56,20,36,35.714285714285715,48,4,77,40,32,22,37,Inter Milan,32,Italy - Serie A
343,Marco Antônio De Mattos Filho,218,162.0,56,74.31192660550458,32,13,19,40.625,130,116,14,89.23076923076924,22,8,14,36.36363636363637,16.307306329845137,3,0,3,0.0,6,0,11,10,4,4,7,Udinese,11,Italy - Serie A
344,Marco Benassi,661,475.0,186,71.86081694402421,66,38,28,57.57575757575758,369,314,55,85.09485094850947,53,26,27,49.056603773584904,16.847046069726826,30,10,20,33.33333333333333,20,2,27,15,16,9,20,Torino,32,Italy - Serie A
345,Marco Borriello,425,335.0,90,78.82352941176471,40,28,12,70.0,269,243,26,90.33457249070632,25,14,11,56.00000000000001,15.042448009251105,11,4,7,36.36363636363637,15,3,49,25,24,11,30,Atalanta,27,Italy - Serie A
346,Marco Crimi,364,238.0,126,65.38461538461539,60,31,29,51.66666666666667,187,158,29,84.49197860962568,43,21,22,48.837209302325576,16.83239891455187,7,3,4,42.857142857142854,8,1,31,12,15,7,37,Carpi,20,Italy - Serie A
347,Marco D''Alessandro,373,259.0,114,69.43699731903486,27,16,11,59.25925925925925,241,198,43,82.15767634854771,39,21,18,53.84615384615385,15.372745801497265,41,21,20,51.21951219512195,14,2,55,29,31,17,32,Atalanta,23,Italy - Serie A
348,Marco Parolo,1218,956.0,262,78.48932676518884,201,131,70,65.17412935323384,714,658,56,92.15686274509804,117,56,61,47.863247863247864,18.29823137692788,24,8,16,33.33333333333333,31,0,15,10,4,3,24,Lazio,31,Italy - Serie A
349,Marco Sportiello,1084,616.0,468,56.82656826568265,120,29,91,24.166666666666668,222,221,1,99.54954954954955,735,278,457,37.823129251700685,45.151088329489156,0,0,0,0.0,2,0,1,1,0,0,4,Atalanta,36,Italy - Serie A
350,Marco Zambelli,789,614.0,175,77.82002534854246,66,33,33,50.0,437,397,40,90.8466819221968,94,37,57,39.361702127659576,16.60257742849551,29,4,25,13.793103448275861,3,0,15,9,8,5,13,Empoli,19,Italy - Serie A
351,Marcos Alonso Mendoza,1704,1373.0,331,80.57511737089203,115,66,49,57.391304347826086,1006,932,74,92.6441351888668,156,62,94,39.743589743589745,17.979515553291126,93,32,61,34.40860215053764,37,4,57,32,26,14,34,Fiorentina,31,Italy - Serie A
352,Marek Hamšík,3094,2633.0,461,85.10019392372334,449,317,132,70.60133630289532,2277,2085,192,91.56785243741766,220,124,96,56.36363636363636,16.680352041355345,50,11,39,22.0,81,11,47,27,29,17,31,Napoli,38,Italy - Serie A
353,Mario Barwuah Balotelli,361,229.0,132,63.43490304709142,56,31,25,55.35714285714286,182,146,36,80.21978021978022,65,23,42,35.38461538461539,18.6040116304558,37,11,26,29.72972972972973,23,1,36,23,25,16,43,AC Milan,20,Italy - Serie A
354,Mario Lemina,462,409.0,53,88.52813852813853,57,43,14,75.43859649122807,329,309,20,93.9209726443769,28,14,14,50.0,19.199550114260262,2,0,2,0.0,5,0,10,9,2,2,9,Juventus,10,Italy - Serie A
355,Mario Mandžukić,562,395.0,167,70.2846975088968,41,27,14,65.85365853658537,307,258,49,84.03908794788273,22,8,14,36.36363636363637,13.5309772934763,24,7,17,29.166666666666668,23,4,19,11,11,6,35,Juventus,27,Italy - Serie A
356,Mario Suárez Mata,465,429.0,36,92.25806451612904,60,53,7,88.33333333333333,365,348,17,95.34246575342465,15,11,4,73.33333333333333,17.05288488241409,2,1,1,50.0,1,0,6,3,1,0,9,Fiorentina,9,Italy - Serie A
357,Marios Oikonomou,759,598.0,161,78.78787878787878,115,58,57,50.43478260869565,419,393,26,93.7947494033413,132,47,85,35.60606060606061,22.993623398732964,3,1,2,33.33333333333333,1,1,4,3,0,0,11,Bologna,20,Italy - Serie A
358,Marko Livaja,195,133.0,62,68.2051282051282,13,9,4,69.23076923076923,131,99,32,75.57251908396947,7,1,6,14.285714285714285,13.814240502996922,12,2,10,16.666666666666664,5,0,20,8,14,6,15,Empoli,18,Italy - Serie A
359,Marten de Roon,1669,1290.0,379,77.29179149191133,245,133,112,54.285714285714285,949,876,73,92.3076923076923,197,83,114,42.13197969543147,20.236671849228138,9,0,9,0.0,18,1,25,17,4,1,35,Atalanta,36,Italy - Serie A
360,Martín Montoya Torralbo,204,169.0,35,82.84313725490196,22,18,4,81.81818181818183,131,121,10,92.36641221374046,14,5,9,35.714285714285715,15.30876310008353,6,1,5,16.666666666666664,3,0,6,4,2,1,7,Inter Milan,3,Italy - Serie A
361,Massimiliano Carlini,135,91.0,44,67.4074074074074,15,11,4,73.33333333333333,72,65,7,90.27777777777779,8,2,6,25.0,14.450649413434666,11,1,10,9.090909090909092,11,0,10,4,5,1,8,Frosinone,14,Italy - Serie A
362,Massimo Gobbi,1689,1252.0,437,74.12670219064536,244,119,125,48.77049180327869,821,728,93,88.67235079171742,190,71,119,37.368421052631575,17.640878932003908,54,17,37,31.48148148148148,16,1,37,25,16,9,16,Chievo,34,Italy - Serie A
363,Massimo Maccarone,648,439.0,209,67.74691358024691,42,17,25,40.476190476190474,453,359,94,79.24944812362031,28,8,20,28.57142857142857,12.829183929253333,25,6,19,24.0,31,5,51,16,32,8,55,Empoli,37,Italy - Serie A
364,Massimo Zenildo Zappino,117,71.0,46,60.68376068376068,11,5,6,45.45454545454545,14,14,0,100.0,95,51,44,53.68421052631579,49.117031536553846,0,0,0,0.0,2,0,0,0,0,0,0,Frosinone,4,Italy - Serie A
365,Mato Jajalo,1077,860.0,217,79.85143918291551,149,90,59,60.40268456375839,661,601,60,90.92284417549168,98,38,60,38.775510204081634,18.044275985314762,6,1,5,16.666666666666664,18,0,18,13,6,3,31,Palermo,28,Italy - Serie A
366,Matteo Bianchetti,753,581.0,172,77.15803452855245,86,41,45,47.674418604651166,418,395,23,94.49760765550239,128,46,82,35.9375,20.8584007092349,8,2,6,25.0,4,0,4,2,0,0,16,Hellas Verona,23,Italy - Serie A
367,Matteo Brighi,608,499.0,109,82.07236842105263,81,58,23,71.60493827160494,425,393,32,92.47058823529412,20,9,11,45.0,14.515362109429343,6,0,6,0.0,9,0,14,7,6,2,35,Bologna,23,Italy - Serie A
368,Matteo Ciofani,539,377.0,162,69.9443413729128,81,41,40,50.617283950617285,203,179,24,88.17733990147784,100,39,61,39.0,19.79408314489425,18,5,13,27.77777777777778,1,1,15,7,5,1,6,Frosinone,18,Italy - Serie A
369,Matteo Fedele,226,167.0,59,73.89380530973452,32,18,14,56.25,122,111,11,90.98360655737704,46,21,25,45.65217391304348,22.6798863116623,10,4,6,40.0,8,0,8,4,2,0,4,Carpi,8,Italy - Serie A
370,Matteo Mancosu,191,120.0,71,62.82722513089005,19,6,13,31.57894736842105,103,80,23,77.66990291262135,3,1,2,33.33333333333333,13.467848746346387,9,3,6,33.33333333333333,10,0,11,6,6,3,17,Bologna,21,Italy - Serie A
371,Matteo Politano,445,318.0,127,71.46067415730337,46,27,19,58.69565217391305,298,246,52,82.5503355704698,43,13,30,30.23255813953488,15.798563099279999,22,5,17,22.727272727272727,16,2,51,19,31,10,20,Sassuolo,28,Italy - Serie A
372,Mattia Cassani,1130,894.0,236,79.11504424778761,141,79,62,56.02836879432624,626,575,51,91.85303514376997,133,41,92,30.82706766917293,19.65728174652255,27,6,21,22.22222222222222,7,1,16,10,5,3,20,Sampdoria,25,Italy - Serie A
373,Mattia De Sciglio,1172,880.0,292,75.0853242320819,120,73,47,60.83333333333333,572,514,58,89.86013986013987,136,54,82,39.705882352941174,18.150656489282458,56,18,38,32.142857142857146,17,1,13,7,4,3,16,AC Milan,22,Italy - Serie A
374,Mattia Destro,413,260.0,153,62.95399515738499,51,20,31,39.21568627450981,226,174,52,76.99115044247787,17,4,13,23.52941176470588,14.450078045955836,10,1,9,10.0,9,2,60,18,37,11,57,Bologna,27,Italy - Serie A
375,Mattia Perin,776,449.0,327,57.86082474226804,84,18,66,21.428571428571427,193,193,0,100.0,509,187,322,36.73870333988212,43.38250008455227,0,0,0,0.0,1,0,0,0,0,0,2,Genoa,25,Italy - Serie A
376,Mattia Zaccagni,19,12.0,7,63.1578947368421,2,0,2,0.0,13,11,2,84.61538461538461,0,0,0,0.0,14.457080239692633,0,0,0,0.0,0,0,0,0,0,0,2,Hellas Verona,3,Italy - Serie A
377,Matuzalém Francelino da Silva,176,147.0,29,83.52272727272727,33,21,12,63.63636363636363,113,109,4,96.46017699115043,22,10,12,45.45454545454545,20.39752721482773,1,0,1,0.0,1,0,2,2,1,1,4,Hellas Verona,7,Italy - Serie A
378,Matías Agustín Silvestre,1015,862.0,153,84.92610837438423,59,29,30,49.152542372881356,616,602,14,97.72727272727273,102,41,61,40.19607843137255,21.449549245047958,0,0,0,0.0,1,0,6,6,0,0,17,Sampdoria,25,Italy - Serie A
379,Matías Ariel Fernández Fernández,695,600.0,95,86.33093525179856,60,41,19,68.33333333333333,538,508,30,94.42379182156134,42,14,28,33.33333333333333,14.954298336718965,16,5,11,31.25,20,3,20,13,9,5,40,Fiorentina,22,Italy - Serie A
380,Matías Vecino Falero,1964,1722.0,242,87.67820773930754,220,154,66,70.0,1455,1376,79,94.57044673539518,93,53,40,56.98924731182796,16.65732108152786,6,0,6,0.0,25,1,38,27,16,10,34,Fiorentina,30,Italy - Serie A
381,Mauricio Aníbal Isla Isla,13,11.0,2,84.61538461538461,1,1,0,100.0,9,8,1,88.88888888888889,0,0,0,0.0,13.119953635384615,1,1,0,100.0,1,0,2,0,1,0,0,Juventus,1,Italy - Serie A
382,Mauricio Ricardo Pinilla Ferreira,351,232.0,119,66.0968660968661,46,21,25,45.65217391304348,152,128,24,84.21052631578947,20,10,10,50.0,15.182369863148717,18,8,10,44.44444444444444,15,2,21,8,12,5,33,Atalanta,20,Italy - Serie A
383,Maurizio Domizzi,157,122.0,35,77.70700636942675,23,7,16,30.434782608695656,88,87,1,98.86363636363636,24,7,17,29.166666666666668,21.619878015664206,0,0,0,0.0,2,0,0,0,0,0,1,Udinese,4,Italy - Serie A
384,Maurizio Pugliesi,28,17.0,11,60.71428571428571,2,0,2,0.0,11,11,0,100.0,16,5,11,31.25,41.282775963257144,0,0,0,0.0,0,0,0,0,0,0,1,Empoli,1,Italy - Serie A
385,Mauro Emanuel Icardi Rivero,558,397.0,161,71.14695340501792,43,19,24,44.18604651162791,332,275,57,82.83132530120481,23,10,13,43.47826086956522,14.03603896023871,24,13,11,54.166666666666664,27,4,17,7,11,5,43,Inter Milan,33,Italy - Serie A
386,Mauro Matías Zárate,265,208.0,57,78.49056603773586,22,17,5,77.27272727272727,202,176,26,87.12871287128714,12,3,9,25.0,14.02439455010717,8,2,6,25.0,10,0,36,20,29,17,17,Fiorentina,15,Italy - Serie A
387,Maurício dos Santos Nascimento,1024,836.0,188,81.640625,76,29,47,38.15789473684211,568,554,14,97.53521126760563,102,31,71,30.392156862745097,20.150197258331954,0,0,0,0.0,1,0,5,4,0,0,18,Lazio,24,Italy - Serie A
388,Maximiliano Gastón López,210,133.0,77,63.33333333333333,26,6,20,23.076923076923077,113,89,24,78.76106194690266,13,6,7,46.15384615384615,14.139973050132687,3,0,3,0.0,10,2,17,13,8,6,13,Torino,26,Italy - Serie A
389,Maximiliano Nicol Moralez,799,604.0,195,75.59449311639548,75,51,24,68.0,497,437,60,87.92756539235413,83,33,50,39.75903614457831,16.13619555903169,64,19,45,29.6875,37,4,29,14,15,6,42,Atalanta,17,Italy - Serie A
390,Michel Morganella,493,342.0,151,69.3711967545639,67,34,33,50.74626865671642,228,199,29,87.28070175438597,71,21,50,29.577464788732392,17.88080442565144,20,3,17,15.0,4,1,14,8,4,1,13,Palermo,14,Italy - Serie A
391,Michelangelo Albertazzi,334,237.0,97,70.95808383233533,69,35,34,50.72463768115942,123,106,17,86.1788617886179,62,28,34,45.16129032258064,20.02527586069006,14,6,8,42.857142857142854,3,0,4,3,2,2,3,Hellas Verona,10,Italy - Serie A
392,Michele Camporese,49,47.0,2,95.91836734693877,3,2,1,66.66666666666666,39,39,0,100.0,4,3,1,75.0,15.966445632994285,0,0,0,0.0,0,0,0,0,0,0,2,Empoli,2,Italy - Serie A
393,Michele Rocca,15,7.0,8,46.666666666666664,5,1,4,20.0,7,4,3,57.14285714285714,2,0,2,0.0,17.865849147072,0,0,0,0.0,0,0,0,0,0,0,0,Sampdoria,1,Italy - Serie A
394,Milan Badelj,1815,1567.0,248,86.33608815426997,275,197,78,71.63636363636363,1266,1189,77,93.91785150078988,151,87,64,57.615894039735096,17.867877015554182,6,1,5,16.666666666666664,32,1,35,23,11,6,24,Fiorentina,27,Italy - Serie A
395,Milan Biševac,450,385.0,65,85.55555555555556,49,30,19,61.224489795918366,279,271,8,97.1326164874552,57,27,30,47.368421052631575,20.8284794451168,0,0,0,0.0,2,0,3,3,0,0,6,Lazio,11,Italy - Serie A
396,Milan Škriniar,78,73.0,5,93.58974358974359,7,5,2,71.42857142857143,58,58,0,100.0,5,0,5,0.0,18.22875920798769,0,0,0,0.0,0,0,1,1,0,0,1,Sampdoria,3,Italy - Serie A
397,Miralem Pjanić,2395,1914.0,481,79.91649269311065,284,183,101,64.43661971830986,1526,1403,123,91.9397116644823,315,143,172,45.3968253968254,17.537733541774145,61,12,49,19.672131147540984,64,11,43,26,21,12,45,AS Roma,33,Italy - Serie A
398,Mirko Gori,973,705.0,268,72.4563206577595,158,75,83,47.46835443037975,516,467,49,90.50387596899225,155,53,102,34.193548387096776,19.711685937301787,27,6,21,22.22222222222222,12,0,27,16,7,3,55,Frosinone,28,Italy - Serie A
399,Mirko Valdifiori,464,384.0,80,82.75862068965517,92,58,34,63.04347826086957,299,287,12,95.9866220735786,71,31,40,43.66197183098591,19.156928858689653,4,2,2,50.0,12,0,4,2,1,0,7,Napoli,6,Italy - Serie A
400,Miroslav Klose,317,205.0,112,64.66876971608832,44,15,29,34.090909090909086,148,123,25,83.1081081081081,15,6,9,40.0,14.76008650178347,4,2,2,50.0,9,6,29,12,18,7,22,Lazio,24,Italy - Serie A
401,Modibo Diakité,726,550.0,176,75.75757575757575,85,24,61,28.235294117647058,383,362,21,94.51697127937337,109,28,81,25.688073394495415,21.913601836957785,4,0,4,0.0,4,0,11,10,3,2,19,Frosinone,26,Italy - Serie A
402,Mohamed Salah,1196,960.0,236,80.2675585284281,59,37,22,62.71186440677966,927,808,119,87.16289104638619,25,11,14,44.0,12.720607324481438,45,17,28,37.77777777777778,53,6,99,47,54,25,47,AS Roma,34,Italy - Serie A
403,Mohamed Salim Fares,281,200.0,81,71.17437722419929,28,12,16,42.857142857142854,110,98,12,89.0909090909091,50,18,32,36.0,19.059106107828043,18,9,9,50.0,6,1,9,8,4,3,1,Hellas Verona,11,Italy - Serie A
404,Molla Wagué,627,503.0,124,80.22328548644339,53,23,30,43.39622641509434,371,363,8,97.84366576819407,58,18,40,31.03448275862069,17.824023666420285,5,2,3,40.0,4,0,2,1,0,0,22,Udinese,21,Italy - Serie A
405,Morgan De Sanctis,79,59.0,20,74.68354430379746,2,1,1,50.0,41,41,0,100.0,32,12,20,37.5,32.25444629037266,0,0,0,0.0,0,0,0,0,0,0,0,AS Roma,4,Italy - Serie A
406,Mário Rui Silva Duarte,2368,1898.0,470,80.15202702702703,309,164,145,53.07443365695793,1350,1257,93,93.11111111111111,233,65,168,27.896995708154503,17.085333894271265,52,7,45,13.461538461538462,32,2,42,21,21,10,97,Empoli,36,Italy - Serie A
407,Nathaniel Chalobah,44,40.0,4,90.9090909090909,5,4,1,80.0,35,34,1,97.14285714285714,1,1,0,100.0,13.889966511927271,0,0,0,0.0,2,0,0,0,0,0,1,Napoli,5,Italy - Serie A
408,Nenad Krstičić,301,247.0,54,82.05980066445183,45,34,11,75.55555555555556,201,185,16,92.03980099502488,33,17,16,51.515151515151516,18.16673108662166,0,0,0,0.0,4,1,7,4,2,1,7,Sampdoria,10,Italy - Serie A
409,Nenad Tomović,1392,1203.0,189,86.42241379310344,153,91,62,59.47712418300654,970,942,28,97.11340206185567,104,38,66,36.53846153846153,17.388529962498104,10,2,8,20.0,9,0,10,5,3,0,17,Fiorentina,24,Italy - Serie A
410,Nicola Leali,981,536.0,445,54.638124362895,144,44,100,30.555555555555557,169,169,0,100.0,717,281,436,39.191073919107396,47.950049520788404,0,0,0,0.0,2,0,0,0,0,0,5,Frosinone,33,Italy - Serie A
411,Nicola Rigoni,989,792.0,197,80.0808897876643,151,99,52,65.56291390728477,608,554,54,91.11842105263158,76,30,46,39.473684210526315,17.536677173339694,5,0,5,0.0,7,1,17,8,6,2,16,Chievo,28,Italy - Serie A
412,Nicola Sansone,1026,752.0,274,73.2943469785575,92,48,44,52.17391304347826,741,625,116,84.34547908232119,77,14,63,18.181818181818183,15.18992848376421,45,10,35,22.22222222222222,43,4,98,47,69,36,68,Sassuolo,37,Italy - Serie A
413,Nicolas Sebastian Frey,756,552.0,204,73.01587301587301,134,68,66,50.74626865671642,328,311,17,94.8170731707317,131,44,87,33.587786259541986,20.806718322738096,15,4,11,26.666666666666668,4,0,1,1,1,1,8,Chievo,19,Italy - Serie A
414,Nicolás Andrés Burdisso,1080,880.0,200,81.48148148148148,91,30,61,32.967032967032964,497,477,20,95.97585513078471,170,87,83,51.17647058823529,24.292989989403335,1,0,1,0.0,2,0,2,2,0,0,15,Genoa,28,Italy - Serie A
415,Nicolás Federico Spolli,351,290.0,61,82.62108262108262,25,12,13,48.0,197,188,9,95.43147208121827,39,13,26,33.33333333333333,19.989590138947694,4,0,4,0.0,2,0,3,3,1,1,13,Chievo,14,Italy - Serie A
416,Nicolás Ignacio Castillo Mora,74,60.0,14,81.08108108108108,7,5,2,71.42857142857143,39,35,4,89.74358974358975,5,2,3,40.0,15.11812597496108,0,0,0,0.0,1,0,4,2,3,1,16,Frosinone,6,Italy - Serie A
417,Nicolò Cherubin,344,254.0,90,73.83720930232558,30,8,22,26.666666666666668,168,163,5,97.02380952380952,63,21,42,33.33333333333333,22.219492237832092,0,0,0,0.0,1,0,3,1,1,0,13,Atalanta,14,Italy - Serie A
418,Nigel de Jong,184,152.0,32,82.6086956521739,29,20,9,68.96551724137932,113,107,6,94.69026548672566,15,6,9,40.0,18.540183655663043,1,0,1,0.0,2,0,2,0,1,0,3,AC Milan,5,Italy - Serie A
419,Niklas Moisander,863,737.0,126,85.39976825028968,75,45,30,60.0,538,524,14,97.39776951672863,106,43,63,40.56603773584906,20.259647109846394,2,1,1,50.0,5,0,5,5,0,0,9,Sampdoria,22,Italy - Serie A
420,Nikola Kalinić,566,445.0,121,78.62190812720848,35,20,15,57.14285714285714,384,335,49,87.23958333333334,4,2,2,50.0,11.98314650542147,5,0,5,0.0,15,3,24,14,17,9,85,Fiorentina,36,Italy - Serie A
421,Nikola Maksimović,832,681.0,151,81.85096153846155,145,85,60,58.620689655172406,502,472,30,94.02390438247012,116,44,72,37.93103448275862,22.69156886709144,6,2,4,33.33333333333333,14,1,23,15,5,3,15,Torino,16,Italy - Serie A
422,Nikola Ninković,5,3.0,2,60.0,0,0,0,0.0,2,2,0,100.0,0,0,0,0.0,21.05726936112,1,0,1,0.0,0,0,1,0,0,0,0,Chievo,1,Italy - Serie A
423,Norbert Gyömbér,52,42.0,10,80.76923076923077,6,4,2,66.66666666666666,26,25,1,96.15384615384616,7,3,4,42.857142857142854,18.49953896302154,1,0,1,0.0,2,0,2,2,0,0,1,AS Roma,6,Italy - Serie A
424,Norbert Sándor Balogh,22,16.0,6,72.72727272727273,2,1,1,50.0,14,12,2,85.71428571428571,0,0,0,0.0,10.532564854887271,1,1,0,100.0,1,0,5,2,2,1,0,Palermo,4,Italy - Serie A
425,Norberto Murara Neto,49,47.0,2,95.91836734693877,0,0,0,0.0,26,26,0,100.0,9,7,2,77.77777777777779,27.078321034138778,0,0,0,0.0,0,0,0,0,0,0,0,Juventus,3,Italy - Serie A
426,Ogenyi Eddy Onazi,689,555.0,134,80.55152394775035,102,62,40,60.78431372549019,443,412,31,93.00225733634312,81,36,45,44.44444444444444,18.01657074514206,7,1,6,14.285714285714285,9,1,17,11,5,3,18,Lazio,15,Italy - Serie A
427,Oliver Kragl,293,175.0,118,59.72696245733788,52,24,28,46.15384615384615,126,104,22,82.53968253968253,52,16,36,30.76923076923077,19.15748047574662,27,7,20,25.925925925925924,11,0,20,8,15,6,23,Frosinone,15,Italy - Serie A
428,Omar El Kaddouri,171,146.0,25,85.38011695906432,23,18,5,78.26086956521739,129,116,13,89.92248062015504,6,3,3,50.0,13.620774481322105,5,3,2,60.0,7,2,9,4,4,2,9,Napoli,20,Italy - Serie A
429,Orestis Karnezis,1095,594.0,501,54.24657534246575,169,46,123,27.218934911242602,237,237,0,100.0,788,292,496,37.055837563451774,47.042389271904,0,0,0,0.0,0,0,0,0,0,0,5,Udinese,38,Italy - Serie A
430,Oscar Hiljemark,1311,968.0,343,73.83676582761251,108,70,38,64.81481481481481,777,694,83,89.31788931788932,151,52,99,34.437086092715234,16.832013907723937,57,14,43,24.561403508771928,36,5,34,19,19,11,17,Palermo,38,Italy - Serie A
431,Pablo Estífer Armero,176,121.0,55,68.75,27,16,11,59.25925925925925,69,60,9,86.95652173913044,28,8,20,28.57142857142857,18.64651678406182,11,4,7,36.36363636363637,2,0,4,2,0,0,6,Udinese,5,Italy - Serie A
432,Panagiotis Giorgios Kone,123,104.0,19,84.5528455284553,17,11,6,64.70588235294117,67,64,3,95.52238805970148,15,10,5,66.66666666666666,19.366267085239024,3,2,1,66.66666666666666,3,1,5,2,4,1,6,Udinese,6,Italy - Serie A
433,Panagiotis Tachtsidis,531,370.0,161,69.6798493408663,84,47,37,55.952380952380956,308,246,62,79.87012987012987,59,31,28,52.54237288135594,18.63487778792271,8,1,7,12.5,8,2,15,7,8,4,12,Genoa,24,Italy - Serie A
434,Paolo Cannavaro,1085,865.0,220,79.72350230414746,140,58,82,41.42857142857143,592,565,27,95.4391891891892,187,73,114,39.037433155080215,22.597457591588352,1,0,1,0.0,4,1,9,7,3,1,31,Sassuolo,31,Italy - Serie A
435,Paolo Sammarco,914,681.0,233,74.50765864332604,159,97,62,61.0062893081761,497,455,42,91.54929577464789,113,43,70,38.05309734513274,18.154761617193085,14,4,10,28.57142857142857,19,1,17,14,7,7,37,Frosinone,28,Italy - Serie A
436,Patrice Evra,1324,1093.0,231,82.55287009063444,119,76,43,63.86554621848739,819,759,60,92.67399267399267,73,25,48,34.24657534246575,15.426575487814077,46,10,36,21.73913043478261,24,3,20,7,9,3,16,Juventus,26,Italy - Serie A
437,Patricio Gabarrón Gil,454,372.0,82,81.93832599118943,34,16,18,47.05882352941176,256,234,22,91.40625,35,12,23,34.285714285714285,17.14707440139489,12,4,8,33.33333333333333,3,0,4,2,2,1,3,Lazio,9,Italy - Serie A
438,Paul Pogba,1786,1431.0,355,80.12318029115342,232,141,91,60.775862068965516,1179,1065,114,90.33078880407125,163,90,73,55.21472392638037,18.222500018420828,51,10,41,19.607843137254903,43,10,144,84,74,41,66,Juventus,35,Italy - Serie A
439,Paul-José M''Poku Ebunge,380,276.0,104,72.63157894736842,55,32,23,58.18181818181818,255,220,35,86.27450980392157,28,7,21,25.0,16.020950958528633,10,5,5,50.0,17,0,30,19,12,6,40,Chievo,20,Italy - Serie A
440,Paulo Bruno Exequiel Dybala,1230,927.0,303,75.36585365853658,128,97,31,75.78125,743,657,86,88.42530282637954,206,87,119,42.23300970873786,18.669196339521953,75,19,56,25.333333333333336,63,9,127,62,66,32,78,Juventus,34,Italy - Serie A
441,Paweł Wszołek,623,435.0,188,69.82343499197432,46,21,25,45.65217391304348,390,337,53,86.41025641025641,59,23,36,38.983050847457626,14.917840274270947,71,27,44,38.028169014084504,29,5,62,43,34,23,30,Hellas Verona,28,Italy - Serie A
442,Pedro Miguel Almeida Lopes Pereira,296,230.0,66,77.7027027027027,36,24,12,66.66666666666666,160,144,16,90.0,24,8,16,33.33333333333333,18.534316924763512,10,4,6,40.0,1,1,16,6,14,5,5,Sampdoria,9,Italy - Serie A
443,Perparim Hetemaj,1106,834.0,272,75.40687160940325,151,81,70,53.64238410596026,712,641,71,90.02808988764045,138,45,93,32.608695652173914,17.66691713018018,53,15,38,28.30188679245283,19,0,48,26,14,4,101,Chievo,28,Italy - Serie A
444,Philippe Mexès,227,192.0,35,84.58149779735683,41,25,16,60.97560975609756,128,125,3,97.65625,37,17,20,45.94594594594595,21.671734777847046,0,0,0,0.0,2,0,1,0,1,0,1,AC Milan,5,Italy - Serie A
445,Pierluigi Gollini,843,467.0,376,55.39739027283511,174,45,129,25.862068965517242,192,191,1,99.47916666666666,583,213,370,36.53516295025729,47.79646964050932,0,0,0,0.0,0,0,0,0,0,0,7,Hellas Verona,26,Italy - Serie A
446,Piotr Zieliński,1753,1407.0,346,80.2624073017684,220,142,78,64.54545454545455,1262,1125,137,89.14421553090332,134,60,74,44.776119402985074,15.311340073279405,32,13,19,40.625,48,4,122,74,53,29,35,Empoli,35,Italy - Serie A
447,Pontus Jansson,351,325.0,26,92.5925925925926,12,4,8,33.33333333333333,262,261,1,99.61832061068702,16,6,10,37.5,19.98919075455795,0,0,0,0.0,2,0,1,1,0,0,2,Torino,7,Italy - Serie A
448,Rade Krunić,168,128.0,40,76.19047619047619,11,6,5,54.54545454545454,115,96,19,83.47826086956522,5,3,2,60.0,12.332125577181428,1,1,0,100.0,6,0,12,5,7,2,26,Empoli,15,Italy - Serie A
449,Radja Nainggolan,1793,1505.0,288,83.93753485778026,254,185,69,72.83464566929135,1187,1100,87,92.67059814658803,162,103,59,63.580246913580254,18.429436526557012,27,10,17,37.03703703703704,41,1,40,24,14,7,57,AS Roma,35,Italy - Serie A
450,Rafael Márquez Álvarez,430,338.0,92,78.6046511627907,74,30,44,40.54054054054054,232,224,8,96.55172413793103,87,30,57,34.48275862068966,23.356628179042605,3,0,3,0.0,3,0,2,1,1,0,11,Hellas Verona,9,Italy - Serie A
451,Rafael Tolói,721,561.0,160,77.80859916782246,90,31,59,34.44444444444444,365,338,27,92.6027397260274,130,47,83,36.15384615384615,23.811746988598504,2,1,1,50.0,2,0,9,7,0,0,10,Atalanta,24,Italy - Serie A
452,Rafael de Andrade Bittencourt Pinheiro,313,189.0,124,60.383386581469644,13,1,12,7.6923076923076925,66,66,0,100.0,211,93,118,44.07582938388626,43.9104568485761,0,0,0,0.0,1,0,0,0,0,0,3,Hellas Verona,12,Italy - Serie A
453,Raffaele Bianco,859,647.0,212,75.32013969732246,126,65,61,51.587301587301596,466,420,46,90.12875536480686,112,52,60,46.42857142857143,19.488267446217275,16,5,11,31.25,14,2,30,16,15,8,32,Carpi,26,Italy - Serie A
454,Raffaele Maiello,378,309.0,69,81.74603174603175,70,42,28,60.0,261,237,24,90.80459770114942,39,18,21,46.15384615384615,17.493670621161904,2,1,1,50.0,7,0,4,2,2,2,25,Empoli,12,Italy - Serie A
455,Raphael Martinho Alves de Lima,233,156.0,77,66.95278969957081,38,19,19,50.0,125,108,17,86.4,33,4,29,12.121212121212121,18.981222069028327,7,1,6,14.285714285714285,4,0,20,9,9,6,4,Carpi,11,Italy - Serie A
456,Ravel Morrison,48,46.0,2,95.83333333333334,5,5,0,100.0,42,40,2,95.23809523809523,2,2,0,100.0,15.873915869580001,0,0,0,0.0,1,0,4,2,4,2,1,Lazio,4,Italy - Serie A
457,Raúl Albiol i Tortajada,2574,2281.0,293,88.61693861693861,213,119,94,55.86854460093896,1647,1623,24,98.54280510018215,231,125,106,54.112554112554115,19.286084821697344,2,1,1,50.0,4,1,5,5,0,0,22,Napoli,36,Italy - Serie A
458,Remo Freuler,159,125.0,34,78.61635220125787,16,8,8,50.0,110,99,11,90.0,9,5,4,55.55555555555556,13.828988700366791,6,4,2,66.66666666666666,2,0,3,1,0,0,5,Atalanta,6,Italy - Serie A
459,Rey Manaj,8,7.0,1,87.5,0,0,0,0.0,6,6,0,100.0,0,0,0,0.0,15.22997065125,0,0,0,0.0,1,0,0,0,0,0,3,Inter Milan,4,Italy - Serie A
460,Ricardo Gabriel Álvarez,415,329.0,86,79.27710843373494,52,36,16,69.23076923076923,279,254,25,91.0394265232975,61,23,38,37.704918032786885,18.269507866699954,24,8,16,33.33333333333333,14,1,44,28,29,18,23,Sampdoria,13,Italy - Serie A
461,Ricardo Kishna,254,153.0,101,60.23622047244095,35,12,23,34.285714285714285,125,98,27,78.4,51,14,37,27.450980392156865,18.55450086912,26,3,23,11.538461538461538,11,0,17,7,11,5,4,Lazio,11,Italy - Serie A
462,Riccardo Fiamozzi,220,173.0,47,78.63636363636364,27,19,8,70.37037037037037,116,101,15,87.06896551724138,21,8,13,38.095238095238095,16.83449037182291,8,3,5,37.5,4,0,4,1,2,0,4,Genoa,8,Italy - Serie A
463,Riccardo Gagliolo,1133,770.0,363,67.96116504854369,243,101,142,41.56378600823045,540,482,58,89.25925925925927,221,60,161,27.149321266968325,21.335825426136275,10,2,8,20.0,10,0,22,14,9,4,72,Carpi,31,Italy - Serie A
464,Riccardo Meggiorini,446,268.0,178,60.0896860986547,53,19,34,35.84905660377358,191,156,35,81.67539267015707,24,9,15,37.5,13.70472022329062,31,13,18,41.935483870967744,17,6,32,12,23,10,63,Chievo,26,Italy - Serie A
465,Riccardo Montolivo,1984,1607.0,377,80.99798387096774,336,190,146,56.547619047619044,1152,1087,65,94.35763888888889,297,144,153,48.484848484848484,21.309485394736814,10,2,8,20.0,18,1,31,20,9,6,45,AC Milan,31,Italy - Serie A
466,Riccardo Saponara,1202,875.0,327,72.79534109816971,176,109,67,61.93181818181818,855,699,156,81.75438596491227,77,37,40,48.05194805194805,15.08576949839441,30,7,23,23.333333333333332,62,10,120,63,57,26,81,Empoli,33,Italy - Serie A
467,Robert Acquafresca,51,37.0,14,72.54901960784314,3,0,3,0.0,35,28,7,80.0,1,1,0,100.0,10.34369316755294,1,0,1,0.0,1,0,6,4,3,2,2,Bologna,6,Italy - Serie A
468,Robert Gucher,612,426.0,186,69.6078431372549,149,73,76,48.99328859060403,280,258,22,92.14285714285714,156,55,101,35.256410256410255,22.46877618593647,12,1,11,8.333333333333332,21,0,20,13,8,3,23,Frosinone,24,Italy - Serie A
469,Roberto Crivello,628,473.0,155,75.31847133757962,81,44,37,54.32098765432099,252,220,32,87.3015873015873,89,30,59,33.70786516853933,19.196297281149935,13,6,7,46.15384615384615,11,1,13,6,7,3,15,Frosinone,17,Italy - Serie A
470,Roberto Gagliardini,36,28.0,8,77.77777777777779,4,2,2,50.0,27,25,2,92.5925925925926,0,0,0,0.0,14.338208336480001,1,0,1,0.0,0,0,0,0,0,0,0,Atalanta,1,Italy - Serie A
471,Roberto Inglese,307,207.0,100,67.42671009771986,28,14,14,50.0,159,136,23,85.53459119496856,12,7,5,58.333333333333336,13.259067610329382,10,2,8,20.0,11,1,23,14,11,6,40,Chievo,26,Italy - Serie A
472,Roberto Maximiliano Pereyra,442,390.0,52,88.23529411764706,34,28,6,82.35294117647058,317,298,19,94.00630914826499,18,14,4,77.77777777777779,15.917353223862625,16,5,11,31.25,26,1,21,8,16,5,22,Juventus,13,Italy - Serie A
473,Roberto Soriano,1354,1127.0,227,83.23485967503693,155,110,45,70.96774193548387,1040,923,117,88.75,34,20,14,58.82352941176471,14.472932883645376,17,6,11,35.294117647058826,23,4,59,32,27,15,52,Sampdoria,37,Italy - Serie A
474,Roberto Vitiello,301,247.0,54,82.05980066445183,29,13,16,44.827586206896555,163,151,12,92.63803680981594,38,21,17,55.26315789473685,19.488322861396146,2,0,2,0.0,1,0,0,0,0,0,4,Palermo,10,Italy - Serie A
475,Robin Quaison,563,400.0,163,71.04795737122558,61,29,32,47.540983606557376,338,290,48,85.79881656804734,58,19,39,32.758620689655174,16.87132093537816,36,11,25,30.555555555555557,21,2,44,29,36,23,24,Palermo,30,Italy - Serie A
476,Rodrigo Ely,60,43.0,17,71.66666666666667,10,3,7,30.0,32,27,5,84.375,12,4,8,33.33333333333333,22.452040292172,0,0,0,0.0,0,0,1,1,0,0,0,AC Milan,3,Italy - Serie A
477,Rodrigo Sebastián Aguirre Soto,68,41.0,27,60.29411764705882,5,3,2,60.0,44,36,8,81.81818181818183,7,2,5,28.57142857142857,15.76902018402,9,3,6,33.33333333333333,4,1,8,5,7,4,12,Udinese,10,Italy - Serie A
478,Rodrigo Sebastián Palacio,581,430.0,151,74.01032702237521,42,23,19,54.761904761904766,384,334,50,86.97916666666666,37,9,28,24.324324324324326,15.53591440534802,52,17,35,32.69230769230769,25,4,41,24,19,10,56,Inter Milan,27,Italy - Serie A
479,Ronaldo Pompeu da Silva,123,102.0,21,82.92682926829268,25,19,6,76.0,84,74,10,88.09523809523809,15,7,8,46.666666666666664,20.288363227996097,0,0,0,0.0,1,0,3,2,3,2,10,Empoli,3,Italy - Serie A
480,Ryder Matos Santos,499,375.0,124,75.1503006012024,35,19,16,54.285714285714285,372,321,51,86.29032258064517,17,3,14,17.647058823529413,12.77564573252056,28,9,19,32.142857142857146,23,2,37,24,29,17,45,Udinese,26,Italy - Serie A
481,Rômulo Souza Orestes Caldeira,162,127.0,35,78.39506172839506,8,4,4,50.0,110,101,9,91.81818181818183,12,5,7,41.66666666666667,14.552194502924443,7,2,5,28.57142857142857,5,1,7,3,2,1,4,Hellas Verona,9,Italy - Serie A
482,Salih Uçan,23,20.0,3,86.95652173913044,1,1,0,100.0,17,15,2,88.23529411764706,1,1,0,100.0,15.615407057822608,1,1,0,100.0,0,1,1,1,1,1,1,AS Roma,3,Italy - Serie A
483,Salvador Ichazo Fernández,98,59.0,39,60.204081632653065,1,1,0,100.0,32,31,1,96.875,47,12,35,25.53191489361702,36.601266728791835,0,0,0,0.0,0,0,0,0,0,0,0,Torino,3,Italy - Serie A
484,Sami Khedira,816,688.0,128,84.31372549019608,81,65,16,80.24691358024691,587,537,50,91.48211243611584,44,22,22,50.0,15.826381648769118,19,8,11,42.10526315789473,8,3,20,13,8,4,19,Juventus,20,Italy - Serie A
485,Samir Caetano de Souza Santos,85,66.0,19,77.64705882352942,10,0,10,0.0,50,49,1,98.0,13,1,12,7.6923076923076925,23.140346535004237,0,0,0,0.0,0,0,0,0,0,0,2,Hellas Verona,3,Italy - Serie A
486,Samir Handanovič,984,738.0,246,75.0,31,8,23,25.806451612903224,427,426,1,99.76580796252928,440,200,240,45.45454545454545,35.03727301296878,0,0,0,0.0,0,0,1,0,0,0,5,Inter Milan,36,Italy - Serie A
487,Samuel Souprayen,961,738.0,223,76.79500520291363,126,65,61,51.587301587301596,517,471,46,91.10251450676982,113,35,78,30.973451327433626,17.47107897096849,37,10,27,27.027027027027028,14,0,18,13,11,7,23,Hellas Verona,20,Italy - Serie A
488,Samuele Longo,58,36.0,22,62.06896551724138,10,5,5,50.0,33,25,8,75.75757575757575,3,1,2,33.33333333333333,13.454708667591724,2,0,2,0.0,3,1,6,4,4,3,3,Frosinone,18,Italy - Serie A
489,Sanjin Prcić,18,14.0,4,77.77777777777779,5,2,3,40.0,6,6,0,100.0,4,4,0,100.0,21.6192926516,0,0,0,0.0,2,0,1,1,0,0,0,Torino,2,Italy - Serie A
490,Santiago Juan Gentiletti Selak,1129,961.0,168,85.11957484499557,81,46,35,56.79012345679012,694,665,29,95.82132564841498,142,73,69,51.40845070422535,20.679604123223385,0,0,0,0.0,0,0,11,7,0,0,9,Lazio,19,Italy - Serie A
491,Saphir Sliti Taïder,1086,905.0,181,83.33333333333334,111,74,37,66.66666666666666,769,714,55,92.8478543563069,70,30,40,42.857142857142854,16.64645094331094,17,3,14,17.647058823529413,18,1,20,9,6,1,62,Bologna,29,Italy - Serie A
492,Sebastian De Maio,1098,878.0,220,79.96357012750455,129,64,65,49.6124031007752,652,623,29,95.5521472392638,128,41,87,32.03125,19.68898586518623,6,2,4,33.33333333333333,1,1,10,7,5,3,12,Genoa,28,Italy - Serie A
493,Segundo Víctor Ibarbo Guerrero,3,1.0,2,33.33333333333333,1,0,1,0.0,1,0,1,0.0,0,0,0,0.0,16.6172881776,0,0,0,0.0,0,0,0,0,0,0,1,AS Roma,2,Italy - Serie A
494,Senad Lulić,1546,1171.0,375,75.74385510996119,186,96,90,51.61290322580645,841,731,110,86.92033293697978,201,86,115,42.78606965174129,19.334423235685694,70,17,53,24.285714285714285,33,3,74,37,28,13,22,Lazio,30,Italy - Serie A
495,Serge Gakpé,218,153.0,65,70.18348623853211,25,15,10,60.0,142,115,27,80.98591549295774,15,5,10,33.33333333333333,14.63176724653321,11,6,5,54.54545454545454,10,1,25,9,19,7,11,Atalanta,18,Italy - Serie A
496,Sergej Milinković-Savić,826,574.0,252,69.49152542372882,111,50,61,45.04504504504504,480,406,74,84.58333333333333,62,22,40,35.483870967741936,15.616570989395942,31,7,24,22.58064516129032,19,0,47,23,31,12,41,Lazio,25,Italy - Serie A
497,Sergio Floccari,452,343.0,109,75.88495575221239,31,18,13,58.06451612903226,285,256,29,89.82456140350877,16,8,8,50.0,13.774380370414248,8,3,5,37.5,13,1,42,27,24,14,38,Bologna,25,Italy - Serie A
498,Sergio Pellissier,194,141.0,53,72.68041237113401,20,11,9,55.00000000000001,127,107,20,84.25196850393701,7,3,4,42.857142857142854,13.106784675039588,7,2,5,28.57142857142857,13,0,2,0,2,0,24,Chievo,19,Italy - Serie A
499,Seydou Kéita,800,690.0,110,86.25,133,88,45,66.16541353383458,536,513,23,95.7089552238806,55,21,34,38.18181818181819,17.955911762844302,1,0,1,0.0,5,0,8,6,3,2,30,AS Roma,20,Italy - Serie A
500,Silvan Widmer,905,589.0,316,65.0828729281768,99,56,43,56.56565656565656,374,310,64,82.88770053475936,125,46,79,36.8,18.194549705240224,71,15,56,21.12676056338028,15,2,37,18,29,14,30,Udinese,27,Italy - Serie A
501,Simone Colombi,46,22.0,24,47.82608695652174,4,1,3,25.0,11,11,0,100.0,32,8,24,25.0,45.42021430786957,0,0,0,0.0,0,0,0,0,0,0,0,Carpi,2,Italy - Serie A
502,Simone Edera,1,1.0,0,100.0,0,0,0,0.0,1,1,0,100.0,0,0,0,0.0,18.5136089976,0,0,0,0.0,0,0,0,0,0,0,2,Torino,2,Italy - Serie A
503,Simone Missiroli,992,743.0,249,74.8991935483871,152,82,70,53.94736842105263,565,506,59,89.5575221238938,79,30,49,37.9746835443038,16.90976381657153,10,3,7,30.0,16,0,27,13,2,1,48,Sassuolo,24,Italy - Serie A
504,Simone Padoin,292,254.0,38,86.98630136986301,25,21,4,84.0,194,185,9,95.36082474226805,19,11,8,57.89473684210527,16.53946669901096,9,4,5,44.44444444444444,5,0,2,1,1,0,10,Juventus,12,Italy - Serie A
505,Simone Pepe,509,357.0,152,70.13752455795678,53,32,21,60.37735849056604,261,230,31,88.12260536398468,84,28,56,33.33333333333333,18.620349459680156,30,9,21,30.0,19,3,13,4,6,3,13,Chievo,22,Italy - Serie A
506,Simone Romagnoli,781,547.0,234,70.03841229193341,91,30,61,32.967032967032964,329,308,21,93.61702127659575,129,41,88,31.782945736434108,21.057012166040664,2,1,1,50.0,2,0,1,1,0,0,2,Carpi,30,Italy - Serie A
507,Simone Verdi,107,67.0,40,62.616822429906534,19,7,12,36.84210526315789,46,35,11,76.08695652173914,27,14,13,51.85185185185185,23.02830700381009,7,2,5,28.57142857142857,5,0,16,10,10,4,8,Carpi,8,Italy - Serie A
508,Simone Zaza,171,129.0,42,75.43859649122807,10,5,5,50.0,113,94,19,83.1858407079646,4,2,2,50.0,14.06377248547579,3,1,2,33.33333333333333,6,0,20,8,16,5,11,Juventus,19,Italy - Serie A
509,Siniša Anđelković,591,462.0,129,78.1725888324873,47,20,27,42.5531914893617,300,285,15,95.0,61,17,44,27.86885245901639,19.711135430826396,1,0,1,0.0,2,1,2,1,1,0,21,Palermo,23,Italy - Serie A
510,Stefan de Vrij,113,98.0,15,86.72566371681415,8,6,2,75.0,70,69,1,98.57142857142858,12,7,5,58.333333333333336,21.74817995162124,0,0,0,0.0,0,0,1,1,0,0,1,Lazio,2,Italy - Serie A
511,Stefano Mauri,203,146.0,57,71.92118226600985,32,14,18,43.75,112,96,16,85.71428571428571,22,6,16,27.27272727272727,16.397625351731232,6,1,5,16.666666666666664,4,1,5,2,2,1,14,Lazio,12,Italy - Serie A
512,Stefano Sabelli,211,116.0,95,54.976303317535546,45,21,24,46.666666666666664,65,48,17,73.84615384615385,38,11,27,28.947368421052634,20.953240070498957,13,1,12,7.6923076923076925,5,0,2,0,1,0,9,Carpi,7,Italy - Serie A
513,Stefano Sorrentino,1068,603.0,465,56.46067415730337,107,22,85,20.5607476635514,208,206,2,99.03846153846155,771,315,456,40.856031128404666,43.97120710850966,0,0,0,0.0,1,0,1,1,0,0,2,Palermo,35,Italy - Serie A
514,Stefano Sturaro,502,373.0,129,74.30278884462152,45,27,18,60.0,333,290,43,87.08708708708708,37,10,27,27.027027027027028,16.789611019334345,18,5,13,27.77777777777778,12,0,15,6,8,4,25,Juventus,19,Italy - Serie A
515,Stephan El Shaarawy,536,426.0,110,79.47761194029852,43,29,14,67.44186046511628,382,344,38,90.0523560209424,23,10,13,43.47826086956522,13.29246607860806,13,3,10,23.076923076923077,11,2,31,14,20,10,11,AS Roma,16,Italy - Serie A
516,Stephan Lichtsteiner,1067,806.0,261,75.53889409559513,132,78,54,59.09090909090909,538,472,66,87.73234200743495,106,37,69,34.90566037735849,16.787853230478277,43,11,32,25.581395348837212,17,1,22,9,14,7,22,Juventus,26,Italy - Serie A
517,Stevan Jovetić,892,640.0,252,71.74887892376681,91,56,35,61.53846153846154,538,449,89,83.45724907063197,54,23,31,42.592592592592595,14.041940550827086,30,3,27,10.0,30,2,64,31,49,23,58,Inter Milan,26,Italy - Serie A
518,Stipe Perica,91,61.0,30,67.03296703296702,9,3,6,33.33333333333333,55,48,7,87.27272727272727,0,0,0,0.0,11.150032507840878,0,0,0,0.0,3,0,20,10,17,8,11,Udinese,11,Italy - Serie A
519,Thiago Rangel Cionek,144,117.0,27,81.25,16,6,10,37.5,69,68,1,98.55072463768117,27,11,16,40.74074074074074,20.642006458475,0,0,0,0.0,0,0,2,2,0,0,8,Palermo,5,Italy - Serie A
520,Thomas Heurtaux,389,304.0,85,78.1491002570694,57,28,29,49.122807017543856,242,235,7,97.10743801652893,60,15,45,25.0,20.16140985963393,2,0,2,0.0,1,0,5,2,0,0,14,Udinese,15,Italy - Serie A
521,Tim Matavž,105,63.0,42,60.0,17,4,13,23.52941176470588,50,40,10,80.0,6,1,5,16.666666666666664,13.57169144896457,2,1,1,50.0,4,0,3,3,1,1,4,Genoa,7,Italy - Serie A
522,Tomás Eduardo Rincón Hernández,1712,1453.0,259,84.8714953271028,219,161,58,73.51598173515981,1225,1142,83,93.22448979591836,117,66,51,56.41025641025641,17.614496398892467,27,14,13,51.85185185185185,32,6,72,50,25,20,63,Genoa,33,Italy - Serie A
523,Umar Sadiq Mesbah,46,31.0,15,67.3913043478261,5,0,5,0.0,30,26,4,86.66666666666667,2,0,2,0.0,12.809655901768696,1,0,1,0.0,1,0,3,2,2,1,8,AS Roma,6,Italy - Serie A
524,Urby Emanuelson,366,293.0,73,80.05464480874316,39,27,12,69.23076923076923,225,209,16,92.88888888888889,44,19,25,43.18181818181818,18.41751130682754,18,4,14,22.22222222222222,10,1,15,3,9,1,14,Hellas Verona,11,Italy - Serie A
525,Uroš Ćosić,560,464.0,96,82.85714285714286,55,26,29,47.27272727272727,368,358,10,97.28260869565217,73,30,43,41.0958904109589,19.85867257157357,0,0,0,0.0,2,0,1,1,0,0,7,Empoli,9,Italy - Serie A
526,Uroš Đurđević,87,66.0,21,75.86206896551724,4,2,2,50.0,58,48,10,82.75862068965517,3,2,1,66.66666666666666,11.850292695012413,2,0,2,0.0,3,1,9,4,4,1,6,Palermo,14,Italy - Serie A
527,Valter Birsa,1082,719.0,363,66.45101663585952,149,93,56,62.41610738255034,591,499,92,84.4331641285956,184,61,123,33.15217391304348,18.25059342994403,65,20,45,30.76923076923077,52,7,84,49,44,24,38,Chievo,35,Italy - Serie A
528,Vangelis Moras,1176,956.0,220,81.29251700680273,135,73,62,54.074074074074076,644,611,33,94.87577639751554,150,58,92,38.666666666666664,21.164294609635103,4,1,3,25.0,5,1,9,8,1,1,35,Hellas Verona,31,Italy - Serie A
529,Vasco Regini,609,502.0,107,82.43021346469622,51,34,17,66.66666666666666,402,371,31,92.28855721393035,27,11,16,40.74074074074074,15.694732680786208,4,0,4,0.0,1,0,12,5,5,1,15,Sampdoria,15,Italy - Serie A
530,Vassilis Torosidis,370,303.0,67,81.89189189189189,32,18,14,56.25,197,188,9,95.43147208121827,29,10,19,34.48275862068966,16.86956379760411,7,3,4,42.857142857142854,4,0,4,2,2,1,13,AS Roma,11,Italy - Serie A
531,Vasyl Pryyma,99,72.0,27,72.72727272727273,12,5,7,41.66666666666667,43,40,3,93.02325581395348,17,7,10,41.17647058823529,20.69291140509818,0,0,0,0.0,0,0,1,1,0,0,7,Frosinone,5,Italy - Serie A
532,Vid Belec,853,360.0,493,42.20398593200469,151,25,126,16.55629139072848,120,119,1,99.16666666666667,673,183,490,27.191679049034175,48.37508920851573,0,0,0,0.0,0,0,1,1,0,0,5,Carpi,30,Italy - Serie A
533,Vincent Laurini,1132,951.0,181,84.01060070671377,117,73,44,62.39316239316239,625,583,42,93.28,87,32,55,36.7816091954023,16.07180237185866,11,1,10,9.090909090909092,5,0,16,9,10,6,32,Empoli,25,Italy - Serie A
534,Vlad Iulian Chiricheș,501,465.0,36,92.81437125748504,25,13,12,52.0,370,361,9,97.56756756756756,25,12,13,48.0,17.3817123775703,0,0,0,0.0,0,0,5,3,0,0,3,Napoli,8,Italy - Serie A
535,Wallace Oliveira dos Santos,85,62.0,23,72.94117647058823,14,11,3,78.57142857142857,44,36,8,81.81818181818183,15,6,9,40.0,19.855274510710586,3,1,2,33.33333333333333,3,1,9,7,5,4,3,Carpi,6,Italy - Serie A
536,Wesley Hoedt,1080,901.0,179,83.42592592592592,123,57,66,46.34146341463415,547,536,11,97.9890310786106,189,87,102,46.03174603174603,24.774817633992665,1,0,1,0.0,0,0,9,7,2,1,11,Lazio,25,Italy - Serie A
537,William Vainqueur,386,358.0,28,92.74611398963731,29,20,9,68.96551724137932,274,266,8,97.08029197080292,17,10,7,58.82352941176471,17.373380658655336,2,1,1,50.0,3,2,14,11,4,2,5,AS Roma,16,Italy - Serie A
538,Wojciech Szczęsny,1242,892.0,350,71.81964573268921,68,14,54,20.588235294117645,516,512,4,99.2248062015504,541,207,334,38.262476894639555,35.590689233346666,0,0,0,0.0,1,0,2,2,0,0,2,AS Roma,34,Italy - Serie A
539,Yussif Raman Chibsah,436,332.0,104,76.14678899082568,79,40,39,50.63291139240506,290,253,37,87.24137931034483,30,8,22,26.666666666666668,17.792645188025723,3,0,3,0.0,13,2,29,16,10,4,27,Frosinone,22,Italy - Serie A
540,Yuto Nagatomo,1044,823.0,221,78.83141762452107,89,60,29,67.41573033707866,585,546,39,93.33333333333333,105,32,73,30.476190476190478,15.7631903684,57,11,46,19.298245614035086,12,0,20,8,9,2,21,Inter Milan,22,Italy - Serie A
541,Zdravko Kuzmanović,578,475.0,103,82.17993079584775,84,60,24,71.42857142857143,362,340,22,93.92265193370166,68,39,29,57.35294117647059,19.35591278393149,9,2,7,22.22222222222222,8,0,11,6,1,0,12,Udinese,16,Italy - Serie A
542,Álvaro Borja Morata Martín,518,388.0,130,74.9034749034749,19,13,6,68.42105263157895,341,294,47,86.21700879765396,22,13,9,59.09090909090909,14.029390764810486,24,7,17,29.166666666666668,20,6,57,23,32,15,60,Juventus,34,Italy - Serie A
543,Édgar Osvaldo Barreto Cáceres,1025,843.0,182,82.24390243902438,147,82,65,55.78231292517006,668,621,47,92.96407185628742,99,42,57,42.42424242424242,17.687121397535766,11,3,8,27.27272727272727,12,1,10,4,3,1,26,Sampdoria,30,Italy - Serie A
544,Łukasz Skorupski,886,651.0,235,73.47629796839729,27,5,22,18.51851851851852,400,399,1,99.75,318,94,224,29.559748427672954,33.35531054961779,0,0,0,0.0,0,0,0,0,0,0,7,Empoli,31,Italy - Serie A
545,Ştefan Daniel Radu,761,627.0,134,82.3915900131406,119,84,35,70.58823529411765,460,434,26,94.34782608695652,58,24,34,41.37931034482759,17.40386810039653,18,5,13,27.77777777777778,14,1,16,11,7,3,12,Lazio,13,Italy - Serie A
546,Šime Vrsaljko,2055,1525.0,530,74.20924574209245,208,128,80,61.53846153846154,956,876,80,91.63179916317992,253,78,175,30.8300395256917,17.582792910514335,162,47,115,29.01234567901235,35,3,38,24,19,13,56,Sassuolo,35,Italy - Serie A
547,Željko Brkić,87,45.0,42,51.724137931034484,6,1,5,16.666666666666664,25,25,0,100.0,59,17,42,28.8135593220339,42.927690518896554,0,0,0,0.0,0,0,0,0,0,0,1,Carpi,4,Italy - Serie A
0,Aaron Cresswell,1874,1402.0,472,74.81323372465314,318,173,145,54.40251572327044,882,797,85,90.36281179138322,287,111,176,38.67595818815331,20.253735302741173,93,28,65,30.107526881720432,41,4,34,16,23,9,35,West Ham United,37,England - Premier League
1,Aaron Lennon,516,402.0,114,77.90697674418605,49,33,16,67.3469387755102,370,316,54,85.4054054054054,18,6,12,33.33333333333333,14.838133792493023,26,8,18,30.76923076923077,21,0,39,19,29,15,26,Everton,25,England - Premier League
2,Aaron Ramsey,2197,1855.0,342,84.43331816112881,285,203,82,71.2280701754386,1590,1460,130,91.82389937106919,123,56,67,45.52845528455284,16.78014398320681,35,11,24,31.428571428571427,34,4,68,41,28,18,57,Arsenal,31,England - Premier League
3,Abdul Rahman Baba,651,524.0,127,80.4915514592934,48,32,16,66.66666666666666,402,366,36,91.04477611940298,33,10,23,30.303030303030305,15.429506533826542,23,5,18,21.73913043478261,2,1,13,9,7,6,6,Chelsea,15,England - Premier League
4,Adam David Lallana,1046,817.0,229,78.10707456978967,87,56,31,64.36781609195403,722,632,90,87.53462603878116,59,19,40,32.20338983050847,13.908006121696657,43,8,35,18.6046511627907,44,7,73,43,36,18,36,Liverpool,30,England - Premier League
5,Adam Federici,130,97.0,33,74.61538461538461,4,0,4,0.0,52,52,0,100.0,64,32,32,50.0,36.738468619709536,0,0,0,0.0,0,0,0,0,0,0,0,AFC Bournemouth,6,England - Premier League
6,Adam Johnson,600,443.0,157,73.83333333333333,128,78,50,60.9375,321,282,39,87.85046728971963,136,63,73,46.32352941176471,22.8431581993428,22,8,14,36.36363636363637,25,5,24,14,8,4,16,Sunderland,19,England - Premier League
7,Adam Matthews,19,16.0,3,84.21052631578947,3,3,0,100.0,7,6,1,85.71428571428571,4,4,0,100.0,24.076071499111578,1,1,0,100.0,0,0,2,0,1,0,0,Sunderland,1,England - Premier League
8,Adam Smith,1274,1045.0,229,82.02511773940346,98,62,36,63.26530612244898,698,651,47,93.26647564469914,88,40,48,45.45454545454545,15.64634026459102,43,12,31,27.906976744186046,14,0,56,35,22,10,55,AFC Bournemouth,31,England - Premier League
9,Adama Traoré Diarra,53,27.0,26,50.943396226415096,5,2,3,40.0,28,19,9,67.85714285714286,7,2,5,28.57142857142857,19.95387583109434,17,2,15,11.76470588235294,0,1,34,21,18,9,13,Aston Villa,10,England - Premier League
10,Adlène Guédioura,298,187.0,111,62.751677852349,54,21,33,38.88888888888889,139,120,19,86.33093525179856,65,18,47,27.692307692307693,20.678082134470067,19,1,18,5.263157894736842,10,2,25,15,10,6,7,Watford,15,England - Premier League
11,Adnan Januzaj,45,36.0,9,80.0,6,3,3,50.0,31,24,7,77.41935483870968,5,5,0,100.0,16.964883812608,0,0,0,0.0,0,0,10,5,8,3,6,Manchester United,5,England - Premier League
12,Adrian Mariappa,131,105.0,26,80.1526717557252,9,4,5,44.44444444444444,73,67,6,91.78082191780823,20,10,10,50.0,20.054296646596033,2,1,1,50.0,0,0,3,2,0,0,3,Crystal Palace,3,England - Premier League
13,Adrián San Miguel del Castillo,998,556.0,442,55.71142284569138,158,41,117,25.949367088607595,197,196,1,99.49238578680203,671,238,433,35.46944858420268,46.75985395913219,0,0,0,0.0,0,0,1,1,0,0,2,West Ham United,32,England - Premier League
14,Alan Hutton,1232,876.0,356,71.1038961038961,166,79,87,47.59036144578313,538,492,46,91.44981412639405,164,63,101,38.41463414634146,18.55826022327779,87,21,66,24.137931034482758,23,1,24,11,11,4,38,Aston Villa,28,England - Premier League
15,Alberto Moreno Pérez,1743,1364.0,379,78.25588066551921,179,108,71,60.33519553072626,857,801,56,93.46557759626604,223,95,128,42.600896860986545,18.800825500148985,107,31,76,28.971962616822427,54,4,44,23,25,13,23,Liverpool,32,England - Premier League
16,Alberto Paloschi,202,145.0,57,71.78217821782178,19,8,11,42.10526315789473,109,91,18,83.4862385321101,10,4,6,40.0,13.194933903563168,5,2,3,40.0,5,0,9,1,6,0,8,Swansea City,10,England - Premier League
17,Aleksandar Kolarov,1774,1339.0,435,75.47914317925591,213,123,90,57.74647887323944,1012,899,113,88.83399209486166,234,74,160,31.62393162393162,18.883090808809165,91,23,68,25.274725274725274,35,3,43,21,26,7,32,Manchester City,29,England - Premier League
18,Aleksandar Mitrović,714,519.0,195,72.68907563025209,49,20,29,40.816326530612244,368,318,50,86.41304347826086,13,6,7,46.15384615384615,11.686442666632233,6,1,5,16.666666666666664,22,4,35,18,26,13,59,Newcastle United,34,England - Premier League
19,Alessandro Diamanti,55,36.0,19,65.45454545454545,7,5,2,71.42857142857143,26,20,6,76.92307692307693,11,7,4,63.63636363636363,21.167270567214544,5,0,5,0.0,1,0,2,2,0,0,2,Watford,3,England - Premier League
20,Alex Iwobi,376,315.0,61,83.77659574468085,31,25,6,80.64516129032258,295,267,28,90.5084745762712,12,5,7,41.66666666666667,14.900225703815106,8,1,7,12.5,10,2,19,12,10,5,5,Arsenal,12,England - Premier League
21,Alex McCarthy,220,98.0,122,44.54545454545455,67,23,44,34.32835820895522,20,19,1,95.0,182,65,117,35.714285714285715,54.831251441487275,0,0,0,0.0,0,0,0,0,0,0,1,Crystal Palace,7,England - Premier League
22,Alex Oxlade-Chamberlain,495,378.0,117,76.36363636363637,48,33,15,68.75,299,262,37,87.62541806020067,43,23,20,53.48837209302325,17.941027139371634,31,9,22,29.03225806451613,17,0,50,36,25,17,16,Arsenal,22,England - Premier League
23,Alex Pritchard,32,24.0,8,75.0,4,3,1,75.0,17,16,1,94.11764705882352,1,0,1,0.0,13.962061811025,0,0,0,0.0,0,0,6,3,2,1,2,West Bromwich Albion,3,England - Premier League
24,Alexander Banor Tettey,1097,920.0,177,83.86508659981769,120,68,52,56.666666666666664,674,624,50,92.58160237388724,69,33,36,47.82608695652174,17.432891082853892,1,0,1,0.0,6,0,24,19,5,5,11,Norwich City,23,England - Premier League
25,Alexandre Dimitri Song-Billong,463,386.0,77,83.36933045356372,67,48,19,71.64179104477611,311,280,31,90.03215434083602,27,12,15,44.44444444444444,17.620280847716113,3,1,2,33.33333333333333,8,0,14,10,3,3,11,West Ham United,12,England - Premier League
26,Alexandre Rodrigues da Silva,26,23.0,3,88.46153846153845,2,2,0,100.0,18,18,0,100.0,1,1,0,100.0,15.714094287932308,0,0,0,0.0,0,0,2,0,1,0,4,Chelsea,2,England - Premier League
27,Alexis Alejandro Sánchez Sánchez,1488,1141.0,347,76.68010752688173,143,93,50,65.03496503496503,975,823,152,84.41025641025641,134,78,56,58.2089552238806,16.53709249964661,55,22,33,40.0,53,4,165,103,96,59,79,Arsenal,30,England - Premier League
28,Allan Romeo Nyom,1228,803.0,425,65.39087947882736,191,74,117,38.7434554973822,453,421,32,92.93598233995584,241,60,181,24.896265560165975,19.727895733777817,58,9,49,15.517241379310345,7,1,36,22,15,7,28,Watford,32,England - Premier League
29,Almen Abdi,1020,814.0,206,79.80392156862746,84,51,33,60.71428571428571,620,567,53,91.45161290322581,90,37,53,41.11111111111111,15.748118041001648,25,11,14,44.0,30,0,21,15,10,8,27,Watford,32,England - Premier League
30,Aly Cissokho,934,657.0,277,70.34261241970022,95,46,49,48.421052631578945,428,384,44,89.7196261682243,130,39,91,30.0,17.963633235716404,65,15,50,23.076923076923077,9,0,11,6,2,2,6,Aston Villa,18,England - Premier League
31,Ander Herrera Agüera,1122,919.0,203,81.90730837789661,122,79,43,64.75409836065575,757,692,65,91.41347424042272,66,25,41,37.878787878787875,16.42544690096214,22,8,14,36.36363636363637,20,2,35,21,15,10,29,Manchester United,27,England - Premier League
32,Andre Green,32,19.0,13,59.375,2,1,1,50.0,20,13,7,65.0,7,3,4,42.857142857142854,19.069760742165,6,2,4,33.33333333333333,2,0,6,3,2,1,0,Aston Villa,2,England - Premier League
33,Andre Wisdom,447,319.0,128,71.36465324384787,63,36,27,57.14285714285714,215,189,26,87.90697674418605,38,12,26,31.57894736842105,17.080137847504428,14,4,10,28.57142857142857,5,0,7,5,3,3,5,Norwich City,10,England - Premier League
34,Andreas Hoelgebaum Pereira,65,48.0,17,73.84615384615385,10,6,4,60.0,37,34,3,91.8918918918919,11,3,8,27.27272727272727,19.724244830363077,4,0,4,0.0,3,0,4,3,2,2,2,Manchester United,4,England - Premier League
35,Andrej Kramarić,15,11.0,4,73.33333333333333,0,0,0,0.0,11,9,2,81.81818181818183,0,0,0,0.0,13.259909587824,1,0,1,0.0,1,1,0,0,0,0,0,Leicester City,2,England - Premier League
36,Andrew Philip King,488,375.0,113,76.84426229508196,78,44,34,56.41025641025641,255,231,24,90.58823529411765,47,23,24,48.93617021276596,17.215867177477378,7,1,6,14.285714285714285,8,1,10,5,5,2,9,Leicester City,25,England - Premier League
37,Andrew Surman,2309,1970.0,339,85.31831961888263,325,226,99,69.53846153846153,1321,1245,76,94.24678274034822,216,123,93,56.94444444444444,19.7435758137072,7,3,4,42.857142857142854,42,3,26,17,7,4,22,AFC Bournemouth,38,England - Premier League
38,Andros Townsend,481,334.0,147,69.43866943866944,36,20,16,55.55555555555556,297,256,41,86.19528619528619,54,13,41,24.074074074074073,15.394840598171976,47,14,33,29.78723404255319,28,2,73,46,51,32,16,Tottenham Hotspur,16,England - Premier League
39,André Ayew Pelé,1098,882.0,216,80.32786885245902,104,54,50,51.92307692307693,701,648,53,92.43937232524965,39,16,23,41.02564102564102,14.237868738194754,15,2,13,13.333333333333334,17,2,83,41,36,16,81,Swansea City,34,England - Premier League
40,Andy Carroll,433,266.0,167,61.43187066974596,61,27,34,44.26229508196721,150,130,20,86.66666666666667,24,8,16,33.33333333333333,14.06194722163372,8,1,7,12.5,14,1,22,10,10,5,29,West Ham United,27,England - Premier League
41,Angelo Obinze Ogbonna,954,759.0,195,79.55974842767296,100,50,50,50.0,548,533,15,97.26277372262774,130,49,81,37.69230769230769,20.914057316443017,0,0,0,0.0,2,0,9,6,1,0,17,West Ham United,27,England - Premier League
42,Anthony Martial,938,713.0,225,76.01279317697228,55,30,25,54.54545454545454,692,586,106,84.6820809248555,16,8,8,50.0,13.310066513513858,47,18,29,38.297872340425535,32,3,136,73,97,52,64,Manchester United,31,England - Premier League
43,Arouna Koné,592,495.0,97,83.61486486486487,48,30,18,62.5,450,406,44,90.22222222222223,8,4,4,50.0,13.48127778060973,9,4,5,44.44444444444444,9,3,57,33,16,8,18,Everton,25,England - Premier League
44,Artur Boruc,913,576.0,337,63.088718510405265,115,28,87,24.347826086956523,286,285,1,99.65034965034964,483,154,329,31.88405797101449,41.34860619374168,0,0,0,0.0,2,0,1,1,0,0,2,AFC Bournemouth,32,England - Premier League
45,Ashley Westwood,1626,1302.0,324,80.07380073800738,247,171,76,69.23076923076923,960,887,73,92.39583333333333,234,108,126,46.15384615384615,20.848407597158083,28,4,24,14.285714285714285,40,2,27,16,10,6,16,Aston Villa,32,England - Premier League
46,Ashley Williams,1884,1600.0,284,84.92569002123143,189,106,83,56.08465608465608,1063,1020,43,95.95484477892757,213,91,122,42.72300469483568,22.998305511154012,2,0,2,0.0,10,1,6,5,2,2,15,Swansea City,36,England - Premier League
47,Ashley Young,776,571.0,205,73.58247422680412,90,51,39,56.666666666666664,363,317,46,87.32782369146005,90,30,60,33.33333333333333,18.244059534107627,60,12,48,20.0,8,2,38,14,27,8,20,Manchester United,18,England - Premier League
48,Asmir Begović,410,226.0,184,55.1219512195122,68,13,55,19.11764705882353,114,113,1,99.12280701754386,248,68,180,27.419354838709676,44.874002047277855,0,0,0,0.0,0,0,0,0,0,0,4,Chelsea,17,England - Premier League
49,Ayoze Pérez Gutiérrez,658,463.0,195,70.36474164133737,68,43,25,63.23529411764706,414,345,69,83.33333333333334,73,25,48,34.24657534246575,15.995096294869422,34,13,21,38.23529411764706,26,2,108,58,52,20,52,Newcastle United,34,England - Premier League
50,Bacary Sagna,1984,1624.0,360,81.85483870967742,249,160,89,64.2570281124498,1165,1094,71,93.90557939914163,123,50,73,40.65040650406504,15.717920350380604,57,22,35,38.59649122807017,27,3,17,9,8,4,16,Manchester City,28,England - Premier League
51,Bafétimbi Gomis,499,398.0,101,79.75951903807615,27,14,13,51.85185185185185,311,273,38,87.78135048231512,20,16,4,80.0,13.648470605285771,6,3,3,50.0,14,0,47,32,20,12,26,Swansea City,33,England - Premier League
52,Bakary Sako,423,293.0,130,69.26713947990544,36,21,15,58.333333333333336,225,195,30,86.66666666666667,59,16,43,27.11864406779661,18.762409953636595,29,6,23,20.689655172413794,8,1,41,21,24,14,11,Crystal Palace,19,England - Premier League
53,Bamidele Alli,1094,810.0,284,74.04021937842778,138,92,46,66.66666666666666,710,611,99,86.05633802816901,48,13,35,27.083333333333332,15.29671408924357,17,4,13,23.52941176470588,47,8,106,42,66,22,75,Tottenham Hotspur,33,England - Premier League
54,Bastian Schweinsteiger,1086,924.0,162,85.0828729281768,165,119,46,72.12121212121212,737,694,43,94.16553595658074,87,43,44,49.42528735632184,18.03084365291801,7,2,5,28.57142857142857,9,0,23,17,9,5,24,Manchester United,18,England - Premier League
55,Ben Davies,890,670.0,220,75.28089887640449,101,59,42,58.415841584158414,407,371,36,91.15479115479116,90,28,62,31.11111111111111,17.872941392961167,28,11,17,39.285714285714285,14,2,10,6,5,3,10,Tottenham Hotspur,17,England - Premier League
56,Ben Foster,408,202.0,206,49.50980392156863,107,36,71,33.64485981308411,41,41,0,100.0,342,136,206,39.76608187134503,55.044993998452945,0,0,0,0.0,0,0,0,0,0,0,0,West Bromwich Albion,15,England - Premier League
57,Ben Watson,1599,1186.0,413,74.17135709818636,246,122,124,49.59349593495935,802,752,50,93.76558603491272,284,104,180,36.61971830985916,20.48090927847931,31,7,24,22.58064516129032,35,0,17,12,3,2,17,Watford,35,England - Premier League
58,Benik Afobe,224,189.0,35,84.375,11,7,4,63.63636363636363,153,146,7,95.42483660130719,2,1,1,50.0,12.123101447668928,2,1,1,50.0,11,0,20,8,11,1,11,AFC Bournemouth,15,England - Premier League
59,Bersant Celina,15,13.0,2,86.66666666666667,1,1,0,100.0,10,10,0,100.0,2,2,0,100.0,15.894888074016,1,1,0,100.0,1,1,0,0,0,0,0,Manchester City,1,England - Premier League
60,Bertrand Isidore Traoré,137,115.0,22,83.94160583941606,11,9,2,81.81818181818183,95,88,7,92.63157894736842,3,0,3,0.0,14.77467757146219,4,1,3,25.0,4,1,13,10,12,9,5,Chelsea,10,England - Premier League
61,Billy Jones,847,588.0,259,69.42148760330579,111,49,62,44.14414414414414,303,265,38,87.45874587458746,92,27,65,29.347826086956523,17.357203351437448,18,4,14,22.22222222222222,10,0,17,12,10,7,15,Sunderland,24,England - Premier League
62,Bojan Krkíc Pérez,758,609.0,149,80.34300791556728,84,62,22,73.80952380952381,550,486,64,88.36363636363636,53,25,28,47.16981132075472,16.83265510786702,19,3,16,15.789473684210526,26,1,88,44,44,24,35,Stoke City,27,England - Premier League
63,Bradley Guzan,840,486.0,354,57.85714285714286,110,31,79,28.18181818181818,147,146,1,99.31972789115646,599,253,346,42.23706176961603,47.56934712099429,0,0,0,0.0,1,0,0,0,0,0,3,Aston Villa,28,England - Premier League
64,Bradley Johnson,77,55.0,22,71.42857142857143,12,6,6,50.0,40,34,6,85.0,5,2,3,40.0,16.293878485742336,2,1,1,50.0,3,1,5,3,2,1,3,Norwich City,4,England - Premier League
65,Bradley Shaun Smith,170,132.0,38,77.64705882352942,12,7,5,58.333333333333336,86,72,14,83.72093023255815,5,4,1,80.0,16.44281185641035,10,4,6,40.0,2,0,8,2,6,2,4,Liverpool,4,England - Premier League
66,Branislav Ivanović,1569,1276.0,293,81.32568514977693,152,83,69,54.60526315789473,866,807,59,93.18706697459585,152,61,91,40.131578947368425,18.644274553132544,38,13,25,34.21052631578947,12,2,18,9,11,4,24,Chelsea,33,England - Premier League
67,Brede Hangeland,265,217.0,48,81.88679245283019,27,9,18,33.33333333333333,141,139,2,98.58156028368793,26,11,15,42.30769230769231,21.120528389882264,0,0,0,0.0,0,0,3,3,0,0,3,Crystal Palace,7,England - Premier League
68,Brendan Joel Zibusiso Galloway,527,424.0,103,80.45540796963947,32,20,12,62.5,321,291,30,90.65420560747664,25,6,19,24.0,14.406258733254647,6,2,4,33.33333333333333,4,1,14,3,7,0,30,Everton,15,England - Premier League
69,Bryan Oviedo,571,437.0,134,76.5323992994746,46,30,16,65.21739130434783,320,287,33,89.6875,61,19,42,31.147540983606557,17.468524688080983,21,4,17,19.047619047619047,11,1,13,6,4,2,14,Everton,14,England - Premier League
70,Callum Connolly,13,9.0,4,69.23076923076923,0,0,0,0.0,8,7,1,87.5,0,0,0,0.0,18.241019429261538,2,0,2,0.0,0,0,0,0,0,0,0,Everton,1,England - Premier League
71,Callum McManaman,99,72.0,27,72.72727272727273,4,4,0,100.0,69,62,7,89.85507246376811,8,0,8,0.0,16.050149389003636,11,3,8,27.27272727272727,7,1,17,12,8,7,10,West Bromwich Albion,12,England - Premier League
72,Callum Wilson,143,104.0,39,72.72727272727273,8,3,5,37.5,98,75,23,76.53061224489795,1,0,1,0.0,12.039148782392726,4,2,2,50.0,8,0,33,11,20,5,18,AFC Bournemouth,13,England - Premier League
73,Calum Chambers,190,165.0,25,86.8421052631579,14,8,6,57.14285714285714,128,120,8,93.75,10,4,6,40.0,18.257693947434948,1,0,1,0.0,2,0,11,8,1,1,3,Arsenal,12,England - Premier League
74,Cameron Borthwick-Jackson,484,378.0,106,78.099173553719,49,35,14,71.42857142857143,263,234,29,88.97338403041825,37,14,23,37.83783783783784,16.700319462824627,20,5,15,25.0,6,1,7,5,6,4,3,Manchester United,10,England - Premier League
75,Cameron Brannagan,126,115.0,11,91.26984126984127,10,6,4,60.0,91,89,2,97.8021978021978,9,3,6,33.33333333333333,18.70583039624,4,1,3,25.0,1,0,4,2,4,2,0,Liverpool,3,England - Premier League
76,Cameron Jerome,434,269.0,165,61.9815668202765,38,13,25,34.21052631578947,190,160,30,84.21052631578947,12,5,7,41.66666666666667,12.387419364477235,13,3,10,23.076923076923077,6,2,39,15,28,10,11,Norwich City,34,England - Premier League
77,Carl Jenkinson,706,517.0,189,73.22946175637394,75,37,38,49.333333333333336,329,299,30,90.88145896656535,80,19,61,23.75,18.979007661997393,23,8,15,34.78260869565217,6,0,14,4,8,1,5,West Ham United,20,England - Premier League
78,Carles Gil de Pareja Vicent,809,655.0,154,80.96415327564895,65,50,15,76.92307692307693,558,502,56,89.96415770609319,71,24,47,33.80281690140845,16.86782196876638,33,8,25,24.242424242424242,22,1,63,37,26,14,31,Aston Villa,23,England - Premier League
79,Carlos Alberto Sánchez Moreno,795,646.0,149,81.25786163522012,97,59,38,60.824742268041234,442,409,33,92.53393665158372,87,53,34,60.91954022988506,19.50298107019834,2,1,1,50.0,3,0,30,22,6,3,9,Aston Villa,20,England - Premier League
80,Chancel Mbemba Mangulu,1162,909.0,253,78.22719449225474,143,77,66,53.84615384615385,613,574,39,93.6378466557912,170,64,106,37.64705882352941,22.95024219517632,4,1,3,25.0,4,0,26,20,7,2,12,Newcastle United,33,England - Premier League
81,"Charles N""Zogbia",12,9.0,3,75.0,0,0,0,0.0,9,9,0,100.0,0,0,0,0.0,10.48573164216,1,0,1,0.0,0,0,1,0,1,0,0,Aston Villa,2,England - Premier League
82,Charlie Adam,590,432.0,158,73.22033898305085,119,58,61,48.739495798319325,284,263,21,92.6056338028169,128,51,77,39.84375,24.27170914706034,16,5,11,31.25,9,1,19,10,8,5,29,Stoke City,22,England - Premier League
83,Charlie Austin,55,35.0,20,63.63636363636363,7,4,3,57.14285714285714,22,18,4,81.81818181818183,5,2,3,40.0,15.895319389291636,2,1,1,50.0,1,0,2,2,1,1,7,Southampton,7,England - Premier League
84,Charlie Daniels,2239,1765.0,474,78.8298347476552,237,136,101,57.383966244725734,1265,1148,117,90.75098814229248,233,87,146,37.33905579399141,17.66795447526113,93,28,65,30.107526881720432,31,5,67,47,27,15,20,AFC Bournemouth,37,England - Premier League
85,Cheik Ismaël Tioté,850,731.0,119,86.0,98,57,41,58.16326530612245,552,532,20,96.37681159420289,62,28,34,45.16129032258064,18.298301059921975,0,0,0,0.0,8,0,21,14,3,3,14,Newcastle United,20,England - Premier League
86,Cheikhou Kouyaté,1255,998.0,257,79.52191235059762,110,59,51,53.63636363636364,771,716,55,92.86640726329442,59,22,37,37.28813559322034,15.687911972552413,15,2,13,13.333333333333334,14,2,45,32,13,7,48,West Ham United,34,England - Premier League
87,Chris Brunt,851,563.0,288,66.15746180963572,177,90,87,50.847457627118644,303,274,29,90.42904290429043,210,72,138,34.285714285714285,23.289098744794714,45,16,29,35.55555555555556,16,3,17,11,5,1,7,West Bromwich Albion,22,England - Premier League
88,Chris Smalling,1522,1280.0,242,84.09986859395532,128,50,78,39.0625,839,813,26,96.9010727056019,136,32,104,23.52941176470588,21.774586926724652,1,0,1,0.0,5,1,8,7,0,0,15,Manchester United,35,England - Premier League
89,Christian Benteke Liolo,493,344.0,149,69.77687626774848,40,14,26,35.0,227,188,39,82.81938325991189,16,13,3,81.25,13.27543136475291,5,5,0,100.0,23,3,21,11,10,3,27,Liverpool,29,England - Premier League
90,Christian Dannemann Eriksen,2041,1559.0,482,76.38412542871141,253,180,73,71.14624505928853,1231,1112,119,90.33306255077173,231,85,146,36.79653679653679,17.8054840872762,74,22,52,29.72972972972973,95,12,76,39,52,23,24,Tottenham Hotspur,35,England - Premier League
91,Christian Fuchs,1665,1128.0,537,67.74774774774774,275,155,120,56.36363636363636,582,519,63,89.17525773195877,386,126,260,32.64248704663213,21.659748672699894,88,13,75,14.772727272727273,43,4,17,11,5,4,12,Leicester City,32,England - Premier League
92,Chung-Yong Lee,193,156.0,37,80.82901554404145,15,11,4,73.33333333333333,119,108,11,90.75630252100841,18,8,10,44.44444444444444,16.76051631019399,9,3,6,33.33333333333333,6,0,19,12,7,3,6,Crystal Palace,13,England - Premier League
93,Ciaran Clark,584,445.0,139,76.1986301369863,86,26,60,30.23255813953488,332,322,10,96.98795180722891,97,27,70,27.835051546391753,22.107484812328767,2,1,1,50.0,3,0,8,6,2,0,10,Aston Villa,17,England - Premier League
94,Claudio Ariel Yacob,1118,870.0,248,77.8175313059034,160,92,68,57.49999999999999,565,517,48,91.50442477876106,112,48,64,42.857142857142854,19.22080667910904,5,1,4,20.0,8,1,18,10,2,1,49,West Bromwich Albion,34,England - Premier League
95,Clinton Mua N''Jie,72,46.0,26,63.888888888888886,6,2,4,33.33333333333333,42,33,9,78.57142857142857,6,1,5,16.666666666666664,14.830494669659998,4,1,3,25.0,1,1,12,7,10,5,1,Tottenham Hotspur,8,England - Premier League
96,Connor Steven Randall,104,78.0,26,75.0,14,9,5,64.28571428571429,41,36,5,87.8048780487805,9,0,9,0.0,16.19827289324308,2,0,2,0.0,0,0,6,2,2,0,2,Liverpool,3,England - Premier League
97,Connor Wickham,409,266.0,143,65.03667481662592,55,27,28,49.09090909090909,155,126,29,81.29032258064515,28,12,16,42.857142857142854,15.463996953176334,18,4,14,22.22222222222222,10,3,24,17,12,10,23,Crystal Palace,21,England - Premier League
98,Costel Fane Pantilimon,560,281.0,279,50.17857142857143,105,22,83,20.952380952380953,100,100,0,100.0,412,141,271,34.22330097087379,48.56890600604829,0,0,0,0.0,1,0,0,0,0,0,3,Sunderland,17,England - Premier League
99,Craig Cathcart,1050,749.0,301,71.33333333333334,211,72,139,34.12322274881517,447,428,19,95.74944071588367,270,85,185,31.48148148148148,25.294580660431613,2,1,1,50.0,3,0,5,4,0,0,13,Watford,35,England - Premier League
100,Craig Dawson,1658,1049.0,609,63.268998793727384,308,129,179,41.883116883116884,471,404,67,85.77494692144374,295,92,203,31.186440677966104,20.547146366272617,77,24,53,31.16883116883117,23,0,30,15,18,7,32,West Bromwich Albion,38,England - Premier League
101,Craig Gardner,745,420.0,325,56.375838926174495,130,52,78,40.0,299,242,57,80.93645484949833,173,51,122,29.47976878612717,20.44988334146223,44,13,31,29.545454545454547,23,3,22,9,13,7,27,West Bromwich Albion,34,England - Premier League
102,Cristian Gamboa Luna,13,9.0,4,69.23076923076923,1,1,0,100.0,10,9,1,90.0,0,0,0,0.0,13.275629778184616,0,0,0,0.0,0,0,2,1,1,1,1,West Bromwich Albion,1,England - Premier League
103,Cédric Ricardo Alves Soares,1155,771.0,384,66.75324675324676,199,101,98,50.753768844221106,410,375,35,91.46341463414635,228,77,151,33.771929824561404,19.686080536715846,95,25,70,26.31578947368421,23,2,37,28,19,13,16,Southampton,24,England - Premier League
104,César Azpilicueta Tanco,2198,1782.0,416,81.07370336669699,249,156,93,62.65060240963856,1221,1138,83,93.2022932022932,193,78,115,40.41450777202073,17.278592141953375,51,16,35,31.372549019607842,17,4,26,8,13,4,22,Chelsea,37,England - Premier League
105,Daley Blind,2215,1786.0,429,80.63205417607223,301,182,119,60.46511627906976,1224,1160,64,94.77124183006535,360,136,224,37.77777777777778,22.6801666045912,25,5,20,20.0,27,1,17,13,4,3,17,Manchester United,35,England - Premier League
106,Dame N''Doye,194,130.0,64,67.0103092783505,20,9,11,45.0,101,87,14,86.13861386138613,15,6,9,40.0,16.168615162318762,4,1,3,25.0,3,0,15,5,7,3,20,Sunderland,11,England - Premier League
107,Damien Delaney,1072,785.0,287,73.22761194029852,194,70,124,36.08247422680412,459,439,20,95.64270152505446,277,97,180,35.018050541516246,26.023323462046122,2,2,0,100.0,5,3,4,4,0,0,15,Crystal Palace,32,England - Premier League
108,Dan Gosling,1230,1029.0,201,83.65853658536585,152,106,46,69.73684210526315,874,797,77,91.18993135011442,40,15,25,37.5,15.674821702648975,6,1,5,16.666666666666664,28,1,59,34,18,12,48,AFC Bournemouth,34,England - Premier League
109,Daniel Amartey,74,61.0,13,82.43243243243244,6,4,2,66.66666666666666,40,37,3,92.5,9,4,5,44.44444444444444,19.485107078215137,0,0,0,0.0,1,0,2,1,1,0,1,Leicester City,4,England - Premier League
110,Daniel Andre Sturridge,327,250.0,77,76.45259938837921,30,19,11,63.33333333333333,234,202,32,86.32478632478633,16,9,7,56.25,14.414142358483156,12,1,11,8.333333333333332,5,1,37,20,19,9,14,Liverpool,14,England - Premier League
111,Daniel Nii Tackie Mensah Welbeck,145,118.0,27,81.37931034482759,12,7,5,58.333333333333336,119,102,17,85.71428571428571,1,1,0,100.0,13.14311410761269,3,2,1,66.66666666666666,5,2,34,17,20,8,9,Arsenal,11,England - Premier League
112,Daniel William John Ings,81,59.0,22,72.8395061728395,11,7,4,63.63636363636363,46,36,10,78.26086956521739,8,4,4,50.0,15.635905029315555,1,1,0,100.0,5,0,7,3,7,3,7,Liverpool,6,England - Premier League
113,Danny Drinkwater,2033,1556.0,477,76.53713723561239,427,242,185,56.674473067915685,1117,1013,104,90.68934646374217,320,141,179,44.0625,19.190221174563952,37,10,27,27.027027027027028,34,7,46,28,9,6,28,Leicester City,35,England - Premier League
114,Danny Graham,86,50.0,36,58.139534883720934,8,4,4,50.0,40,33,7,82.5,6,3,3,50.0,15.087928710851163,3,1,2,33.33333333333333,0,0,2,0,2,0,7,Sunderland,10,England - Premier League
115,Danny Rose,1433,1077.0,356,75.15701325889742,184,93,91,50.54347826086957,756,669,87,88.4920634920635,158,62,96,39.24050632911392,18.682186353489698,56,14,42,25.0,20,3,52,27,23,11,50,Tottenham Hotspur,24,England - Premier League
116,Danny Simpson,1203,850.0,353,70.65669160432253,163,75,88,46.012269938650306,429,397,32,92.54079254079254,142,41,101,28.87323943661972,17.7440426949989,19,3,16,15.789473684210526,6,0,17,10,8,2,13,Leicester City,30,England - Premier League
117,Danny Ward,58,33.0,25,56.896551724137936,3,0,3,0.0,23,23,0,100.0,29,5,24,17.24137931034483,39.844909606965516,0,0,0,0.0,0,0,0,0,0,0,0,Liverpool,2,England - Premier League
118,Darren Fletcher,1516,1151.0,365,75.92348284960421,287,172,115,59.93031358885017,826,744,82,90.07263922518159,219,96,123,43.83561643835616,20.15872398303174,31,8,23,25.806451612903224,23,2,67,39,21,10,36,West Bromwich Albion,38,England - Premier League
119,Darren Randolph,192,104.0,88,54.166666666666664,76,24,52,31.57894736842105,30,30,0,100.0,136,54,82,39.705882352941174,53.238086238562495,0,0,0,0.0,0,0,0,0,0,0,0,West Ham United,6,England - Premier League
120,Darron Gibson,177,154.0,23,87.00564971751412,33,19,14,57.57575757575758,105,101,4,96.19047619047619,23,12,11,52.17391304347826,23.185028408977622,0,0,0,0.0,3,0,3,3,0,0,0,Everton,6,England - Premier League
121,Daryl Janmaat,1731,1264.0,467,73.0213749277874,200,115,85,57.49999999999999,737,651,86,88.33107191316147,216,74,142,34.25925925925926,18.26804781064721,116,28,88,24.137931034482758,22,4,67,46,41,26,8,Newcastle United,32,England - Premier League
122,David Josué Jiménez Silva,1488,1226.0,262,82.39247311827957,156,127,29,81.41025641025641,1090,986,104,90.45871559633028,115,62,53,53.91304347826087,15.711526545064356,42,10,32,23.809523809523807,50,10,50,31,30,18,39,Manchester City,24,England - Premier League
123,David Ospina Ramírez,127,74.0,53,58.26771653543307,21,6,15,28.57142857142857,21,21,0,100.0,87,35,52,40.229885057471265,46.6440548904,0,0,0,0.0,0,0,0,0,0,0,2,Arsenal,4,England - Premier League
124,David de Gea Quintana,956,596.0,360,62.34309623430963,72,18,54,25.0,240,236,4,98.33333333333333,585,232,353,39.65811965811966,44.42857193536193,0,0,0,0.0,0,0,0,0,0,0,0,Manchester United,34,England - Premier League
125,DeAndre Yedlin,797,522.0,275,65.49560853199499,122,53,69,43.44262295081967,293,267,26,91.12627986348123,142,46,96,32.3943661971831,19.665263599246977,27,7,20,25.925925925925924,11,1,41,23,26,12,13,Sunderland,23,England - Premier League
126,Declan Rudd,334,149.0,185,44.61077844311377,58,15,43,25.862068965517242,47,47,0,100.0,257,76,181,29.571984435797667,51.035976073153286,0,0,0,0.0,0,0,0,0,0,0,0,Norwich City,11,England - Premier League
127,Dejan Lovren,1078,917.0,161,85.06493506493507,104,59,45,56.730769230769226,641,617,24,96.25585023400937,112,47,65,41.964285714285715,21.350445952852986,3,1,2,33.33333333333333,8,0,3,2,0,0,13,Liverpool,24,England - Premier League
128,Demarai Gray,100,72.0,28,72.0,7,4,3,57.14285714285714,61,50,11,81.9672131147541,10,5,5,50.0,15.5035534075632,6,3,3,50.0,5,1,11,7,7,5,4,Leicester City,12,England - Premier League
129,Diafra Sakho,360,227.0,133,63.05555555555556,49,16,33,32.6530612244898,175,141,34,80.57142857142857,21,8,13,38.095238095238095,14.0133183186718,23,6,17,26.08695652173913,12,1,50,22,31,12,31,West Ham United,21,England - Premier League
130,Diego da Silva Costa,818,642.0,176,78.4841075794621,48,32,16,66.66666666666666,588,500,88,85.03401360544217,15,9,6,60.0,12.520538448828823,18,6,12,33.33333333333333,20,5,104,47,74,28,59,Chelsea,28,England - Premier League
131,Dieumerci Mbokani Bezua,472,329.0,143,69.70338983050848,60,29,31,48.333333333333336,244,215,29,88.11475409836066,11,3,8,27.27272727272727,12.705516106830459,9,3,6,33.33333333333333,21,1,39,25,23,11,51,Norwich City,29,England - Premier League
132,Dimitri Payet,1572,1103.0,469,70.16539440203562,187,102,85,54.54545454545454,861,731,130,84.90127758420442,314,133,181,42.35668789808918,19.66128754724565,125,38,87,30.4,100,12,110,75,59,42,45,West Ham United,30,England - Premier League
133,Dionatan do Nascimento Teixeira,7,2.0,5,28.57142857142857,2,0,2,0.0,0,0,0,0.0,4,1,3,25.0,37.431453752639996,0,0,0,0.0,0,0,0,0,0,0,0,Stoke City,1,England - Premier League
134,Divock Okoth Origi,173,120.0,53,69.36416184971098,9,2,7,22.22222222222222,125,100,25,80.0,2,1,1,50.0,11.314097235980116,16,5,11,31.25,9,1,17,12,14,10,17,Liverpool,16,England - Premier League
135,Donald Love,35,24.0,11,68.57142857142857,5,1,4,20.0,22,16,6,72.72727272727273,3,0,3,0.0,17.011194452886855,1,0,1,0.0,0,0,5,3,3,2,0,Manchester United,1,England - Premier League
136,Duncan Watmore,174,113.0,61,64.9425287356322,13,11,2,84.61538461538461,110,86,24,78.18181818181819,4,2,2,50.0,12.723274369206205,12,3,9,25.0,9,1,40,22,32,17,18,Sunderland,23,England - Premier League
137,Dušan Tadić,1104,712.0,392,64.4927536231884,105,55,50,52.38095238095239,537,441,96,82.12290502793296,175,65,110,37.142857142857146,17.47321842490826,134,45,89,33.582089552238806,66,11,60,38,45,26,40,Southampton,34,England - Premier League
138,Dwight Gayle,154,104.0,50,67.53246753246754,11,6,5,54.54545454545454,68,59,9,86.76470588235294,10,3,7,30.0,15.14499276666857,7,3,4,42.857142857142854,7,0,7,3,5,3,35,Crystal Palace,16,England - Premier League
139,Eden Hazard,1476,1248.0,228,84.5528455284553,149,115,34,77.18120805369128,1064,955,109,89.75563909774436,66,50,16,75.75757575757575,15.162048007307805,51,18,33,35.294117647058826,62,3,111,75,61,42,80,Chelsea,31,England - Premier League
140,El-Hadji Baye Oumar Niasse,46,36.0,10,78.26086956521739,2,1,1,50.0,30,24,6,80.0,3,3,0,100.0,15.066722625933915,2,2,0,100.0,2,0,6,2,4,2,3,Everton,5,England - Premier League
141,Eliaquim Mangala,1011,894.0,117,88.4272997032641,41,23,18,56.09756097560976,710,684,26,96.3380281690141,49,16,33,32.6530612244898,19.161290902881188,0,0,0,0.0,0,0,8,6,2,1,8,Manchester City,23,England - Premier League
142,Emmanuel Adebayor,240,181.0,59,75.41666666666667,19,10,9,52.63157894736842,151,133,18,88.0794701986755,4,3,1,75.0,13.290269253165,3,1,2,33.33333333333333,7,1,14,6,10,3,6,Crystal Palace,12,England - Premier League
143,Emmanuel Emenike,153,112.0,41,73.20261437908496,11,6,5,54.54545454545454,103,88,15,85.43689320388349,2,1,1,50.0,11.370715903952942,5,1,4,20.0,9,0,17,11,6,4,7,West Ham United,13,England - Premier League
144,Emmanuel Rivière,20,18.0,2,90.0,2,2,0,100.0,13,11,2,84.61538461538461,0,0,0,0.0,10.306725775128,1,1,0,100.0,1,0,2,1,0,0,2,Newcastle United,3,England - Premier League
145,Emre Can,1782,1456.0,326,81.70594837261504,232,135,97,58.189655172413794,1155,1067,88,92.38095238095238,156,72,84,46.15384615384615,18.37700043819374,12,3,9,25.0,26,0,57,40,17,11,36,Liverpool,30,England - Premier League
146,Enner Remberto Valencia Lastra,259,191.0,68,73.74517374517374,20,13,7,65.0,163,143,20,87.73006134969326,12,3,9,25.0,13.70222544380108,7,2,5,28.57142857142857,7,2,36,16,16,9,21,West Ham United,19,England - Premier League
147,Eric Dier,2111,1766.0,345,83.6570345807674,330,224,106,67.87878787878789,1307,1234,73,94.41469013006886,184,74,110,40.21739130434783,19.504565216038863,14,1,13,7.142857142857142,19,2,13,9,1,0,28,Tottenham Hotspur,37,England - Premier League
148,Erik Lamela,1117,827.0,290,74.03760071620412,84,55,29,65.47619047619048,729,633,96,86.83127572016461,114,47,67,41.228070175438596,15.862153940667715,36,7,29,19.444444444444446,64,8,76,36,43,20,46,Tottenham Hotspur,34,England - Premier League
149,Erik Pieters,1956,1465.0,491,74.89775051124744,272,160,112,58.82352941176471,960,875,85,91.14583333333334,208,62,146,29.807692307692307,19.029549931165768,69,14,55,20.28985507246377,18,1,25,12,9,4,49,Stoke City,35,England - Premier League
150,Etienne Capoue,1595,1245.0,350,78.0564263322884,256,149,107,58.203125,908,826,82,90.96916299559471,180,85,95,47.22222222222222,18.063705634958957,20,7,13,35.0,22,1,93,54,43,23,65,Watford,33,England - Premier League
151,Eunan O''Kane,383,296.0,87,77.28459530026109,66,46,20,69.6969696969697,232,202,30,87.06896551724138,36,19,17,52.77777777777778,18.015182705621516,2,1,1,50.0,4,1,15,10,6,3,13,AFC Bournemouth,16,England - Premier League
152,Fabian Delph,471,399.0,72,84.71337579617835,52,38,14,73.07692307692307,370,340,30,91.8918918918919,21,5,16,23.809523809523807,15.772978136415286,3,0,3,0.0,3,0,33,24,11,7,15,Manchester City,17,England - Premier League
153,Fabio Borini,600,398.0,202,66.33333333333333,67,24,43,35.82089552238806,321,274,47,85.35825545171339,56,16,40,28.57142857142857,17.5218533906148,26,7,19,26.923076923076923,15,2,40,17,27,10,52,Sunderland,26,England - Premier League
154,Fabricio Coloccini,856,722.0,134,84.34579439252336,74,39,35,52.702702702702695,479,465,14,97.07724425887265,108,46,62,42.592592592592595,22.22931022591458,3,0,3,0.0,3,0,8,7,0,0,8,Newcastle United,26,England - Premier League
155,Faustino Marcos Alberto Rojo,902,649.0,253,71.95121951219512,115,64,51,55.65217391304348,424,397,27,93.63207547169812,117,26,91,22.22222222222222,18.77600681855601,43,11,32,25.581395348837212,9,1,2,1,0,0,13,Manchester United,16,England - Premier League
156,Federico Fernández,1745,1473.0,272,84.41260744985674,142,73,69,51.40845070422535,1095,1039,56,94.88584474885845,131,41,90,31.297709923664126,20.619984895653868,2,0,2,0.0,8,1,5,4,1,1,23,Swansea City,32,England - Premier League
157,Fernando Francisco Reges,910,809.0,101,88.90109890109889,100,79,21,79.0,625,606,19,96.96000000000001,42,21,21,50.0,17.294291126851252,0,0,0,0.0,5,0,22,20,5,5,16,Manchester City,24,England - Premier League
158,Fernando Luiz Rosa,1894,1652.0,242,87.22280887011615,320,247,73,77.1875,1376,1293,83,93.96802325581395,87,47,40,54.02298850574713,16.834100804427877,9,1,8,11.11111111111111,25,2,40,26,8,5,41,Manchester City,33,England - Premier League
159,Fikayo Tomori,14,12.0,2,85.71428571428571,1,1,0,100.0,7,7,0,100.0,1,0,1,0.0,21.351889419942857,0,0,0,0.0,0,0,1,0,1,0,0,Chelsea,1,England - Premier League
160,Florian Thauvin,216,123.0,93,56.94444444444444,24,10,14,41.66666666666667,115,96,19,83.47826086956522,41,3,38,7.317073170731707,17.72106641708,21,4,17,19.047619047619047,4,0,26,10,10,3,17,Newcastle United,13,England - Premier League
161,Fraizer Campbell,83,57.0,26,68.67469879518072,6,4,2,66.66666666666666,44,38,6,86.36363636363636,1,1,0,100.0,12.008458095952772,1,0,1,0.0,1,0,8,2,5,1,4,Crystal Palace,11,England - Premier League
162,Francesc Fàbregas i Soler,2947,2406.0,541,81.64234815066169,517,335,182,64.79690522243715,1878,1710,168,91.05431309904152,356,172,184,48.31460674157304,18.78443622941668,45,12,33,26.666666666666668,62,7,42,24,17,8,51,Chelsea,37,England - Premier League
163,Francis Joseph Coquelin,1104,988.0,116,89.4927536231884,156,128,28,82.05128205128204,804,767,37,95.39800995024875,72,50,22,69.44444444444444,16.62895816337087,4,1,3,25.0,6,0,36,30,6,6,36,Arsenal,26,England - Premier League
164,Fraser Forster,487,256.0,231,52.56673511293635,118,40,78,33.89830508474576,64,64,0,100.0,379,156,223,41.16094986807388,52.7468521625623,0,0,0,0.0,0,0,1,1,0,0,0,Southampton,18,England - Premier League
165,Gabriel Antoine Obertan,107,83.0,24,77.57009345794393,3,2,1,66.66666666666666,67,58,9,86.56716417910447,5,3,2,60.0,13.453340542459065,8,2,6,25.0,2,1,7,2,5,2,3,Newcastle United,5,England - Premier League
166,Gabriel Armando de Abreu,1074,978.0,96,91.06145251396647,51,31,20,60.78431372549019,738,719,19,97.42547425474255,53,27,26,50.943396226415096,18.77354258236297,1,0,1,0.0,1,0,7,5,2,1,14,Arsenal,21,England - Premier League
167,Gabriel Imuetinyan Agbonlahor,233,160.0,73,68.6695278969957,16,6,10,37.5,134,124,10,92.53731343283582,10,2,8,20.0,13.67819884445655,10,3,7,30.0,11,2,13,6,4,2,17,Aston Villa,15,England - Premier League
168,Gareth Barry,2098,1710.0,388,81.50619637750238,359,234,125,65.18105849582173,1227,1152,75,93.8875305623472,258,133,125,51.55038759689923,20.190341873224863,20,10,10,50.0,33,0,25,19,4,3,29,Everton,33,England - Premier League
169,Gareth McAuley,847,588.0,259,69.42148760330579,214,79,135,36.915887850467286,316,300,16,94.9367088607595,256,89,167,34.765625,26.722115319249774,1,0,1,0.0,6,0,8,8,1,1,18,West Bromwich Albion,34,England - Premier League
170,Gary Cahill,743,643.0,100,86.54104979811575,28,10,18,35.714285714285715,464,452,12,97.41379310344827,53,18,35,33.9622641509434,18.681713752701803,0,0,0,0.0,2,0,4,4,1,1,20,Chelsea,23,England - Premier League
171,Gary Hooper,4,3.0,1,75.0,0,0,0,0.0,4,3,1,75.0,0,0,0,0.0,12.69309075804,0,0,0,0.0,0,0,0,0,0,0,1,Norwich City,2,England - Premier League
172,Gary O''Neil,977,734.0,243,75.1279426816786,163,85,78,52.14723926380368,506,466,40,92.09486166007905,153,58,95,37.908496732026144,20.635642161555293,16,4,12,25.0,8,0,33,22,5,3,19,Norwich City,27,England - Premier League
173,Gastón Exequiel Ramírez Pereyra,19,13.0,6,68.42105263157895,0,0,0,0.0,12,11,1,91.66666666666666,2,0,2,0.0,16.3473341328,2,0,2,0.0,0,0,5,3,1,0,0,Southampton,3,England - Premier League
174,Gaël Clichy,839,662.0,177,78.90345649582838,122,70,52,57.377049180327866,514,473,41,92.02334630350194,77,24,53,31.16883116883117,18.013577022429942,26,10,16,38.46153846153847,10,1,14,12,3,2,8,Manchester City,14,England - Premier League
175,Geoff Cameron,1187,905.0,282,76.24262847514743,172,82,90,47.674418604651166,667,619,48,92.80359820089956,144,44,100,30.555555555555557,20.039385410851086,9,2,7,22.22222222222222,9,0,31,21,2,1,14,Stoke City,30,England - Premier League
176,George Honeyman,6,5.0,1,83.33333333333334,0,0,0,0.0,4,4,0,100.0,0,0,0,0.0,14.144027805359999,0,0,0,0.0,1,0,0,0,0,0,1,Sunderland,1,England - Premier League
177,Georginio Wijnaldum,1264,1055.0,209,83.46518987341773,128,93,35,72.65625,858,784,74,91.37529137529138,60,32,28,53.333333333333336,14.994460633710647,20,5,15,25.0,38,4,117,81,32,23,63,Newcastle United,38,England - Premier League
178,Gerard Deulofeu Lázaro,691,428.0,263,61.93921852387844,77,42,35,54.54545454545454,364,279,85,76.64835164835165,92,24,68,26.08695652173913,18.914745253270713,88,22,66,25.0,28,9,66,36,46,29,17,Everton,26,England - Premier League
179,Giedrius Arlauskis,6,4.0,2,66.66666666666666,4,2,2,50.0,0,0,0,0.0,5,3,2,60.0,60.611319468,0,0,0,0.0,0,0,0,0,0,0,0,Watford,1,England - Premier League
180,Gilbert Gianelli Imbula Wanga,779,682.0,97,87.54813863928112,117,86,31,73.50427350427351,578,550,28,95.15570934256056,45,14,31,31.11111111111111,16.764637333435072,4,0,4,0.0,11,0,61,40,14,9,22,Stoke City,14,England - Premier League
181,Glen Johnson,1205,945.0,260,78.42323651452283,169,96,73,56.80473372781065,639,582,57,91.07981220657277,108,35,73,32.407407407407405,18.11183790256778,37,11,26,29.72972972972973,16,3,72,38,38,20,12,Stoke City,25,England - Premier League
182,Glenn Murray,202,134.0,68,66.33663366336634,12,6,6,50.0,103,86,17,83.49514563106796,8,3,5,37.5,12.660676453179802,5,2,3,40.0,6,0,16,8,9,5,21,AFC Bournemouth,21,England - Premier League
183,Glenn Whelan,2037,1755.0,282,86.15611192930781,266,171,95,64.28571428571429,1334,1282,52,96.10194902548726,170,77,93,45.294117647058826,19.20717279000311,8,1,7,12.5,21,1,23,18,2,0,25,Stoke City,37,England - Premier League
184,Glyn Oliver Myhill,661,310.0,351,46.89863842662632,183,56,127,30.601092896174865,75,75,0,100.0,540,202,338,37.407407407407405,54.12766825151347,0,0,0,0.0,0,0,0,0,0,0,3,West Bromwich Albion,23,England - Premier League
185,Gnégnéri Yaya Touré,1869,1596.0,273,85.39325842696628,253,163,90,64.42687747035573,1307,1216,91,93.03749043611323,111,55,56,49.549549549549546,17.77459031920372,11,6,5,54.54545454545454,40,3,62,44,37,23,37,Manchester City,32,England - Premier League
186,Graham Dorrans,761,647.0,114,85.0197109067017,113,79,34,69.91150442477876,482,453,29,93.98340248962656,61,29,32,47.540983606557376,18.56178976834994,5,1,4,20.0,15,1,18,13,11,8,7,Norwich City,21,England - Premier League
187,Graziano Pellè,889,574.0,315,64.56692913385827,126,58,68,46.03174603174603,343,282,61,82.21574344023324,71,29,42,40.845070422535215,14.503825029188572,12,3,9,25.0,26,6,29,14,19,8,34,Southampton,30,England - Premier League
188,Guangtai Jiang,131,105.0,26,80.1526717557252,9,7,2,77.77777777777779,67,63,4,94.02985074626866,13,4,9,30.76923076923077,16.990999352804884,3,0,3,0.0,2,0,1,0,0,0,2,Everton,5,England - Premier League
189,Guillermo Varela Olivera,197,154.0,43,78.1725888324873,16,8,8,50.0,87,85,2,97.70114942528735,29,7,22,24.137931034482758,18.29336058412995,6,1,5,16.666666666666664,1,0,6,3,1,0,9,Manchester United,4,England - Premier League
190,Gylfi Þór Sigurðsson,1346,969.0,377,71.99108469539375,150,77,73,51.33333333333333,866,736,130,84.98845265588915,157,47,110,29.936305732484076,16.011578213111715,57,10,47,17.543859649122805,57,3,54,29,32,17,33,Swansea City,36,England - Premier League
191,Gökhan İnler,122,97.0,25,79.50819672131148,24,16,8,66.66666666666666,66,58,8,87.87878787878788,14,7,7,50.0,16.99066637103541,0,0,0,0.0,1,0,3,2,1,0,4,Leicester City,5,England - Premier League
192,Harrison Reed,7,4.0,3,57.14285714285714,2,0,2,0.0,3,3,0,100.0,1,0,1,0.0,15.476488572342857,0,0,0,0.0,0,0,0,0,0,0,0,Southampton,1,England - Premier League
193,Harry Arter,1042,888.0,154,85.22072936660268,182,126,56,69.23076923076923,713,646,67,90.6030855539972,88,54,34,61.36363636363637,18.294433556932052,6,4,2,66.66666666666666,24,0,38,21,18,10,24,AFC Bournemouth,21,England - Premier League
194,Harry Kane,1005,720.0,285,71.64179104477611,136,74,62,54.41176470588235,564,477,87,84.57446808510637,66,34,32,51.515151515151516,15.671180940024,39,11,28,28.205128205128204,39,1,96,56,63,33,61,Tottenham Hotspur,38,England - Premier League
195,Henri Saivet,78,62.0,16,79.48717948717949,12,4,8,33.33333333333333,43,40,3,93.02325581395348,7,4,3,57.14285714285714,19.038173417686153,0,0,0,0.0,1,0,3,0,1,0,2,Newcastle United,4,England - Premier League
196,Heung-Min Son,455,359.0,96,78.9010989010989,30,16,14,53.333333333333336,315,278,37,88.25396825396825,14,5,9,35.714285714285715,12.854427565885715,7,1,6,14.285714285714285,17,1,49,24,24,17,15,Tottenham Hotspur,28,England - Premier League
197,Heurelho da Silva Gomes,1132,593.0,539,52.3851590106007,257,80,177,31.1284046692607,158,158,0,100.0,883,347,536,39.29784824462061,52.29015317465851,0,0,0,0.0,0,0,0,0,0,0,5,Watford,38,England - Premier League
198,Hiram Boateng,5,3.0,2,60.0,0,0,0,0.0,2,2,0,100.0,0,0,0,0.0,10.656704867904,0,0,0,0.0,0,0,0,0,0,0,0,Crystal Palace,1,England - Premier League
199,Hugo Lloris,1217,817.0,400,67.13229252259654,168,36,132,21.428571428571427,440,438,2,99.54545454545455,586,203,383,34.641638225255974,38.938391519489635,0,0,0,0.0,3,0,0,0,0,0,5,Tottenham Hotspur,37,England - Premier League
200,Héctor Bellerín Moruno,2094,1735.0,359,82.85577841451767,195,145,50,74.35897435897436,1303,1177,126,90.33000767459708,98,39,59,39.795918367346935,15.281192566537237,81,22,59,27.160493827160494,19,5,103,67,40,26,14,Arsenal,36,England - Premier League
201,Ibrahim Afellay,1331,1146.0,185,86.10067618332081,166,127,39,76.50602409638554,887,843,44,95.03945885005636,96,47,49,48.95833333333333,19.362865752893644,30,3,27,10.0,19,2,59,40,17,10,42,Stoke City,31,England - Premier League
202,Idrissa Gana Gueye,1906,1608.0,298,84.36516264428123,227,161,66,70.92511013215858,1318,1228,90,93.17147192716236,103,50,53,48.54368932038835,16.680100501715383,13,4,9,30.76923076923077,26,1,108,74,37,22,57,Aston Villa,35,England - Premier League
203,Ignacio Monreal Eraso,2259,1868.0,391,82.69145639663567,201,141,60,70.1492537313433,1377,1293,84,93.89978213507625,170,64,106,37.64705882352941,15.77828598763538,83,25,58,30.120481927710845,25,3,26,12,11,4,47,Arsenal,37,England - Premier League
204,Ikechi Anya,866,620.0,246,71.59353348729792,83,49,34,59.036144578313255,452,406,46,89.82300884955751,88,30,58,34.090909090909086,16.382877701234968,47,10,37,21.27659574468085,15,1,28,17,13,10,20,Watford,28,England - Premier League
205,Ivan Toney,2,1.0,1,50.0,0,0,0,0.0,1,1,0,100.0,0,0,0,0.0,16.0302375864,0,0,0,0.0,0,0,0,0,0,0,0,Newcastle United,2,England - Premier League
206,Ivo Daniel Ferreira Mendonca Pinto,486,353.0,133,72.63374485596708,57,27,30,47.368421052631575,187,170,17,90.9090909090909,53,20,33,37.735849056603776,17.573295804522964,24,8,16,33.33333333333333,2,0,19,11,10,6,6,Norwich City,10,England - Premier League
207,Jack Butland,1013,551.0,462,54.3928923988154,212,58,154,27.358490566037734,248,247,1,99.59677419354838,684,228,456,33.33333333333333,48.48878213422792,0,0,0,0.0,1,0,1,1,0,0,2,Stoke City,31,England - Premier League
208,Jack Colback,1175,965.0,210,82.12765957446808,144,97,47,67.36111111111111,702,668,34,95.15669515669516,135,61,74,45.18518518518518,18.829482763961874,24,10,14,41.66666666666667,17,1,20,14,4,2,48,Newcastle United,29,England - Premier League
209,Jack Frank Porteous Cork,1746,1459.0,287,83.56242840778924,198,129,69,65.15151515151516,1155,1088,67,94.1991341991342,111,53,58,47.74774774774775,16.910346002330307,14,4,10,28.57142857142857,27,1,61,41,17,11,53,Swansea City,35,England - Premier League
210,Jack Grealish,342,269.0,73,78.65497076023392,27,17,10,62.96296296296296,252,222,30,88.09523809523809,20,4,16,20.0,14.89283068484842,6,1,5,16.666666666666664,11,0,33,19,18,9,21,Aston Villa,16,England - Premier League
211,Jack Rodwell,462,347.0,115,75.10822510822511,74,38,36,51.35135135135135,252,238,14,94.44444444444444,46,20,26,43.47826086956522,17.766654405165195,2,0,2,0.0,14,0,12,8,3,0,9,Sunderland,22,England - Premier League
212,Jack Wilshere,77,68.0,9,88.31168831168831,4,4,0,100.0,66,60,6,90.9090909090909,3,1,2,33.33333333333333,12.978098945102337,0,0,0,0.0,0,0,11,5,7,3,7,Arsenal,3,England - Premier League
213,Jake-Liam Clarke-Salter,6,6.0,0,100.0,0,0,0,0.0,6,6,0,100.0,0,0,0,0.0,16.0547317716,0,0,0,0.0,0,0,0,0,0,0,0,Chelsea,1,England - Premier League
214,Jakob Haugaard,145,82.0,63,56.55172413793104,47,15,32,31.914893617021278,18,18,0,100.0,110,48,62,43.63636363636363,54.490564488562754,0,0,0,0.0,0,0,0,0,0,0,0,Stoke City,5,England - Premier League
215,Jamaal Lascelles,461,383.0,78,83.08026030368764,34,13,21,38.23529411764706,260,250,10,96.15384615384616,54,18,36,33.33333333333333,19.52544170365692,2,0,2,0.0,2,0,5,3,1,1,3,Newcastle United,18,England - Premier League
216,James Collins,555,435.0,120,78.37837837837837,81,33,48,40.74074074074074,289,278,11,96.19377162629758,102,38,64,37.254901960784316,23.557911548781405,1,0,1,0.0,1,0,4,3,0,0,7,West Ham United,19,England - Premier League
217,James Grant Chester,404,299.0,105,74.00990099009901,67,35,32,52.23880597014925,170,153,17,90.0,56,12,44,21.428571428571427,19.181944223998215,12,1,11,8.333333333333332,4,0,7,4,2,1,7,West Bromwich Albion,13,England - Premier League
218,James McArthur,1067,900.0,167,84.34864104967198,99,55,44,55.55555555555556,642,602,40,93.76947040498442,77,35,42,45.45454545454545,18.01940618353192,6,2,4,33.33333333333333,19,2,33,20,11,5,29,Crystal Palace,28,England - Premier League
219,James McCarthy,1389,1195.0,194,86.03311735061196,175,119,56,68.0,936,884,52,94.44444444444444,99,44,55,44.44444444444444,18.58897303462134,9,2,7,22.22222222222222,14,2,16,9,5,3,36,Everton,29,England - Premier League
220,James McClean,822,493.0,329,59.975669099756686,74,40,34,54.054054054054056,356,298,58,83.70786516853933,148,52,96,35.13513513513514,18.616784559878102,107,32,75,29.906542056074763,30,2,68,35,36,16,45,West Bromwich Albion,35,England - Premier League
221,James Morrison,615,496.0,119,80.65040650406505,73,43,30,58.9041095890411,388,347,41,89.43298969072166,58,35,23,60.3448275862069,17.39637934189112,7,2,5,28.57142857142857,16,2,36,20,16,7,13,West Bromwich Albion,18,England - Premier League
222,James Philip Milner,1610,1172.0,438,72.79503105590062,253,161,92,63.63636363636363,914,805,109,88.07439824945295,257,104,153,40.46692607003891,19.18094682666365,86,31,55,36.04651162790697,50,11,41,21,30,18,37,Liverpool,28,England - Premier League
223,James Tomkins,963,747.0,216,77.57009345794393,119,53,66,44.537815126050425,481,452,29,93.97089397089398,137,49,88,35.76642335766424,19.912415396983928,13,3,10,23.076923076923077,10,0,9,5,4,1,16,West Ham United,25,England - Premier League
224,James Ward-Prowse,807,615.0,192,76.2081784386617,121,91,30,75.20661157024794,430,399,31,92.79069767441861,153,57,96,37.254901960784316,19.97103578674974,39,12,27,30.76923076923077,27,4,14,10,3,3,9,Southampton,33,England - Premier League
225,James Wilson,6,6.0,0,100.0,0,0,0,0.0,5,5,0,100.0,0,0,0,0.0,15.9751705896,0,0,0,0.0,1,0,0,0,0,0,0,Manchester United,1,England - Premier League
226,Jamie Vardy,679,426.0,253,62.73932253313696,55,28,27,50.90909090909091,296,237,59,80.06756756756756,26,9,17,34.61538461538461,14.211758067849544,50,18,32,36.0,36,5,76,39,63,33,34,Leicester City,36,England - Premier League
227,Jan Kirchhoff,569,389.0,180,68.36555360281194,126,70,56,55.55555555555556,271,243,28,89.66789667896678,61,17,44,27.86885245901639,19.702127263925483,3,1,2,33.33333333333333,13,0,16,14,5,5,19,Sunderland,15,England - Premier League
228,Jan Vertonghen,1526,1335.0,191,87.48361730013107,129,69,60,53.48837209302325,956,938,18,98.11715481171548,124,47,77,37.903225806451616,21.226225021012215,1,1,0,100.0,5,0,10,10,2,2,24,Tottenham Hotspur,29,England - Premier League
229,Jason Puncheon,1408,1046.0,362,74.28977272727273,211,122,89,57.81990521327014,821,731,90,89.03775883069429,210,79,131,37.61904761904762,18.64787356602148,54,13,41,24.074074074074073,54,3,83,52,45,24,40,Crystal Palace,31,England - Premier League
230,Javier Hernández Balcázar,13,11.0,2,84.61538461538461,0,0,0,0.0,13,11,2,84.61538461538461,0,0,0,0.0,11.347362133975384,0,0,0,0.0,1,0,0,0,0,0,1,Manchester United,1,England - Premier League
231,Jay Fulton,9,9.0,0,100.0,1,1,0,100.0,8,8,0,100.0,0,0,0,0.0,14.307584288,0,0,0,0.0,0,0,0,0,0,0,0,Swansea City,2,England - Premier League
232,Jay Rodriguez,93,67.0,26,72.04301075268818,15,12,3,80.0,49,40,9,81.63265306122449,3,2,1,66.66666666666666,14.573231261682581,3,2,1,66.66666666666666,3,0,12,6,8,4,3,Southampton,12,England - Premier League
233,Jefferson Antonio Montero Vite,492,316.0,176,64.22764227642277,24,11,13,45.83333333333333,267,229,38,85.76779026217228,54,15,39,27.77777777777778,16.14982932272049,89,22,67,24.719101123595504,24,2,84,39,67,28,43,Swansea City,23,England - Premier League
234,Jeffrey Schlupp,557,390.0,167,70.01795332136446,70,38,32,54.285714285714285,285,255,30,89.47368421052632,78,27,51,34.61538461538461,18.46660840430245,34,13,21,38.23529411764706,15,2,49,31,38,23,25,Leicester City,24,England - Premier League
235,Jeremain Lens,474,277.0,197,58.438818565400844,72,26,46,36.11111111111111,220,173,47,78.63636363636364,83,26,57,31.32530120481928,21.036907475876962,49,7,42,14.285714285714285,14,3,64,34,43,22,34,Sunderland,20,England - Premier League
236,Jermain Defoe,439,319.0,120,72.66514806378133,40,20,20,50.0,277,228,49,82.31046931407943,19,10,9,52.63157894736842,14.67016693739721,6,1,5,16.666666666666664,18,1,43,20,31,15,39,Sunderland,33,England - Premier League
237,Jesse Lingard,771,635.0,136,82.36057068741893,56,32,24,57.14285714285714,563,507,56,90.05328596802842,28,6,22,21.428571428571427,13.803746062621633,22,3,19,13.636363636363635,14,1,35,12,16,4,23,Manchester United,25,England - Premier League
238,Jesús Navas González,1452,1103.0,349,75.9641873278237,83,54,29,65.06024096385542,996,863,133,86.64658634538152,104,35,69,33.65384615384615,15.71851974483967,115,29,86,25.217391304347824,48,7,68,45,39,25,29,Manchester City,34,England - Premier League
239,Joe Allen,413,347.0,66,84.01937046004842,49,34,15,69.38775510204081,295,273,22,92.54237288135593,21,12,9,57.14285714285714,17.255575254257433,9,4,5,44.44444444444444,12,1,16,9,7,5,24,Liverpool,19,England - Premier League
240,Joe Dodoo,6,3.0,3,50.0,2,0,2,0.0,2,2,0,100.0,1,0,1,0.0,15.279702028799997,0,0,0,0.0,0,0,0,0,0,0,1,Leicester City,1,England - Premier League
241,Joe Gomez,273,218.0,55,79.85347985347985,31,21,10,67.74193548387096,156,142,14,91.02564102564102,29,10,19,34.48275862068966,17.90905377354989,7,1,6,14.285714285714285,2,1,8,4,1,0,2,Liverpool,5,England - Premier League
242,Joe Hart,848,502.0,346,59.198113207547166,94,23,71,24.46808510638298,242,242,0,100.0,515,174,341,33.78640776699029,43.95235503490642,0,0,0,0.0,2,0,1,1,0,0,4,Manchester City,35,England - Premier League
243,Joe Ledley,396,322.0,74,81.31313131313132,39,20,19,51.28205128205128,240,221,19,92.08333333333333,29,6,23,20.689655172413794,16.38693091716182,1,0,1,0.0,3,0,6,4,2,2,5,Crystal Palace,19,England - Premier League
244,Joel Nathaniel Campbell Samuels,350,266.0,84,76.0,38,16,22,42.10526315789473,261,227,34,86.97318007662835,18,5,13,27.77777777777778,14.668505905891886,9,4,5,44.44444444444444,11,2,22,14,17,12,29,Arsenal,19,England - Premier League
245,Joel Robles Blázquez,475,250.0,225,52.63157894736842,71,13,58,18.30985915492958,116,116,0,100.0,307,89,218,28.990228013029316,47.32319071171705,0,0,0,0.0,0,0,1,1,0,0,2,Everton,13,England - Premier League
246,Joel Ward,1328,982.0,346,73.94578313253012,202,108,94,53.46534653465347,541,494,47,91.31238447319778,188,65,123,34.57446808510639,18.14024785253259,44,13,31,29.545454545454547,13,1,31,17,17,8,32,Crystal Palace,30,England - Premier League
247,John Michael Nchekwube Obinna,1226,1115.0,111,90.94616639477977,112,78,34,69.64285714285714,942,908,34,96.39065817409767,60,26,34,43.333333333333336,16.768794272839283,3,0,3,0.0,4,1,18,15,3,2,15,Chelsea,25,England - Premier League
248,John O''Shea,611,448.0,163,73.32242225859247,94,34,60,36.17021276595745,267,259,8,97.00374531835206,118,35,83,29.66101694915254,22.80386912205659,1,0,1,0.0,1,0,1,1,0,0,12,Sunderland,28,England - Premier League
249,John Ruddy,905,504.0,401,55.69060773480663,159,44,115,27.67295597484277,163,162,1,99.38650306748467,601,210,391,34.94176372712147,47.96000035111929,0,0,0,0.0,0,0,1,1,0,0,2,Norwich City,27,England - Premier League
250,John Stones,1596,1414.0,182,88.59649122807018,132,79,53,59.84848484848485,1092,1045,47,95.6959706959707,116,47,69,40.51724137931034,20.416731007979095,6,2,4,33.33333333333333,4,0,18,11,2,0,31,Everton,33,England - Premier League
251,John Terry,933,853.0,80,91.42550911039658,49,24,25,48.97959183673469,609,601,8,98.68637110016421,40,15,25,37.5,17.846998942256718,0,0,0,0.0,3,0,3,1,2,0,6,Chelsea,24,England - Premier League
252,Joleon Lescott,1043,828.0,215,79.38638542665389,123,59,64,47.96747967479675,532,501,31,94.17293233082707,163,71,92,43.558282208588956,20.8769989831483,4,2,2,50.0,4,0,10,9,2,2,8,Aston Villa,32,England - Premier League
253,Jon Flanagan,303,249.0,54,82.17821782178217,26,14,12,53.84615384615385,206,189,17,91.74757281553399,17,3,14,17.647058823529413,15.989852066233665,4,1,3,25.0,1,1,4,2,1,1,4,Liverpool,5,England - Premier League
254,Jonas Olsson,575,399.0,176,69.3913043478261,114,45,69,39.473684210526315,230,214,16,93.04347826086956,145,47,98,32.41379310344827,24.59062345871833,0,0,0,0.0,3,1,3,2,1,0,8,West Bromwich Albion,28,England - Premier League
255,Jonathan Grant Evans,1101,796.0,305,72.29791099000909,196,90,106,45.91836734693878,476,431,45,90.54621848739495,207,83,124,40.09661835748793,22.447576473909972,19,9,10,47.368421052631575,5,1,22,17,4,3,20,West Bromwich Albion,30,England - Premier League
256,Jonathan Howson,1338,999.0,339,74.66367713004485,197,101,96,51.26903553299492,801,707,94,88.26466916354558,111,34,77,30.630630630630627,17.241218584658206,27,8,19,29.629629629629626,27,4,53,33,19,8,24,Norwich City,36,England - Premier League
257,Jonathan Leko,55,40.0,15,72.72727272727273,5,2,3,40.0,44,39,5,88.63636363636364,3,0,3,0.0,16.904405529242183,3,1,2,33.33333333333333,1,1,21,12,15,7,4,West Bromwich Albion,5,England - Premier League
258,Jonathan Walters,537,343.0,194,63.87337057728119,52,27,25,51.92307692307693,258,225,33,87.20930232558139,27,9,18,33.33333333333333,14.60925459910257,27,5,22,18.51851851851852,19,2,34,16,17,7,26,Stoke City,27,England - Premier League
259,Jonathan Williams,5,5.0,0,100.0,0,0,0,0.0,4,4,0,100.0,0,0,0,0.0,14.336176163760001,0,0,0,0.0,0,0,0,0,0,0,0,Crystal Palace,1,England - Premier League
260,Jonjo Shelvey,1593,1231.0,362,77.27558066541117,302,179,123,59.27152317880795,797,739,58,92.72271016311167,312,137,175,43.91025641025641,23.672246540830738,41,10,31,24.390243902439025,39,4,52,37,17,11,12,Swansea City,30,England - Premier League
261,Jonjoe Kenny,32,23.0,9,71.875,2,1,1,50.0,13,11,2,84.61538461538461,3,0,3,0.0,16.639013359575,1,1,0,100.0,0,0,0,0,0,0,0,Everton,1,England - Premier League
262,Jordan Amavi,529,398.0,131,75.23629489603024,42,29,13,69.04761904761905,239,214,25,89.5397489539749,57,18,39,31.57894736842105,18.065904380431757,34,8,26,23.52941176470588,6,2,49,18,29,6,14,Aston Villa,10,England - Premier League
263,Jordan Ayew,824,647.0,177,78.51941747572816,55,33,22,60.0,574,507,67,88.32752613240417,26,9,17,34.61538461538461,14.163619289251544,42,9,33,21.428571428571427,14,0,158,85,85,45,49,Aston Villa,30,England - Premier League
264,Jordan Brian Henderson,1007,780.0,227,77.45779543197617,171,110,61,64.32748538011695,563,520,43,92.36234458259325,136,64,72,47.05882352941176,20.252588165488635,32,9,23,28.125,16,2,22,12,8,3,12,Liverpool,17,England - Premier League
265,Jordan Lyden,72,59.0,13,81.94444444444444,7,4,3,57.14285714285714,49,43,6,87.75510204081633,7,4,3,57.14285714285714,18.59015262023,2,0,2,0.0,1,0,1,1,0,0,2,Aston Villa,4,England - Premier League
266,Jordan Pickford,78,30.0,48,38.46153846153847,31,10,21,32.25806451612903,5,5,0,100.0,70,22,48,31.428571428571427,61.00369370132308,0,0,0,0.0,0,0,0,0,0,0,1,Sunderland,2,England - Premier League
267,Jordan Rossiter,6,4.0,2,66.66666666666666,0,0,0,0.0,4,4,0,100.0,0,0,0,0.0,10.06914601356,0,0,0,0.0,0,0,0,0,0,0,0,Liverpool,1,England - Premier League
268,Jordan Veretout,1090,854.0,236,78.34862385321101,150,107,43,71.33333333333334,703,635,68,90.3271692745377,122,42,80,34.42622950819672,18.543075076708842,40,13,27,32.5,35,5,14,11,3,2,28,Aston Villa,25,England - Premier League
269,Jordi Amat Maas,185,145.0,40,78.37837837837837,14,6,8,42.857142857142854,112,105,7,93.75,16,3,13,18.75,20.109251356645622,1,0,1,0.0,0,0,2,2,0,0,3,Swansea City,8,England - Premier League
270,Jordi Gómez García-Penche,173,143.0,30,82.65895953757226,29,16,13,55.172413793103445,96,92,4,95.83333333333334,16,5,11,31.25,17.45826730083468,3,1,2,33.33333333333333,3,0,2,2,1,1,5,Sunderland,5,England - Premier League
271,Jordon Ibe,559,442.0,117,79.06976744186046,40,35,5,87.5,394,348,46,88.3248730964467,35,11,24,31.428571428571427,15.335518622039356,31,8,23,25.806451612903224,18,1,77,44,44,27,17,Liverpool,27,England - Premier League
272,Jordon Mutch,357,253.0,104,70.86834733893558,35,18,17,51.42857142857142,190,173,17,91.05263157894737,50,15,35,30.0,17.893291173045377,21,4,17,19.047619047619047,7,0,16,12,6,4,11,Crystal Palace,20,England - Premier League
273,Jordy Clasie,828,665.0,163,80.31400966183575,121,67,54,55.371900826446286,479,445,34,92.90187891440502,107,56,51,52.336448598130836,19.405399465233042,9,2,7,22.22222222222222,10,0,11,6,2,2,9,Southampton,22,England - Premier League
274,Josh Onomah,49,32.0,17,65.3061224489796,4,4,0,100.0,35,29,6,82.85714285714286,5,2,3,40.0,14.379567612435919,7,1,6,14.285714285714285,0,0,4,2,4,2,1,Tottenham Hotspur,8,England - Premier League
275,Joshua King,457,338.0,119,73.96061269146608,29,14,15,48.275862068965516,303,247,56,81.51815181518151,8,3,5,37.5,12.500208803031597,23,8,15,34.78260869565217,21,2,103,57,64,35,31,AFC Bournemouth,31,England - Premier League
276,José Holebas,531,386.0,145,72.69303201506591,67,33,34,49.25373134328358,247,220,27,89.06882591093117,81,34,47,41.9753086419753,17.71399019500339,17,4,13,23.52941176470588,7,0,35,17,18,6,5,Watford,11,England - Premier League
277,José Leonardo Ulloa,396,280.0,116,70.70707070707071,37,19,18,51.35135135135135,208,177,31,85.09615384615384,11,3,8,27.27272727272727,12.221045035774546,7,2,5,28.57142857142857,9,1,30,17,17,12,19,Leicester City,29,England - Premier League
278,José Luis Sanmartín Mato,376,268.0,108,71.27659574468085,35,14,21,40.0,175,146,29,83.42857142857143,17,8,9,47.05882352941176,13.997651426708934,12,5,7,41.66666666666667,8,1,25,10,16,7,21,Stoke City,22,England - Premier League
279,José Manuel Jurado Marín,1035,831.0,204,80.28985507246377,98,70,28,71.42857142857143,719,643,76,89.4297635605007,73,29,44,39.726027397260275,15.383856462096,34,10,24,29.411764705882355,39,0,86,52,33,19,44,Watford,27,England - Premier League
280,José Miguel da Rocha Fonte,1642,1375.0,267,83.73934226552984,190,103,87,54.21052631578947,905,880,25,97.23756906077348,223,99,124,44.39461883408072,22.058136842782364,7,3,4,42.857142857142854,5,0,4,4,0,0,12,Southampton,37,England - Premier League
281,José Ramiro Funes Mori,1299,1085.0,214,83.52578906851424,133,75,58,56.390977443609025,785,756,29,96.30573248407643,179,78,101,43.575418994413404,21.45934470481829,3,0,3,0.0,5,0,11,5,2,0,12,Everton,28,England - Premier League
282,José Salomón Rondón Giménez,662,424.0,238,64.04833836858006,63,19,44,30.158730158730158,297,249,48,83.83838383838383,27,15,12,55.55555555555556,13.280380149127977,26,8,18,30.76923076923077,24,2,44,21,28,15,40,West Bromwich Albion,34,England - Premier League
283,José Ángel Crespo Rincón,30,27.0,3,90.0,2,2,0,100.0,14,14,0,100.0,5,5,0,100.0,19.380510910224,0,0,0,0.0,0,0,0,0,0,0,1,Aston Villa,1,England - Premier League
284,João Carlos Vilaça Teixeira,3,3.0,0,100.0,0,0,0,0.0,2,2,0,100.0,0,0,0,0.0,11.132932593120001,0,0,0,0.0,0,0,0,0,0,0,0,Liverpool,1,England - Premier League
285,Juan Carlos Paredes Reasco,380,256.0,124,67.36842105263158,59,29,30,49.152542372881356,153,129,24,84.31372549019608,57,22,35,38.59649122807017,18.872308202208632,23,6,17,26.08695652173913,3,0,14,7,7,3,9,Watford,17,England - Premier League
286,Juan Guillermo Cuadrado Bello,11,9.0,2,81.81818181818183,0,0,0,0.0,5,4,1,80.0,1,0,1,0.0,18.476908747265455,1,0,1,0.0,0,0,0,0,0,0,2,Chelsea,1,England - Premier League
287,Juan Manuel Iturbe Arévalo,27,19.0,8,70.37037037037037,4,4,0,100.0,18,14,4,77.77777777777779,1,1,0,100.0,14.592635185173334,0,0,0,0.0,1,0,4,3,3,2,1,AFC Bournemouth,2,England - Premier League
288,Juan Manuel Mata García,1914,1634.0,280,85.37095088819227,176,136,40,77.27272727272727,1325,1237,88,93.35849056603773,153,71,82,46.40522875816993,16.773184007412603,52,10,42,19.230769230769234,46,5,61,40,26,12,41,Manchester United,38,England - Premier League
289,Juan Miguel Jiménez López,51,40.0,11,78.43137254901961,2,0,2,0.0,33,30,3,90.9090909090909,1,0,1,0.0,14.85985058922353,2,0,2,0.0,3,0,4,3,2,2,5,Southampton,12,England - Premier League
290,Julián Speroni,68,41.0,27,60.29411764705882,7,3,4,42.857142857142854,15,15,0,100.0,49,23,26,46.93877551020408,45.56625340928823,0,0,0,0.0,0,0,0,0,0,0,0,Crystal Palace,2,England - Premier League
291,Junior Stanislas,776,547.0,229,70.4896907216495,59,37,22,62.71186440677966,523,426,97,81.45315487571702,83,24,59,28.915662650602407,16.15759877407268,43,15,28,34.883720930232556,31,2,62,34,25,15,16,AFC Bournemouth,21,England - Premier League
292,Karl Darlow,246,119.0,127,48.3739837398374,54,21,33,38.88888888888889,29,29,0,100.0,192,69,123,35.9375,51.140290710286834,0,0,0,0.0,0,0,0,0,0,0,1,Newcastle United,9,England - Premier League
293,Kasper Schmeichel,1220,477.0,743,39.09836065573771,497,103,394,20.72434607645875,76,76,0,100.0,1029,298,731,28.960155490767736,57.97589977988557,0,0,0,0.0,6,0,1,1,0,0,1,Leicester City,38,England - Premier League
294,Kelechi Promise Iheanacho,349,268.0,81,76.79083094555874,29,14,15,48.275862068965516,250,211,39,84.39999999999999,8,2,6,25.0,12.966660257165845,10,5,5,50.0,12,1,17,15,14,12,6,Manchester City,26,England - Premier League
295,Kelvin Davis,29,14.0,15,48.275862068965516,0,0,0,0.0,9,8,1,88.88888888888889,17,3,14,17.647058823529413,41.069626019255175,0,0,0,0.0,0,0,0,0,0,0,0,Southampton,1,England - Premier League
296,Kevin De Bruyne,1314,946.0,368,71.99391171993912,130,89,41,68.46153846153847,864,699,165,80.90277777777779,142,64,78,45.07042253521127,17.402063922717204,89,24,65,26.96629213483146,69,9,73,43,36,19,23,Manchester City,25,England - Premier League
297,Kevin Linford Stewart,466,408.0,58,87.55364806866953,46,27,19,58.69565217391305,335,320,15,95.52238805970148,36,18,18,50.0,17.733454355154592,0,0,0,0.0,3,0,10,7,3,2,18,Liverpool,7,England - Premier League
298,Kevin Mbabu,56,30.0,26,53.57142857142857,7,3,4,42.857142857142854,18,14,4,77.77777777777779,12,4,8,33.33333333333333,23.098442136235715,2,0,2,0.0,1,0,4,3,3,2,2,Newcastle United,3,England - Premier League
299,Kevin Mirallas,382,296.0,86,77.4869109947644,39,25,14,64.1025641025641,230,209,21,90.8695652173913,48,15,33,31.25,18.411250739645027,24,5,19,20.833333333333336,14,2,37,21,22,11,21,Everton,23,England - Premier League
300,Kevin Nolan,14,13.0,1,92.85714285714286,1,0,1,0.0,11,11,0,100.0,1,0,1,0.0,14.53623343554857,0,0,0,0.0,0,0,1,1,0,0,0,West Ham United,2,England - Premier League
301,Kevin Toner,125,92.0,33,73.6,21,8,13,38.095238095238095,58,54,4,93.10344827586206,17,4,13,23.52941176470588,19.84956044133312,2,1,1,50.0,0,1,1,0,1,0,4,Aston Villa,4,England - Premier League
302,Kevin Wimmer,543,487.0,56,89.68692449355433,45,29,16,64.44444444444444,345,334,11,96.81159420289856,52,26,26,50.0,21.495119391779006,0,0,0,0.0,1,0,0,0,0,0,3,Tottenham Hotspur,10,England - Premier League
303,Kieran Gibbs,219,163.0,56,74.42922374429224,24,15,9,62.5,132,122,10,92.42424242424242,20,4,16,20.0,16.928032565487122,5,1,4,20.0,1,0,11,4,7,3,5,Arsenal,15,England - Premier League
304,Kieran O''Neill Dowell,35,25.0,10,71.42857142857143,4,2,2,50.0,19,16,3,84.21052631578947,4,1,3,25.0,15.870125848566857,4,0,4,0.0,1,0,5,2,0,0,0,Everton,2,England - Premier League
305,Kieran Richardson,347,260.0,87,74.92795389048992,29,18,11,62.06896551724138,160,149,11,93.125,35,13,22,37.142857142857146,16.901221761088184,16,4,12,25.0,3,2,12,8,4,2,3,Aston Villa,11,England - Premier League
306,Kieran Trippier,355,252.0,103,70.98591549295776,40,21,19,52.5,155,142,13,91.61290322580645,50,15,35,30.0,18.976060747878083,28,7,21,25.0,5,1,7,2,3,0,11,Tottenham Hotspur,6,England - Premier League
307,Kolo Habib Touré,457,384.0,73,84.02625820568927,41,15,26,36.58536585365854,321,302,19,94.0809968847352,45,9,36,20.0,20.095691843535754,1,0,1,0.0,1,0,5,4,2,1,3,Liverpool,14,England - Premier League
308,Kristoffer Nordfeldt,29,23.0,6,79.3103448275862,2,1,1,50.0,8,8,0,100.0,16,10,6,62.5,43.1457812145931,0,0,0,0.0,0,0,0,0,0,0,0,Swansea City,1,England - Premier League
309,Kurt Happy Zouma,736,610.0,126,82.88043478260869,49,17,32,34.69387755102041,436,424,12,97.24770642201835,64,17,47,26.5625,20.83398118936337,4,1,3,25.0,0,0,8,4,1,1,9,Chelsea,23,England - Premier League
310,Kyle Bartley,139,108.0,31,77.6978417266187,11,3,8,27.27272727272727,75,70,5,93.33333333333333,16,5,11,31.25,21.713742627617265,0,0,0,0.0,0,0,1,1,0,0,5,Swansea City,5,England - Premier League
311,Kyle Lafferty,7,4.0,3,57.14285714285714,0,0,0,0.0,1,1,0,100.0,0,0,0,0.0,13.790224199314286,0,0,0,0.0,0,0,0,0,0,0,0,Norwich City,1,England - Premier League
312,Kyle Naughton,1388,1082.0,306,77.95389048991355,172,96,76,55.81395348837209,710,666,44,93.80281690140845,133,47,86,35.338345864661655,17.953716246332164,39,11,28,28.205128205128204,16,3,22,11,6,2,22,Swansea City,27,England - Premier League
313,Kyle Walker,1732,1315.0,417,75.92378752886836,215,129,86,60.0,802,722,80,90.02493765586036,256,111,145,43.359375,20.651584037775795,64,22,42,34.375,32,2,48,20,22,8,33,Tottenham Hotspur,33,England - Premier League
314,Lamine Koné,405,260.0,145,64.19753086419753,89,22,67,24.719101123595504,179,164,15,91.62011173184358,101,19,82,18.81188118811881,24.540436575224888,2,1,1,50.0,2,1,5,4,3,3,6,Sunderland,15,England - Premier League
315,Laurent Koscielny,1671,1458.0,213,87.25314183123878,169,99,70,58.57988165680473,1049,1008,41,96.09151572926596,130,51,79,39.23076923076923,20.468284149762443,2,0,2,0.0,9,0,8,5,1,0,26,Arsenal,33,England - Premier League
316,Leandro Bacuna,1389,1034.0,355,74.44204463642909,189,98,91,51.85185185185185,680,626,54,92.05882352941175,221,83,138,37.55656108597285,20.455987826218315,53,12,41,22.641509433962266,17,0,52,29,16,8,15,Aston Villa,31,England - Premier League
317,Lee Cattermole,970,729.0,241,75.15463917525773,180,89,91,49.44444444444444,509,454,55,89.19449901768172,137,58,79,42.33576642335766,20.276685603750433,8,3,5,37.5,20,0,19,14,6,4,20,Sunderland,31,England - Premier League
318,Lee Tomlin,122,84.0,38,68.85245901639344,13,4,9,30.76923076923077,82,67,15,81.70731707317073,8,2,6,25.0,14.655481389395408,0,0,0,0.0,7,0,9,4,6,2,9,AFC Bournemouth,6,England - Premier League
319,Leighton Baines,1023,793.0,230,77.51710654936461,118,79,39,66.94915254237289,541,502,39,92.79112754158965,146,55,91,37.67123287671233,19.46156942724739,55,12,43,21.818181818181817,20,1,16,8,6,1,20,Everton,18,England - Premier League
320,Leon Britton,1002,884.0,118,88.22355289421158,104,80,24,76.92307692307693,735,695,40,94.5578231292517,15,7,8,46.666666666666664,16.24148695234994,2,0,2,0.0,4,0,21,16,6,3,22,Swansea City,25,England - Premier League
321,Leon Osman,152,124.0,28,81.57894736842105,12,9,3,75.0,123,109,14,88.6178861788618,4,2,2,50.0,14.519547861906316,3,1,2,33.33333333333333,0,0,3,1,1,0,6,Everton,9,England - Premier League
322,Leroy Fer,435,369.0,66,84.82758620689656,69,43,26,62.31884057971014,280,264,16,94.28571428571428,23,12,11,52.17391304347826,18.33183370189738,0,0,0,0.0,6,2,19,12,6,4,18,Swansea City,11,England - Premier League
323,Lewis Grabban,327,274.0,53,83.79204892966361,24,17,7,70.83333333333334,247,219,28,88.66396761133603,10,4,6,40.0,13.72682906946275,9,3,6,33.33333333333333,7,0,25,13,13,6,5,AFC Bournemouth,21,England - Premier League
324,Libor Kozák,73,46.0,27,63.013698630136986,6,3,3,50.0,24,20,4,83.33333333333334,1,0,1,0.0,12.311459807217533,1,0,1,0.0,3,0,3,1,3,1,3,Aston Villa,4,England - Premier League
325,Loïc Rémy,103,87.0,16,84.46601941747572,6,6,0,100.0,74,68,6,91.8918918918919,3,2,1,66.66666666666666,12.54928453796272,5,1,4,20.0,3,0,9,8,5,4,6,Chelsea,13,England - Premier League
326,Lucas Pezzini Leiva,1478,1239.0,239,83.82949932341002,189,131,58,69.31216931216932,907,859,48,94.70782800441015,79,29,50,36.708860759493675,19.648773815211523,4,0,4,0.0,20,1,20,16,5,4,21,Liverpool,27,England - Premier League
327,Luis Antonio Valencia Mosquera,709,605.0,104,85.33145275035261,59,42,17,71.1864406779661,450,421,29,93.55555555555556,48,20,28,41.66666666666667,15.895700729807052,28,12,16,42.857142857142854,5,3,26,22,14,11,8,Manchester United,14,England - Premier League
328,Luke Shaw,351,291.0,60,82.90598290598291,36,24,12,66.66666666666666,202,185,17,91.58415841584159,19,11,8,57.89473684210527,16.795409728574356,10,5,5,50.0,3,1,7,6,2,1,3,Manchester United,5,England - Premier League
329,Maarten Stekelenburg,467,289.0,178,61.88436830835118,83,21,62,25.301204819277107,149,149,0,100.0,274,102,172,37.22627737226277,45.139218556673065,0,0,0,0.0,1,0,0,0,0,0,2,Southampton,17,England - Premier League
330,Mamadou Obbi Oularé,3,2.0,1,66.66666666666666,0,0,0,0.0,0,0,0,0.0,0,0,0,0.0,10.94407400208,0,0,0,0.0,0,0,0,0,0,0,0,Watford,2,England - Premier League
331,Mamadou Sakho,1244,1092.0,152,87.78135048231512,107,72,35,67.28971962616822,841,807,34,95.95719381688465,78,36,42,46.15384615384615,18.886132134553893,0,0,0,0.0,4,0,3,3,0,0,16,Liverpool,22,England - Premier League
332,Mame Biram Diouf,272,199.0,73,73.16176470588235,22,8,14,36.36363636363637,137,124,13,90.51094890510949,18,7,11,38.88888888888889,14.557122075521912,5,1,4,20.0,7,1,21,12,10,4,28,Stoke City,26,England - Premier League
333,Manuel García Alonso,19,19.0,0,100.0,1,1,0,100.0,14,14,0,100.0,1,1,0,100.0,17.79912678179368,0,0,0,0.0,0,0,0,0,0,0,0,Manchester City,1,England - Premier League
334,Manuel Lanzini,1119,969.0,150,86.59517426273459,102,74,28,72.54901960784314,829,768,61,92.64173703256937,56,27,29,48.214285714285715,15.570563815463164,24,10,14,41.66666666666667,32,2,86,51,40,22,39,West Ham United,26,England - Premier League
335,Marc Albrighton,1214,671.0,543,55.271828665568364,223,94,129,42.152466367713004,497,415,82,83.5010060362173,326,91,235,27.914110429447852,21.281698260517757,142,32,110,22.535211267605636,55,7,100,61,56,29,32,Leicester City,38,England - Premier League
336,Marc Muniesa Martínez,558,458.0,100,82.07885304659499,60,35,25,58.333333333333336,325,308,17,94.76923076923077,58,17,41,29.310344827586203,19.79582616424774,10,2,8,20.0,4,0,12,6,5,1,7,Stoke City,15,England - Premier League
337,Marc Pugh,555,407.0,148,73.33333333333333,39,32,7,82.05128205128204,372,322,50,86.55913978494624,44,21,23,47.72727272727273,15.041108077359569,32,10,22,31.25,12,2,60,28,34,16,28,AFC Bournemouth,26,England - Premier League
338,Marc Wilson,113,86.0,27,76.10619469026548,17,6,11,35.294117647058826,53,51,2,96.22641509433963,20,6,14,30.0,27.017814261268672,1,1,0,100.0,1,0,2,1,0,0,3,Stoke City,4,England - Premier League
339,Marcin Ryszard Wasilewski,79,58.0,21,73.41772151898735,11,4,7,36.36363636363637,38,38,0,100.0,14,5,9,35.714285714285715,19.635025740753417,0,0,0,0.0,0,0,0,0,0,0,0,Leicester City,4,England - Premier League
340,Marco van Ginkel,387,308.0,79,79.58656330749353,67,43,24,64.17910447761194,247,227,20,91.90283400809717,36,17,19,47.22222222222222,17.729346092057675,5,0,5,0.0,5,0,9,5,3,3,11,Stoke City,17,England - Premier League
341,Marcus Rashford,209,155.0,54,74.16267942583733,6,4,2,66.66666666666666,158,123,35,77.84810126582279,2,0,2,0.0,11.69192536837665,8,0,8,0.0,5,3,36,13,29,11,10,Manchester United,11,England - Premier League
342,Mario Suárez Mata,427,340.0,87,79.62529274004683,78,50,28,64.1025641025641,272,245,27,90.07352941176471,37,16,21,43.24324324324324,18.890090052786885,2,1,1,50.0,6,0,11,8,5,4,5,Watford,15,England - Premier League
343,Mark Bunn,270,131.0,139,48.51851851851852,58,19,39,32.758620689655174,30,30,0,100.0,220,84,136,38.18181818181819,50.865244679941334,0,0,0,0.0,0,0,0,0,0,0,0,Aston Villa,10,England - Premier League
344,Mark Noble,1943,1662.0,281,85.53782810087493,285,189,96,66.3157894736842,1183,1116,67,94.33643279797126,193,108,85,55.95854922279793,18.633486624911406,16,8,8,50.0,43,4,40,28,9,7,60,West Ham United,37,England - Premier League
345,Marko Arnautović,1161,895.0,266,77.08871662360033,93,50,43,53.76344086021505,819,697,122,85.1037851037851,66,28,38,42.42424242424242,15.960207888527751,47,16,31,34.04255319148936,44,6,134,77,65,34,33,Stoke City,34,England - Premier League
346,Marouane Chamakh,91,72.0,19,79.12087912087912,12,6,6,50.0,52,45,7,86.53846153846155,1,0,1,0.0,12.019890380645275,1,0,1,0.0,4,0,4,1,2,0,5,Crystal Palace,10,England - Premier League
347,Marouane Fellaini-Bakkioui,601,494.0,107,82.19633943427621,54,36,18,66.66666666666666,381,351,30,92.1259842519685,13,4,9,30.76923076923077,15.263691445865291,2,1,1,50.0,10,0,21,12,8,4,15,Manchester United,18,England - Premier League
348,Martin Kelly,540,393.0,147,72.77777777777777,67,35,32,52.23880597014925,236,208,28,88.13559322033898,73,18,55,24.65753424657534,18.027551869301334,13,2,11,15.384615384615385,3,0,6,4,1,1,3,Crystal Palace,13,England - Premier League
349,Martin Olsson,723,446.0,277,61.68741355463347,107,36,71,33.64485981308411,235,205,30,87.2340425531915,131,29,102,22.137404580152673,20.23363790999104,50,13,37,26.0,6,2,16,6,12,3,20,Norwich City,24,England - Premier League
350,Martin Škrtel,1146,1005.0,141,87.69633507853402,80,36,44,45.0,740,732,8,98.91891891891892,92,31,61,33.69565217391305,20.55132346709906,1,1,0,100.0,5,0,2,2,0,0,6,Liverpool,22,England - Premier League
351,Martín Gastón Demichelis,567,488.0,79,86.06701940035273,62,44,18,70.96774193548387,378,366,12,96.82539682539682,33,14,19,42.42424242424242,18.843633661803175,0,0,0,0.0,4,0,6,5,1,1,8,Manchester City,20,England - Premier League
352,Marvin Emnes,15,9.0,6,60.0,1,1,0,100.0,10,7,3,70.0,0,0,0,0.0,10.97418644376,1,0,1,0.0,0,0,4,2,1,0,0,Swansea City,2,England - Premier League
353,Massadio Haïdara,319,248.0,71,77.74294670846395,33,21,12,63.63636363636363,176,161,15,91.47727272727273,27,6,21,22.22222222222222,16.44586891023047,8,3,5,37.5,3,0,9,6,3,1,10,Newcastle United,7,England - Premier League
354,Mathieu Debuchy,101,74.0,27,73.26732673267327,22,18,4,81.81818181818183,41,39,2,95.1219512195122,10,1,9,10.0,16.870940223754456,3,0,3,0.0,1,0,3,1,2,0,1,Arsenal,2,England - Premier League
355,Mathieu Flamini,627,548.0,79,87.40031897926634,83,64,19,77.10843373493977,427,406,21,95.08196721311475,28,11,17,39.285714285714285,16.393847218754065,2,1,1,50.0,4,0,5,2,1,0,8,Arsenal,16,England - Premier League
356,Matt Grimes,46,34.0,12,73.91304347826086,7,4,3,57.14285714285714,33,30,3,90.9090909090909,5,1,4,20.0,18.94708748967652,1,0,1,0.0,1,0,0,0,0,0,1,Swansea City,1,England - Premier League
357,Matt Jarvis,367,237.0,130,64.57765667574932,21,12,9,57.14285714285714,187,157,30,83.9572192513369,50,16,34,32.0,16.62485143455368,51,12,39,23.52941176470588,14,1,15,9,11,5,8,Norwich City,22,England - Premier League
358,Matt Miazga,88,72.0,16,81.81818181818183,7,1,6,14.285714285714285,55,54,1,98.18181818181819,8,1,7,12.5,22.215581465023636,0,0,0,0.0,0,0,0,0,0,0,2,Chelsea,2,England - Premier League
359,Matt Ritchie,1675,1176.0,499,70.2089552238806,190,92,98,48.421052631578945,912,785,127,86.07456140350878,261,98,163,37.547892720306514,19.406863629726704,89,25,64,28.08988764044944,35,6,49,26,26,10,62,AFC Bournemouth,37,England - Premier League
360,Matt Targett,555,412.0,143,74.23423423423424,67,44,23,65.67164179104478,251,225,26,89.64143426294821,70,38,32,54.285714285714285,18.47795746572065,27,11,16,40.74074074074074,4,1,5,3,2,1,13,Southampton,14,England - Premier League
361,Matteo Darmian,1157,908.0,249,78.47882454624028,123,78,45,63.41463414634146,639,580,59,90.76682316118936,97,24,73,24.742268041237114,17.475426274716714,39,12,27,30.76923076923077,11,0,19,10,12,5,23,Manchester United,28,England - Premier League
362,Matthew Pennington,172,147.0,25,85.46511627906976,13,8,5,61.53846153846154,116,113,3,97.41379310344827,10,2,8,20.0,17.729268306802325,1,0,1,0.0,0,0,1,1,1,1,1,Everton,4,England - Premier League
363,Mauro Matías Zárate,336,249.0,87,74.10714285714286,21,16,5,76.19047619047619,191,167,24,87.43455497382199,46,16,30,34.78260869565217,16.887148393529998,22,7,15,31.818181818181817,17,0,47,26,27,14,23,West Ham United,15,England - Premier League
364,Max-Alain Gradel,339,224.0,115,66.07669616519173,18,5,13,27.77777777777778,214,177,37,82.71028037383178,46,16,30,34.78260869565217,16.6878479293954,27,6,21,22.22222222222222,8,2,45,20,34,15,26,AFC Bournemouth,14,England - Premier League
365,Maya Yoshida,567,441.0,126,77.77777777777779,71,29,42,40.845070422535215,281,269,12,95.72953736654804,88,31,57,35.22727272727273,21.816278518377143,4,1,3,25.0,2,0,8,6,1,0,7,Southampton,20,England - Premier League
366,Memphis Depay,751,547.0,204,72.83621837549934,47,27,20,57.446808510638306,478,409,69,85.56485355648536,71,23,48,32.3943661971831,15.640966492324154,63,11,52,17.46031746031746,12,0,66,33,53,26,39,Manchester United,29,England - Premier League
367,Mesut Özil,2511,2050.0,461,81.64078056551175,279,209,70,74.91039426523297,1746,1561,185,89.40435280641466,274,132,142,48.175182481751825,16.015137953136346,89,43,46,48.31460674157304,123,19,92,54,37,25,53,Arsenal,35,England - Premier League
368,Micah Richards,783,654.0,129,83.5249042145594,72,47,25,65.27777777777779,450,435,15,96.66666666666667,64,27,37,42.1875,18.464595592609655,2,1,1,50.0,6,1,30,22,8,3,31,Aston Villa,24,England - Premier League
369,Michael Carrick,1562,1353.0,209,86.61971830985915,287,215,72,74.91289198606272,1008,950,58,94.24603174603175,137,73,64,53.284671532846716,19.91047544509598,6,3,3,50.0,8,0,12,7,1,0,19,Manchester United,27,England - Premier League
370,Michail Antonio,708,460.0,248,64.97175141242938,69,32,37,46.3768115942029,312,252,60,80.76923076923077,125,51,74,40.8,19.04153159217051,56,17,39,30.357142857142854,19,3,94,59,56,32,37,West Ham United,26,England - Premier League
371,Michel Vorm,49,47.0,2,95.91836734693877,0,0,0,0.0,32,32,0,100.0,6,4,2,66.66666666666666,25.599275087289794,0,0,0,0.0,0,0,0,0,0,0,0,Tottenham Hotspur,1,England - Premier League
372,Miguel Arturo Layún Prado,60,45.0,15,75.0,1,1,0,100.0,42,37,5,88.09523809523809,4,1,3,25.0,14.605320623184001,6,1,5,16.666666666666664,2,0,4,4,1,1,1,Watford,3,England - Premier League
373,Miguel Ángel Britos Cabrera,772,529.0,243,68.52331606217616,144,50,94,34.72222222222222,303,294,9,97.02970297029702,221,76,145,34.38914027149321,25.384263659205388,1,1,0,100.0,0,0,8,7,0,0,18,Watford,24,England - Premier League
374,Mikel Arteta Amatriain,128,113.0,15,88.28125,16,11,5,68.75,79,78,1,98.73417721518987,6,3,3,50.0,17.551989127996876,0,0,0,0.0,1,0,2,1,1,0,7,Arsenal,9,England - Premier League
375,Mile Jedinak,828,604.0,224,72.94685990338165,130,66,64,50.76923076923077,344,317,27,92.15116279069767,85,32,53,37.64705882352941,18.808847368149564,8,3,5,37.5,9,0,6,5,0,0,19,Crystal Palace,27,England - Premier League
376,Modibo Maïga,12,5.0,7,41.66666666666667,0,0,0,0.0,5,3,2,60.0,0,0,0,0.0,12.1474445646,2,0,2,0.0,0,0,5,4,4,3,1,West Ham United,3,England - Premier League
377,Modou Barrow,235,172.0,63,73.19148936170212,9,4,5,44.44444444444444,162,138,24,85.18518518518519,17,3,14,17.647058823529413,14.743855094789106,25,8,17,32.0,12,3,51,30,38,21,27,Swansea City,22,England - Premier League
378,Mohamed Naser Elsayed Elneny,744,685.0,59,92.06989247311827,78,64,14,82.05128205128204,579,560,19,96.71848013816926,34,17,17,50.0,16.29038634363387,3,0,3,0.0,2,1,8,4,3,0,13,Arsenal,11,England - Premier League
379,Morgan Schneiderlin,1484,1321.0,163,89.01617250673854,175,132,43,75.42857142857143,1010,975,35,96.53465346534654,104,62,42,59.61538461538461,17.736787915017818,5,0,5,0.0,9,0,26,19,6,5,18,Manchester United,29,England - Premier League
380,Mousa Sidi Yaya Dembélé,1383,1238.0,145,89.51554591467824,137,110,27,80.2919708029197,1064,1006,58,94.54887218045113,20,5,15,25.0,15.796445353309847,5,1,4,20.0,25,1,101,81,36,26,48,Tottenham Hotspur,29,England - Premier League
381,Moussa Sissoko,1576,1142.0,434,72.46192893401016,167,95,72,56.886227544910184,966,802,164,83.02277432712215,110,54,56,49.09090909090909,15.403543195693704,114,45,69,39.473684210526315,50,7,148,78,60,31,38,Newcastle United,37,England - Premier League
382,Muhamed Bešić,352,300.0,52,85.22727272727273,26,18,8,69.23076923076923,254,227,27,89.37007874015748,20,13,7,65.0,17.719097261240453,3,1,2,33.33333333333333,4,0,16,11,5,4,3,Everton,12,England - Premier League
383,N''Golo Kanté,1476,1202.0,274,81.43631436314364,169,121,48,71.59763313609467,934,847,87,90.68522483940042,85,42,43,49.411764705882355,15.985876545501464,20,10,10,50.0,24,3,63,48,19,14,30,Leicester City,37,England - Premier League
384,Nabil Bentaleb,100,78.0,22,78.0,14,8,6,57.14285714285714,67,60,7,89.55223880597015,9,2,7,22.22222222222222,18.8559693708408,0,0,0,0.0,2,0,5,4,1,1,1,Tottenham Hotspur,5,England - Premier League
385,Nacer Chadli,388,315.0,73,81.18556701030928,30,23,7,76.66666666666667,260,239,21,91.92307692307692,17,9,8,52.94117647058824,14.516913043709073,11,4,7,36.36363636363637,19,2,34,13,25,9,8,Tottenham Hotspur,28,England - Premier League
386,Nathan Aké,905,615.0,290,67.95580110497238,116,62,54,53.44827586206896,349,313,36,89.68481375358166,93,30,63,32.25806451612903,17.327561909167372,22,5,17,22.727272727272727,7,0,12,7,4,2,12,Watford,24,England - Premier League
387,Nathan Dyer,90,67.0,23,74.44444444444444,12,5,7,41.66666666666667,61,50,11,81.9672131147541,4,1,3,25.0,12.50005988426,4,1,3,25.0,4,1,15,7,8,3,11,Leicester City,13,England - Premier League
388,Nathan Redmond,1084,761.0,323,70.20295202952029,92,54,38,58.69565217391305,686,574,112,83.6734693877551,97,25,72,25.773195876288657,16.594478672359486,73,12,61,16.43835616438356,37,3,96,61,46,27,42,Norwich City,35,England - Premier League
389,Nathaniel Edwin Clyne,1943,1520.0,423,78.22954194544519,260,165,95,63.46153846153846,1117,997,120,89.25693822739481,161,47,114,29.19254658385093,16.85691667869406,54,13,41,24.074074074074073,28,0,32,18,13,6,26,Liverpool,33,England - Premier League
390,Neil Taylor,1639,1292.0,347,78.82855399633924,196,117,79,59.693877551020414,859,788,71,91.73457508731082,162,60,102,37.03703703703704,17.211372801474507,55,16,39,29.09090909090909,15,1,29,12,10,3,29,Swansea City,34,England - Premier League
391,Nemanja Matić,1653,1429.0,224,86.44888082274652,166,111,55,66.86746987951807,1136,1071,65,94.27816901408451,66,36,30,54.54545454545454,17.280029588822025,15,7,8,46.666666666666664,14,2,33,27,13,11,22,Chelsea,33,England - Premier League
392,Nick Powell,2,1.0,1,50.0,0,0,0,0.0,1,1,0,100.0,0,0,0,0.0,13.738993045199999,0,0,0,0.0,0,0,0,0,0,0,0,Manchester United,1,England - Premier League
393,Nicolás Hernán Otamendi,1561,1344.0,217,86.09865470852019,164,95,69,57.92682926829268,1012,977,35,96.54150197628458,134,52,82,38.80597014925373,20.53538851988433,0,0,0,0.0,4,0,11,8,0,0,30,Manchester City,30,England - Premier League
394,Nikica Jelavić,78,51.0,27,65.38461538461539,6,3,3,50.0,31,28,3,90.32258064516128,1,0,1,0.0,11.97252331463077,4,2,2,50.0,6,1,5,4,4,3,4,West Ham United,13,England - Premier League
395,Nordin Amrabat,193,133.0,60,68.9119170984456,11,5,6,45.45454545454545,112,98,14,87.5,26,7,19,26.923076923076923,17.223743974823627,28,6,22,21.428571428571427,4,0,19,14,13,10,24,Watford,12,England - Premier League
396,Odion Jude Ighalo,707,532.0,175,75.24752475247524,38,15,23,39.473684210526315,452,380,72,84.070796460177,13,7,6,53.84615384615385,11.675980657874648,10,4,6,40.0,31,2,92,53,61,38,60,Watford,37,England - Premier League
397,Ola Toivonen,261,188.0,73,72.03065134099617,35,15,20,42.857142857142854,119,108,11,90.75630252100841,12,6,6,50.0,15.605206432750345,2,1,1,50.0,6,2,3,1,0,0,10,Sunderland,12,England - Premier League
398,Olivier Giroud,825,571.0,254,69.21212121212122,63,26,37,41.269841269841265,416,332,84,79.8076923076923,25,11,14,44.0,11.903555709682124,18,4,14,22.22222222222222,26,6,29,14,13,7,36,Arsenal,38,England - Premier League
399,Oluwaseyi Babajide Ojo,158,122.0,36,77.21518987341773,16,10,6,62.5,118,107,11,90.67796610169492,13,3,10,23.076923076923077,15.83761452823595,9,2,7,22.22222222222222,8,2,18,12,10,6,11,Liverpool,8,England - Premier League
400,Oriol Romeu Vidal,830,701.0,129,84.4578313253012,127,89,38,70.07874015748031,512,481,31,93.9453125,75,48,27,64.0,18.994649202010407,1,0,1,0.0,11,0,27,19,5,3,22,Southampton,29,England - Premier League
401,Osazemwinde Peter Odemwingie,54,45.0,9,83.33333333333334,3,3,0,100.0,34,33,1,97.05882352941177,4,0,4,0.0,16.6520720044,3,0,3,0.0,0,0,2,1,2,1,1,Stoke City,5,England - Premier League
402,Oscar dos Santos Emboaba Júnior,1096,882.0,214,80.47445255474453,136,99,37,72.79411764705883,703,623,80,88.62019914651493,97,57,40,58.76288659793815,16.8274536629515,38,13,25,34.21052631578947,27,3,74,39,48,23,42,Chelsea,27,England - Premier League
403,Pablo Javier Zabaleta Girod,722,604.0,118,83.65650969529086,82,58,24,70.73170731707317,425,403,22,94.82352941176471,37,10,27,27.027027027027028,14.564825205362327,10,2,8,20.0,0,1,9,4,5,4,9,Manchester City,13,England - Premier League
404,Paddy McNair,217,168.0,49,77.41935483870968,33,18,15,54.54545454545454,119,112,7,94.11764705882352,38,12,26,31.57894736842105,22.51568800374636,5,1,4,20.0,1,0,3,1,3,1,1,Manchester United,8,England - Premier League
405,Pape N''Diaye Souaré,1685,1195.0,490,70.91988130563797,227,103,124,45.37444933920705,735,665,70,90.47619047619048,266,72,194,27.06766917293233,19.606083133206553,93,20,73,21.50537634408602,26,1,45,29,20,15,35,Crystal Palace,34,England - Premier League
406,Papiss Demba Cissé,407,297.0,110,72.97297297297297,27,11,16,40.74074074074074,203,165,38,81.2807881773399,25,14,11,56.00000000000001,14.482551070649631,6,2,4,33.33333333333333,10,0,22,16,5,5,10,Newcastle United,21,England - Premier League
407,Patrick Bamford,96,62.0,34,64.58333333333334,8,5,3,62.5,60,45,15,75.0,1,1,0,100.0,10.93018264159125,4,1,3,25.0,2,0,2,2,2,2,4,Norwich City,13,England - Premier League
408,Patrick Roberts,4,4.0,0,100.0,0,0,0,0.0,3,3,0,100.0,0,0,0,0.0,11.7935812134,0,0,0,0.0,0,0,1,1,1,1,1,Manchester City,1,England - Premier League
409,Patrick van Aanholt,1417,1044.0,373,73.67678193366267,138,60,78,43.47826086956522,719,621,98,86.36995827538247,127,32,95,25.196850393700785,18.65418463038843,49,20,29,40.816326530612244,26,4,66,41,29,12,16,Sunderland,33,England - Premier League
410,Paul Dummett,880,633.0,247,71.93181818181819,131,65,66,49.61832061068702,335,309,26,92.23880597014926,139,43,96,30.935251798561154,19.867549192322315,17,5,12,29.411764705882355,3,0,6,6,1,1,11,Newcastle United,23,England - Premier League
411,Paulo Dino Gazzaniga,64,41.0,23,64.0625,13,3,10,23.076923076923077,12,12,0,100.0,42,19,23,45.23809523809524,49.6127806939125,0,0,0,0.0,0,0,0,0,0,0,0,Southampton,2,England - Premier League
412,Pedro Chirivella Burgos,31,24.0,7,77.41935483870968,2,1,1,50.0,24,21,3,87.5,5,2,3,40.0,17.653717175063225,0,0,0,0.0,0,0,1,0,0,0,0,Liverpool,1,England - Premier League
413,Pedro Eliezer Rodríguez Ledesma,1049,835.0,214,79.59961868446139,89,58,31,65.1685393258427,735,659,76,89.65986394557824,73,32,41,43.83561643835616,15.84120906046879,47,17,30,36.17021276595745,39,2,99,59,40,26,58,Chelsea,29,England - Premier League
414,Pedro Mba Obiang Avomo,478,371.0,107,77.61506276150628,70,37,33,52.85714285714286,284,256,28,90.14084507042254,40,18,22,45.0,18.21794886296887,4,0,4,0.0,2,1,15,9,4,3,16,West Ham United,23,England - Premier League
415,Per Mertesacker,1238,1116.0,122,90.14539579967689,63,42,21,66.66666666666666,813,795,18,97.7859778597786,67,23,44,34.32835820895522,19.232454883868435,0,0,0,0.0,1,0,2,2,0,0,9,Arsenal,24,England - Premier League
416,Peter Crouch,156,91.0,65,58.333333333333336,24,9,15,37.5,54,46,8,85.18518518518519,5,0,5,0.0,12.678453118453845,1,0,1,0.0,3,1,3,1,0,0,4,Stoke City,11,England - Premier League
417,Petr Čech,1036,654.0,382,63.12741312741312,193,60,133,31.088082901554404,278,278,0,100.0,636,258,378,40.56603773584906,46.094517390885635,0,0,0,0.0,2,0,2,2,0,0,5,Arsenal,34,England - Premier League
418,Phil Bardsley,382,289.0,93,75.6544502617801,68,32,36,47.05882352941176,175,165,10,94.28571428571428,68,28,40,41.17647058823529,20.243690088987016,16,3,13,18.75,2,1,4,2,1,1,16,Stoke City,11,England - Premier League
419,Phil Jagielka,1062,895.0,167,84.27495291902072,127,66,61,51.96850393700787,554,539,15,97.29241877256317,176,77,99,43.75,24.030827272303053,2,1,1,50.0,3,0,6,4,1,1,14,Everton,21,England - Premier League
420,Phil Jones,321,273.0,48,85.04672897196261,44,26,18,59.09090909090909,204,197,7,96.56862745098039,28,10,18,35.714285714285715,19.42151279406056,1,1,0,100.0,0,0,1,0,0,0,3,Manchester United,10,England - Premier League
421,Philipp Wollscheid,1199,1009.0,190,84.1534612176814,91,43,48,47.25274725274725,690,665,25,96.37681159420289,153,60,93,39.21568627450981,22.075262826186414,0,0,0,0.0,4,0,9,8,0,0,19,Stoke City,31,England - Premier League
422,Philippe Coutinho Correia,1147,872.0,275,76.02441150828247,182,134,48,73.62637362637363,711,621,90,87.34177215189874,114,57,57,50.0,17.644442538872745,27,7,20,25.925925925925924,43,5,93,51,54,32,38,Liverpool,26,England - Premier League
423,Radamel Falcao García Zárate,85,64.0,21,75.29411764705883,5,3,2,60.0,58,50,8,86.20689655172413,2,2,0,100.0,12.350229436299388,0,0,0,0.0,2,0,7,3,4,2,7,Chelsea,10,England - Premier League
424,Raheem Sterling,904,727.0,177,80.42035398230088,58,42,16,72.41379310344827,712,633,79,88.90449438202246,29,5,24,17.24137931034483,12.8413960643743,44,5,39,11.363636363636363,33,2,83,48,53,32,58,Manchester City,31,England - Premier League
425,Ramires Santos do Nascimento,332,261.0,71,78.6144578313253,41,23,18,56.09756097560976,201,177,24,88.05970149253731,28,11,17,39.285714285714285,17.482274122051084,4,1,3,25.0,1,0,15,7,7,4,19,Chelsea,12,England - Premier League
426,Reece Oxford,57,47.0,10,82.45614035087719,4,2,2,50.0,35,32,3,91.42857142857143,6,1,5,16.666666666666664,19.44810474233684,0,0,0,0.0,0,0,0,0,0,0,1,West Ham United,7,England - Premier League
427,Rees Greenwood,20,16.0,4,80.0,2,2,0,100.0,15,13,2,86.66666666666667,0,0,0,0.0,13.909669151903998,2,0,2,0.0,1,0,2,1,2,1,0,Sunderland,1,England - Premier League
428,Rhu-endly Martina,581,422.0,159,72.63339070567987,94,46,48,48.93617021276596,265,233,32,87.9245283018868,86,39,47,45.348837209302324,19.546504475536935,33,12,21,36.36363636363637,11,1,5,3,3,2,12,Southampton,15,England - Premier League
429,Rickie Lambert,277,190.0,87,68.59205776173285,40,20,20,50.0,116,108,8,93.10344827586206,26,12,14,46.15384615384615,15.392365912444419,5,1,4,20.0,8,1,5,3,1,0,10,West Bromwich Albion,19,England - Premier League
430,Ritchie De Laet,332,212.0,120,63.85542168674698,69,25,44,36.231884057971016,109,96,13,88.07339449541286,61,21,40,34.42622950819672,19.405623363366796,12,5,7,41.66666666666667,4,0,11,3,9,2,5,Leicester City,12,England - Premier League
431,Riyad Mahrez,1174,816.0,358,69.50596252129472,132,75,57,56.81818181818182,641,533,108,83.15132605304211,145,58,87,40.0,16.81456751480821,78,24,54,30.76923076923077,56,10,218,123,131,68,92,Leicester City,37,England - Premier League
432,Rob Elliot,688,382.0,306,55.52325581395349,137,39,98,28.467153284671532,101,101,0,100.0,534,231,303,43.258426966292134,49.678618753405466,0,0,0,0.0,1,0,0,0,0,0,5,Newcastle United,21,England - Premier League
433,Robert Brady,1608,1016.0,592,63.18407960199005,254,116,138,45.66929133858268,684,570,114,83.33333333333334,314,90,224,28.662420382165603,20.499820792382685,114,27,87,23.684210526315788,51,2,79,48,41,27,18,Norwich City,36,England - Premier League
434,Robert Huth,794,612.0,182,77.07808564231739,76,29,47,38.15789473684211,354,349,5,98.58757062146893,98,32,66,32.6530612244898,20.35332350494549,1,1,0,100.0,1,0,4,4,1,1,18,Leicester City,35,England - Premier League
435,Robert Kenedy Nunes do Nascimento,323,268.0,55,82.97213622291022,26,18,8,69.23076923076923,232,211,21,90.94827586206897,21,8,13,38.095238095238095,15.01850831166836,10,1,9,10.0,5,0,34,22,20,13,10,Chelsea,14,England - Premier League
436,Roberto Firmino Barbosa de Oliveira,1045,778.0,267,74.44976076555024,85,50,35,58.82352941176471,717,581,136,81.03207810320781,36,14,22,38.88888888888889,14.060271210290594,31,8,23,25.806451612903224,37,7,90,55,48,31,23,Liverpool,31,England - Premier League
437,Rolando Aarons,170,140.0,30,82.35294117647058,9,6,3,66.66666666666666,86,81,5,94.18604651162791,17,10,7,58.82352941176471,16.601273426202354,11,4,7,36.36363636363637,3,1,20,8,7,3,9,Newcastle United,10,England - Premier League
438,Romelu Lukaku Menama,1112,804.0,308,72.3021582733813,116,53,63,45.689655172413794,707,598,109,84.58274398868458,28,14,14,50.0,12.939272933230942,28,4,24,14.285714285714285,43,6,88,46,58,27,35,Everton,37,England - Premier League
439,Ross Barkley,1921,1593.0,328,82.92555960437272,227,159,68,70.04405286343612,1376,1258,118,91.42441860465115,149,57,92,38.25503355704698,17.57634425799967,36,12,24,33.33333333333333,54,8,145,94,84,55,86,Everton,38,England - Premier League
440,Ruben Loftus-Cheek,248,209.0,39,84.2741935483871,19,10,9,52.63157894736842,199,180,19,90.45226130653266,1,1,0,100.0,13.271285217968709,1,0,1,0.0,4,0,19,9,8,4,14,Chelsea,13,England - Premier League
441,Rudy Gestede,594,348.0,246,58.58585858585859,84,25,59,29.761904761904763,196,165,31,84.18367346938776,9,2,7,22.22222222222222,12.404196828705455,5,1,4,20.0,11,1,20,13,12,7,14,Aston Villa,32,England - Premier League
442,Russell Martin,1332,973.0,359,73.04804804804806,246,98,148,39.83739837398374,565,518,47,91.68141592920354,260,101,159,38.84615384615385,22.246556683506487,22,6,16,27.27272727272727,9,0,10,1,4,1,8,Norwich City,30,England - Premier League
443,Ryan Allsop,10,9.0,1,90.0,0,0,0,0.0,6,6,0,100.0,2,1,1,50.0,27.7853392476,0,0,0,0.0,0,0,0,0,0,0,0,AFC Bournemouth,1,England - Premier League
444,Ryan Bennett,606,447.0,159,73.76237623762376,111,42,69,37.83783783783784,244,231,13,94.67213114754098,120,42,78,35.0,24.451650861260198,0,0,0,0.0,4,0,1,1,0,0,7,Norwich City,22,England - Premier League
445,Ryan Bertrand,1565,1170.0,395,74.76038338658148,175,108,67,61.71428571428571,748,682,66,91.17647058823529,215,72,143,33.48837209302326,17.885902751884984,72,16,56,22.22222222222222,19,3,44,20,33,12,29,Southampton,32,England - Premier League
446,Ryan Mason,543,453.0,90,83.42541436464089,85,61,24,71.76470588235294,354,331,23,93.50282485875707,51,25,26,49.01960784313725,18.67248567040309,11,4,7,36.36363636363637,12,0,15,9,6,4,11,Tottenham Hotspur,22,England - Premier League
447,Ryan Shawcross,590,448.0,142,75.9322033898305,88,36,52,40.909090909090914,315,302,13,95.87301587301587,105,39,66,37.142857142857146,22.505540315917422,2,0,2,0.0,1,0,7,4,2,0,2,Stoke City,20,England - Premier League
448,Sadio Mané,1043,815.0,228,78.13998082454458,80,62,18,77.5,703,590,113,83.92603129445236,48,23,25,47.91666666666667,14.972904756631708,65,23,42,35.38461538461539,37,6,147,80,77,42,87,Southampton,37,England - Premier League
449,Saido Berahino,473,356.0,117,75.26427061310783,42,26,16,61.904761904761905,296,255,41,86.14864864864865,21,7,14,33.33333333333333,15.989465399967019,12,3,9,25.0,18,0,44,30,18,13,28,West Bromwich Albion,31,England - Premier League
450,Sam Field,2,1.0,1,50.0,0,0,0,0.0,1,1,0,100.0,0,0,0,0.0,8.4437209332,0,0,0,0.0,0,0,0,0,0,0,1,West Bromwich Albion,1,England - Premier League
451,Samir Nasri,437,398.0,39,91.07551487414187,34,30,4,88.23529411764706,342,323,19,94.44444444444444,18,14,4,77.77777777777779,14.444125292301692,9,3,6,33.33333333333333,7,2,18,10,9,4,7,Manchester City,12,England - Premier League
452,Samuel Mark Byram,140,96.0,44,68.57142857142857,31,13,18,41.935483870967744,54,50,4,92.5925925925926,29,6,23,20.689655172413794,20.091774760236,9,2,7,22.22222222222222,2,0,0,0,0,0,4,West Ham United,4,England - Premier League
453,Sandro Ranieri Guimarães Cordeiro,145,97.0,48,66.89655172413794,22,9,13,40.909090909090914,74,65,9,87.83783783783784,9,3,6,33.33333333333333,18.309011957240276,2,2,0,100.0,1,0,3,3,0,0,6,West Bromwich Albion,10,England - Premier League
454,Santiago Cazorla González,1300,1128.0,172,86.76923076923076,180,148,32,82.22222222222221,927,878,49,94.71413160733549,120,64,56,53.333333333333336,17.773093423359693,23,8,15,34.78260869565217,36,3,45,35,15,13,15,Arsenal,15,England - Premier League
455,Scott Dann,1111,837.0,274,75.33753375337534,209,80,129,38.27751196172249,452,437,15,96.68141592920354,236,85,151,36.016949152542374,24.627095483393845,2,1,1,50.0,8,0,11,8,1,1,15,Crystal Palace,35,England - Premier League
456,Scott Sinclair,354,285.0,69,80.50847457627118,21,16,5,76.19047619047619,269,235,34,87.36059479553904,5,3,2,60.0,12.362099761572201,15,2,13,13.333333333333334,4,0,62,33,37,16,23,Aston Villa,26,England - Premier League
457,Sebastian Larsson,269,187.0,82,69.51672862453532,38,14,24,36.84210526315789,139,126,13,90.64748201438849,45,11,34,24.444444444444443,18.589263000635242,9,0,9,0.0,6,0,5,2,3,2,6,Sunderland,18,England - Premier League
458,Sebastian Prödl,538,397.0,141,73.7918215613383,83,29,54,34.93975903614458,230,226,4,98.26086956521739,119,38,81,31.932773109243694,23.78436879253918,1,1,0,100.0,2,0,1,0,0,0,6,Watford,21,England - Premier League
459,Sebastián Coates Nión,417,292.0,125,70.02398081534771,90,26,64,28.888888888888886,166,158,8,95.18072289156626,102,28,74,27.450980392156865,25.19442322690532,1,0,1,0.0,1,1,8,6,2,1,5,Sunderland,16,England - Premier League
460,Segundo Víctor Ibarbo Guerrero,28,18.0,10,64.28571428571429,3,1,2,33.33333333333333,15,14,1,93.33333333333333,5,0,5,0.0,18.148423289785715,2,0,2,0.0,0,0,3,1,0,0,1,Watford,4,England - Premier League
461,Serge Gnabry,7,6.0,1,85.71428571428571,0,0,0,0.0,5,5,0,100.0,1,1,0,100.0,13.861465103314286,0,0,0,0.0,1,0,4,2,3,1,0,West Bromwich Albion,1,England - Premier League
462,Sergi Canós Tenes,4,3.0,1,75.0,1,0,1,0.0,2,1,1,50.0,0,0,0,0.0,8.8178248332,0,0,0,0.0,0,0,0,0,0,0,0,Liverpool,1,England - Premier League
463,Sergio Germán Romero,140,91.0,49,65.0,18,3,15,16.666666666666664,44,44,0,100.0,69,24,45,34.78260869565217,38.000239219079994,0,0,0,0.0,0,0,0,0,0,0,0,Manchester United,4,England - Premier League
464,Sergio Leonel Agüero del Castillo,740,611.0,129,82.56756756756756,32,26,6,81.25,544,486,58,89.33823529411765,20,8,12,40.0,12.828509442209675,19,4,15,21.052631578947366,24,2,111,64,86,45,46,Manchester City,30,England - Premier League
465,Seydou Doumbia,8,6.0,2,75.0,0,0,0,0.0,8,6,2,75.0,0,0,0,0.0,8.19815964759,1,0,1,0.0,0,0,0,0,0,0,1,Newcastle United,3,England - Premier League
466,Shane Long,649,418.0,231,64.40677966101694,55,22,33,40.0,320,256,64,80.0,31,8,23,25.806451612903224,13.478819109696666,44,13,31,29.545454545454547,30,4,29,12,14,4,45,Southampton,28,England - Premier League
467,Shaun MacDonald,19,17.0,2,89.47368421052632,1,1,0,100.0,13,13,0,100.0,0,0,0,0.0,15.892296991995789,1,0,1,0.0,0,0,1,1,0,0,0,AFC Bournemouth,3,England - Premier League
468,Shay Given,67,44.0,23,65.67164179104478,6,1,5,16.666666666666664,9,9,0,100.0,52,30,22,57.692307692307686,47.910996733325376,0,0,0,0.0,0,0,0,0,0,0,1,Stoke City,3,England - Premier League
469,Shinji Okazaki,521,389.0,132,74.6641074856046,36,20,16,55.55555555555556,321,285,36,88.78504672897196,10,6,4,60.0,10.66888310497884,10,1,9,10.0,17,0,45,23,21,9,57,Leicester City,36,England - Premier League
470,Siem Stefan de Jong,200,153.0,47,76.5,20,15,5,75.0,115,98,17,85.21739130434783,3,2,1,66.66666666666666,12.646589582919601,2,0,2,0.0,1,1,8,4,4,2,6,Newcastle United,18,England - Premier League
471,Simon Francis,2454,1921.0,533,78.28035859820702,275,152,123,55.27272727272727,1193,1113,80,93.29421626152556,369,150,219,40.65040650406504,20.780952085304744,86,32,54,37.2093023255814,32,4,49,34,21,9,13,AFC Bournemouth,38,England - Premier League
472,Simon Mignolet,934,616.0,318,65.95289079229121,111,30,81,27.027027027027028,355,354,1,99.71830985915493,468,158,310,33.76068376068376,39.533536955696526,0,0,0,0.0,0,0,4,4,0,0,3,Liverpool,34,England - Premier League
473,Stephen Ireland,176,138.0,38,78.4090909090909,22,13,9,59.09090909090909,105,94,11,89.52380952380953,18,8,10,44.44444444444444,17.975189602808182,2,1,1,50.0,7,1,4,4,2,2,0,Stoke City,13,England - Premier League
474,Stephen Kingsley,155,112.0,43,72.25806451612902,11,4,7,36.36363636363637,74,66,8,89.1891891891892,29,9,20,31.03448275862069,20.83445078608568,13,3,10,23.076923076923077,1,1,5,5,0,0,3,Swansea City,4,England - Premier League
475,Steve Cook,1641,1312.0,329,79.95124923826936,182,81,101,44.505494505494504,831,801,30,96.38989169675091,249,102,147,40.963855421686745,23.84003535266501,3,0,3,0.0,4,0,1,0,0,0,10,AFC Bournemouth,36,England - Premier League
476,Steve Sidwell,7,6.0,1,85.71428571428571,1,0,1,0.0,5,5,0,100.0,1,0,1,0.0,15.247462592571427,0,0,0,0.0,0,0,0,0,0,0,0,Stoke City,1,England - Premier League
477,Steven Berghuis,113,74.0,39,65.48672566371681,15,11,4,73.33333333333333,63,47,16,74.60317460317461,26,13,13,50.0,21.788240980065133,13,4,9,30.76923076923077,6,2,5,4,2,1,4,Watford,9,England - Premier League
478,Steven Caulker,80,56.0,24,70.0,12,4,8,33.33333333333333,33,31,2,93.93939393939394,12,3,9,25.0,18.942034230918,0,0,0,0.0,1,0,1,1,0,0,0,Southampton,6,England - Premier League
479,Steven Davis,1634,1300.0,334,79.5593635250918,234,149,85,63.67521367521367,947,865,82,91.34107708553326,211,95,116,45.023696682464454,18.490180439628837,47,11,36,23.404255319148938,46,2,36,23,14,8,25,Southampton,34,England - Premier League
480,Steven Fletcher,294,186.0,108,63.26530612244898,39,12,27,30.76923076923077,120,106,14,88.33333333333333,14,5,9,35.714285714285715,13.63380811221551,8,0,8,0.0,10,0,26,14,11,4,16,Sunderland,16,England - Premier League
481,Steven Naismith,506,371.0,135,73.3201581027668,50,25,25,50.0,313,273,40,87.22044728434504,9,4,5,44.44444444444444,12.817689020339763,9,5,4,55.55555555555556,18,1,31,11,19,6,43,Norwich City,23,England - Premier League
482,Steven Pienaar,80,64.0,16,80.0,8,6,2,75.0,64,53,11,82.8125,2,1,1,50.0,14.889478932819,2,1,1,50.0,1,0,6,4,0,0,3,Everton,4,England - Premier League
483,Steven Taylor,316,273.0,43,86.39240506329115,27,14,13,51.85185185185185,210,202,8,96.19047619047619,32,7,25,21.875,20.51374857772329,0,0,0,0.0,1,0,2,1,2,1,4,Newcastle United,10,England - Premier League
484,Steven Whittaker,409,294.0,115,71.88264058679707,73,34,39,46.57534246575342,184,161,23,87.5,59,17,42,28.8135593220339,18.319668100413885,11,2,9,18.181818181818183,3,0,11,6,3,2,3,Norwich City,8,England - Premier League
485,Stéphane Sessègnon,638,463.0,175,72.5705329153605,47,29,18,61.702127659574465,394,347,47,88.07106598984772,62,20,42,32.25806451612903,16.394090387922507,51,12,39,23.52941176470588,26,2,84,50,47,29,59,West Bromwich Albion,25,England - Premier League
486,Sullay Kaikai,20,14.0,6,70.0,0,0,0,0.0,12,11,1,91.66666666666666,5,1,4,20.0,20.736287222796,2,0,2,0.0,2,0,0,0,0,0,0,Crystal Palace,1,England - Premier League
487,Sung-Yeung Ki,1189,1074.0,115,90.32800672834314,141,114,27,80.85106382978722,794,756,38,95.21410579345087,58,45,13,77.58620689655173,19.075178499934466,6,3,3,50.0,21,1,20,13,9,6,26,Swansea City,28,England - Premier League
488,Sylvain Distin,479,394.0,85,82.25469728601253,41,28,13,68.29268292682927,261,248,13,95.01915708812261,37,14,23,37.83783783783784,20.058887281970105,0,0,0,0.0,0,0,3,3,0,0,2,AFC Bournemouth,11,England - Premier League
489,Séamus Coleman,1398,1125.0,273,80.47210300429185,156,102,54,65.38461538461539,791,745,46,94.18457648546145,146,48,98,32.87671232876712,17.79905644872206,72,16,56,22.22222222222222,13,2,72,41,37,17,32,Everton,28,England - Premier League
490,Sébastien Aymar Bassong Nguena,950,737.0,213,77.57894736842104,102,42,60,41.17647058823529,467,446,21,95.50321199143468,123,44,79,35.77235772357724,20.897822910338526,3,0,3,0.0,2,0,13,12,0,0,22,Norwich City,32,England - Premier League
491,Sébastien Pocognoli,30,19.0,11,63.33333333333333,5,0,5,0.0,9,9,0,100.0,8,2,6,25.0,22.582917902400002,3,2,1,66.66666666666666,1,1,0,0,0,0,0,West Bromwich Albion,1,England - Premier League
492,Tammy Bakumo-Abraham,14,7.0,7,50.0,1,1,0,100.0,8,4,4,50.0,0,0,0,0.0,11.163527297850857,2,0,2,0.0,0,0,2,1,2,1,0,Chelsea,2,England - Premier League
493,Tetchi Jores Charlemagne Ulrich Okore,344,277.0,67,80.52325581395348,29,13,16,44.827586206896555,180,163,17,90.55555555555556,35,11,24,31.428571428571427,22.786611899527674,0,0,0,0.0,1,0,4,3,0,0,10,Aston Villa,12,England - Premier League
494,Theo Walcott,333,249.0,84,74.77477477477478,20,15,5,75.0,229,197,32,86.02620087336244,15,2,13,13.333333333333334,14.37682351548108,20,5,15,25.0,13,2,48,26,18,9,28,Arsenal,28,England - Premier League
495,Thibaut Courtois,638,370.0,268,57.993730407523515,73,14,59,19.17808219178082,179,178,1,99.4413407821229,382,124,258,32.460732984293195,44.2857713705368,0,0,0,0.0,0,0,0,0,0,0,3,Chelsea,23,England - Premier League
496,Thomas Robson,56,44.0,12,78.57142857142857,9,5,4,55.55555555555556,21,19,2,90.47619047619048,8,3,5,37.5,18.231981063814285,1,0,1,0.0,0,0,2,1,0,0,1,Sunderland,1,England - Premier League
497,Tim Howard,805,554.0,251,68.81987577639752,51,9,42,17.647058823529413,322,321,1,99.68944099378882,391,150,241,38.36317135549872,38.37031056447563,0,0,0,0.0,0,0,1,1,0,0,2,Everton,25,England - Premier League
498,Timm Klose,283,188.0,95,66.43109540636041,40,17,23,42.5,100,90,10,90.0,68,23,45,33.82352941176471,23.75019666368396,0,0,0,0.0,0,0,1,1,0,0,6,Norwich City,10,England - Premier League
499,Timothy Evans Fosu-Mensah,144,102.0,42,70.83333333333334,16,5,11,31.25,71,66,5,92.95774647887323,20,4,16,20.0,20.765758979575,1,0,1,0.0,0,1,3,2,0,0,3,Manchester United,8,England - Premier League
500,Timothy Michael Krul,281,165.0,116,58.718861209964416,39,10,29,25.64102564102564,65,64,1,98.46153846153847,181,68,113,37.569060773480665,45.19971963602136,0,0,0,0.0,0,0,0,0,0,0,1,Newcastle United,8,England - Premier League
501,Toby Alderweireld,2122,1704.0,418,80.30160226201697,339,152,187,44.83775811209439,1070,1041,29,97.28971962616822,450,196,254,43.55555555555555,25.937805877790048,14,3,11,21.428571428571427,7,2,12,7,7,4,7,Tottenham Hotspur,38,England - Premier League
502,Tokelo Anthony Rantie,11,9.0,2,81.81818181818183,0,0,0,0.0,11,9,2,81.81818181818183,0,0,0,0.0,10.056014097643637,0,0,0,0.0,1,0,3,0,2,0,0,AFC Bournemouth,3,England - Premier League
503,Tom Carroll,361,293.0,68,81.16343490304709,56,42,14,75.0,240,216,24,90.0,38,18,20,47.368421052631575,18.35255070197252,10,3,7,30.0,8,0,7,4,4,3,2,Tottenham Hotspur,19,England - Premier League
504,Tom Cleverley,974,768.0,206,78.85010266940452,116,73,43,62.93103448275862,580,538,42,92.75862068965517,121,42,79,34.710743801652896,18.26959589082111,43,7,36,16.27906976744186,18,4,23,14,12,7,22,Everton,22,England - Premier League
505,Tom Davies,49,37.0,12,75.51020408163265,6,3,3,50.0,38,32,6,84.21052631578947,2,0,2,0.0,14.752916822659593,1,0,1,0.0,0,0,2,2,0,0,2,Everton,2,England - Premier League
506,Tommy Elphick,462,377.0,85,81.6017316017316,48,29,19,60.416666666666664,270,264,6,97.77777777777777,50,18,32,36.0,19.780969640452984,0,0,0,0.0,1,0,0,0,0,0,6,AFC Bournemouth,12,England - Premier League
507,Tony Hibbert,19,16.0,3,84.21052631578947,3,1,2,33.33333333333333,13,12,1,92.3076923076923,1,0,1,0.0,17.885891541221053,0,0,0,0.0,0,0,1,0,0,0,0,Everton,1,England - Premier League
508,Troy Deeney,1302,792.0,510,60.82949308755761,248,111,137,44.75806451612903,509,425,84,83.49705304518665,91,33,58,36.26373626373626,15.05315889489434,30,7,23,23.333333333333332,49,7,50,29,22,10,45,Watford,38,England - Premier League
509,Tyler Roberts,8,4.0,4,50.0,1,0,1,0.0,2,2,0,100.0,0,0,0,0.0,9.70755605856,0,0,0,0.0,0,0,2,2,1,1,0,West Bromwich Albion,1,England - Premier League
510,Tyrone Mings,2,2.0,0,100.0,0,0,0,0.0,2,2,0,100.0,0,0,0,0.0,14.104533132,0,0,0,0.0,0,0,0,0,0,0,0,AFC Bournemouth,1,England - Premier League
511,Vadis Odjidja-Ofoe,159,120.0,39,75.47169811320755,10,6,4,60.0,94,84,10,89.36170212765957,9,4,5,44.44444444444444,13.72517408899336,9,3,6,33.33333333333333,7,2,18,9,14,6,3,Norwich City,10,England - Premier League
512,Valon Behrami,519,411.0,108,79.1907514450867,52,29,23,55.769230769230774,346,321,25,92.77456647398844,21,5,16,23.809523809523807,14.392343916689478,1,0,1,0.0,4,1,9,3,1,0,19,Watford,21,England - Premier League
513,Victor Chinedu Anichebe,116,68.0,48,58.620689655172406,15,3,12,20.0,38,32,6,84.21052631578947,0,0,0,0.0,12.648332459321379,1,0,1,0.0,2,0,8,6,5,3,7,West Bromwich Albion,10,England - Premier League
514,Victor Moses,306,231.0,75,75.49019607843137,25,15,10,60.0,217,187,30,86.17511520737328,20,8,12,40.0,15.141167552025882,24,5,19,20.833333333333336,14,2,47,23,29,11,25,West Ham United,21,England - Premier League
515,Victor Wanyama,1389,1141.0,248,82.14542836573074,186,112,74,60.215053763440864,894,848,46,94.85458612975391,114,43,71,37.719298245614034,18.352856533641642,4,0,4,0.0,12,1,43,30,15,10,35,Southampton,30,England - Premier League
516,Vincent Kompany,679,572.0,107,84.24153166421208,84,49,35,58.333333333333336,384,369,15,96.09375,76,28,48,36.84210526315789,23.288376363327835,1,0,1,0.0,3,0,11,8,1,0,5,Manchester City,14,England - Premier League
517,Virgil van Dijk,1412,1186.0,226,83.9943342776204,197,115,82,58.37563451776649,726,697,29,96.00550964187327,199,99,100,49.74874371859296,22.851772963752236,4,2,2,50.0,8,0,13,10,5,2,14,Southampton,34,England - Premier League
518,Vito Mannone,633,277.0,356,43.75987361769352,170,48,122,28.235294117647058,85,85,0,100.0,495,145,350,29.292929292929294,52.43756042711659,0,0,0,0.0,0,0,0,0,0,0,5,Sunderland,19,England - Premier League
519,Vurnon Anita,1134,864.0,270,76.19047619047619,182,94,88,51.64835164835166,579,528,51,91.19170984455958,110,31,79,28.18181818181818,18.29109768288381,16,5,11,31.25,9,3,24,13,11,5,15,Newcastle United,28,England - Premier League
520,Wahbi Khazri,421,271.0,150,64.37054631828978,54,22,32,40.74074074074074,181,157,24,86.74033149171271,116,48,68,41.37931034482759,21.771242308453683,27,11,16,40.74074074074074,30,1,35,17,14,6,16,Sunderland,14,England - Premier League
521,Wayne Hennessey,869,431.0,438,49.59723820483315,292,83,209,28.424657534246577,149,149,0,100.0,644,214,430,33.22981366459628,53.03632520739645,0,0,0,0.0,0,0,0,0,0,0,0,Crystal Palace,29,England - Premier League
522,Wayne Mark Rooney,1195,955.0,240,79.9163179916318,150,96,54,64.0,704,638,66,90.625,149,90,59,60.40268456375839,18.890596997564867,43,9,34,20.930232558139537,35,5,50,30,22,9,22,Manchester United,28,England - Premier League
523,Wayne Routledge,722,501.0,221,69.39058171745152,50,23,27,46.0,436,363,73,83.25688073394495,58,23,35,39.6551724137931,15.256050673520443,42,10,32,23.809523809523807,27,1,42,24,21,11,28,Swansea City,28,England - Premier League
524,Wes Brown,198,153.0,45,77.27272727272727,23,9,14,39.130434782608695,101,93,8,92.07920792079209,30,13,17,43.333333333333336,20.799546332567274,0,0,0,0.0,0,0,1,1,0,0,6,Sunderland,6,England - Premier League
525,Wes Hoolahan,1180,938.0,242,79.49152542372882,119,81,38,68.0672268907563,809,709,100,87.63906056860321,96,45,51,46.875,15.307540978596345,49,15,34,30.612244897959183,38,7,57,33,29,14,48,Norwich City,30,England - Premier League
526,Wes Morgan,849,648.0,201,76.32508833922262,113,38,75,33.6283185840708,403,386,17,95.7816377171216,119,38,81,31.932773109243694,20.25627671032325,1,0,1,0.0,3,0,11,9,0,0,16,Leicester City,38,England - Premier League
527,Wilfredo Daniel Caballero,91,51.0,40,56.043956043956044,12,3,9,25.0,23,23,0,100.0,58,19,39,32.758620689655174,45.97343118514286,0,0,0,0.0,0,0,0,0,0,0,0,Manchester City,4,England - Premier League
528,Wilfried Guemiand Bony,398,317.0,81,79.64824120603015,34,22,12,64.70588235294117,262,232,30,88.54961832061069,4,1,3,25.0,12.49098642611005,3,1,2,33.33333333333333,8,3,25,15,15,8,23,Manchester City,26,England - Premier League
529,Wilfried Zaha,699,488.0,211,69.8140200286123,56,36,20,64.28571428571429,426,344,82,80.75117370892019,50,24,26,48.0,16.288611427983863,86,35,51,40.69767441860465,35,1,198,119,108,62,102,Crystal Palace,34,England - Premier League
530,Willian Borges da Silva,1745,1303.0,442,74.67048710601719,186,126,60,67.74193548387096,1061,924,137,87.08765315739868,254,114,140,44.881889763779526,18.430605660466934,99,23,76,23.232323232323232,76,7,104,70,52,35,73,Chelsea,35,England - Premier League
531,Winston Reid,826,691.0,135,83.65617433414043,88,45,43,51.13636363636363,443,424,19,95.71106094808127,109,41,68,37.61467889908257,23.424736944166778,0,0,0,0.0,4,1,2,2,0,0,29,West Ham United,24,England - Premier League
532,Xherdan Shaqiri,835,577.0,258,69.10179640718563,80,41,39,51.24999999999999,443,396,47,89.39051918735892,149,44,105,29.53020134228188,19.859998509293604,81,15,66,18.51851851851852,43,5,86,42,46,21,33,Stoke City,27,England - Premier League
533,Yann Gérard M''Vila,1799,1404.0,395,78.04335742078933,319,188,131,58.93416927899686,1053,966,87,91.73789173789174,247,96,151,38.8663967611336,19.90757482549554,36,4,32,11.11111111111111,43,3,38,28,11,6,55,Sunderland,37,England - Premier League
534,Yann Kermorgant,62,40.0,22,64.51612903225806,10,6,4,60.0,30,24,6,80.0,2,1,1,50.0,14.195147480419354,1,0,1,0.0,2,0,3,2,1,1,5,AFC Bournemouth,7,England - Premier League
535,Yannick Bolasie Yala,653,402.0,251,61.56202143950995,57,28,29,49.122807017543856,319,256,63,80.25078369905955,84,20,64,23.809523809523807,16.841391447609922,109,26,83,23.853211009174313,23,3,135,73,82,42,40,Crystal Palace,26,England - Premier League
536,Yoan Gouffran,94,71.0,23,75.53191489361703,11,5,6,45.45454545454545,53,52,1,98.11320754716981,11,3,8,27.27272727272727,19.418552950817872,3,0,3,0.0,1,0,2,0,1,0,1,Newcastle United,8,England - Premier League
537,Yohan Benalouane,18,10.0,8,55.55555555555556,5,1,4,20.0,1,1,0,100.0,4,1,3,25.0,22.6865740578,0,0,0,0.0,0,0,0,0,0,0,0,Leicester City,4,England - Premier League
538,Yohan Cabaye,1433,1111.0,322,77.52965806001396,205,121,84,59.02439024390244,772,720,52,93.26424870466322,266,109,157,40.97744360902256,20.355148898444046,43,13,30,30.23255813953488,48,1,39,19,16,7,41,Crystal Palace,33,England - Premier League
539,Younes Kaboul,692,465.0,227,67.1965317919075,119,38,81,31.932773109243694,304,287,17,94.4078947368421,160,42,118,26.25,24.103386631781273,7,5,2,71.42857142857143,5,1,14,12,2,2,8,Sunderland,23,England - Premier League
540,Youssouf Chafiq Mulumbu Ngangu,162,143.0,19,88.27160493827161,14,12,2,85.71428571428571,109,100,9,91.74311926605505,6,3,3,50.0,15.124568337431112,1,0,1,0.0,1,0,9,6,0,0,6,Norwich City,7,England - Premier League
541,Àngel Rangel Zaragoza,1584,1268.0,316,80.05050505050505,190,105,85,55.26315789473685,808,746,62,92.32673267326733,157,55,102,35.03184713375796,18.401719026723637,36,10,26,27.77777777777778,13,0,22,14,10,5,17,Swansea City,23,England - Premier League
542,Ádám Bogdán,49,25.0,24,51.02040816326531,4,1,3,25.0,13,13,0,100.0,32,9,23,28.125,43.1328958356049,0,0,0,0.0,0,0,0,0,0,0,0,Liverpool,2,England - Premier League
543,Éderzito António Macedo Lopes,85,61.0,24,71.76470588235294,8,2,6,25.0,48,40,8,83.33333333333334,2,0,2,0.0,15.406345135372234,3,0,3,0.0,2,0,9,6,4,2,10,Swansea City,13,England - Premier League
544,Łukasz Fabiański,1212,768.0,444,63.366336633663366,116,20,96,17.24137931034483,367,365,2,99.45504087193461,675,247,428,36.592592592592595,41.72143459887148,0,0,0,0.0,3,1,0,0,0,0,9,Swansea City,37,England - Premier League
