index,player,total_passes,total_completed,total_uncompleted,total_percentage%,f3_passes,f3_completed,f3_uncompleted,f3_percentage%,short_passes,short_completed,short_uncompleted,short_percentage%,long_passes,long_completed,long_uncompleted,long_percentage%,average_pass_length,crosses,crosses_completed,crosses_uncompleted,crosses_percentage%,total_shot_assists,total_goal_assists,dribbles,dribbles_completed,dribbles_f3,dribbles_f3_completed,fouls_won,team,MP,competition
0,Aaron Hunt,870,625.0,245,71.83908045977012,98,57,41,58.16326530612245,509,427,82,83.88998035363457,101,42,59,41.584158415841586,18.020298302589353,30,8,22,26.666666666666668,35,2,37,25,20,13,47,Hamburger SV,23,Germany - 1. Bundesliga
1,Adam Hloušek,206,157.0,49,76.2135922330097,39,17,22,43.58974358974359,86,85,1,98.83720930232558,52,23,29,44.230769230769226,24.761701529860197,1,0,1,0.0,0,0,1,1,0,0,5,VfB Stuttgart,7,Germany - 1. Bundesliga
2,Adelino André Vieira Freitas,1304,977.0,327,74.92331288343557,182,120,62,65.93406593406593,687,607,80,88.35516739446871,219,106,113,48.401826484018265,19.91045528498098,72,17,55,23.61111111111111,31,5,37,24,13,6,59,Wolfsburg,26,Germany - 1. Bundesliga
3,Admir Mehmedi,564,424.0,140,75.177304964539,50,29,21,57.99999999999999,397,332,65,83.6272040302267,39,14,25,35.8974358974359,14.449669407852127,25,12,13,48.0,27,5,44,32,25,19,22,Bayer Leverkusen,28,Germany - 1. Bundesliga
4,Adnan Januzaj,57,42.0,15,73.68421052631578,4,4,0,100.0,37,31,6,83.78378378378379,9,4,5,44.44444444444444,17.77773959143579,4,1,3,25.0,5,2,7,5,6,5,5,Borussia Dortmund,6,Germany - 1. Bundesliga
5,Ahmet Metin Arslan,1,1.0,0,100.0,1,1,0,100.0,0,0,0,0.0,0,0,0,0.0,16.3165974912,0,0,0,0.0,0,0,0,0,0,0,0,Hamburger SV,1,Germany - 1. Bundesliga
6,Albian Afrim Ajeti,8,6.0,2,75.0,0,0,0,0.0,5,4,1,80.0,0,0,0,0.0,11.41503544395,0,0,0,0.0,0,0,0,0,0,0,0,Augsburg,1,Germany - 1. Bundesliga
7,Albin Ekdal,591,460.0,131,77.834179357022,85,51,34,60.0,365,336,29,92.05479452054794,37,14,23,37.83783783783784,17.08649624379655,1,0,1,0.0,5,0,9,4,2,2,39,Hamburger SV,14,Germany - 1. Bundesliga
8,Alejandro Gálvez Jimena,513,383.0,130,74.6588693957115,92,43,49,46.73913043478261,202,189,13,93.56435643564357,117,57,60,48.717948717948715,25.19909048947228,2,1,1,50.0,0,0,3,2,0,0,7,Werder Bremen,21,Germany - 1. Bundesliga
9,Aleksandar Ignjovski,568,379.0,189,66.72535211267606,64,34,30,53.125,281,231,50,82.20640569395017,54,13,41,24.074074074074073,17.295784855296464,34,10,24,29.411764705882355,7,1,34,15,16,7,29,Eintracht Frankfurt,18,Germany - 1. Bundesliga
10,Alessandro Schöpf,176,128.0,48,72.72727272727273,21,11,10,52.38095238095239,115,96,19,83.47826086956522,11,7,4,63.63636363636363,14.363454571576364,9,3,6,33.33333333333333,7,1,24,8,7,1,12,Schalke 04,13,Germany - 1. Bundesliga
11,Alexander Baumjohann,230,162.0,68,70.43478260869566,25,14,11,56.00000000000001,171,137,34,80.11695906432749,4,0,4,0.0,13.96958796663339,5,2,3,40.0,13,2,23,14,15,7,18,Hertha Berlin,24,Germany - 1. Bundesliga
12,Alexander Esswein,568,377.0,191,66.37323943661971,33,17,16,51.515151515151516,334,268,66,80.23952095808383,50,15,35,30.0,16.051919969920565,66,18,48,27.27272727272727,29,1,58,30,34,18,37,Augsburg,29,Germany - 1. Bundesliga
13,Alexander Hack,372,311.0,61,83.60215053763442,36,19,17,52.77777777777778,202,188,14,93.06930693069307,55,26,29,47.27272727272727,22.82531980978839,0,0,0,0.0,0,0,7,6,0,0,4,FSV Mainz 05,7,Germany - 1. Bundesliga
14,Alexander Manninger,36,25.0,11,69.44444444444444,3,1,2,33.33333333333333,12,12,0,100.0,22,11,11,50.0,43.533647756,0,0,0,0.0,0,0,0,0,0,0,0,Augsburg,2,Germany - 1. Bundesliga
15,Alexander Meier,483,321.0,162,66.45962732919256,65,30,35,46.15384615384615,216,182,34,84.25925925925925,21,12,9,57.14285714285714,15.4306537117759,3,1,2,33.33333333333333,16,1,12,7,5,2,12,Eintracht Frankfurt,19,Germany - 1. Bundesliga
16,Alexander Milosevic,340,277.0,63,81.47058823529412,43,19,24,44.18604651162791,189,181,8,95.76719576719577,47,16,31,34.04255319148936,20.209896650484,0,0,0,0.0,0,0,0,0,0,0,4,Hannover 96,10,Germany - 1. Bundesliga
17,Alexandru Iulian Maxim,627,456.0,171,72.72727272727273,72,43,29,59.72222222222222,357,310,47,86.83473389355743,108,44,64,40.74074074074074,18.037280700021817,27,11,16,40.74074074074074,29,5,30,17,15,6,18,VfB Stuttgart,25,Germany - 1. Bundesliga
18,Alfredo Morales,526,303.0,223,57.60456273764258,100,41,59,41.0,218,174,44,79.81651376146789,63,15,48,23.809523809523807,17.295888003673003,21,3,18,14.285714285714285,9,1,42,21,22,8,54,Ingolstadt,24,Germany - 1. Bundesliga
19,Alfreð Finnbogason,292,203.0,89,69.52054794520548,19,7,12,36.84210526315789,158,119,39,75.31645569620254,8,3,5,37.5,13.472467796330136,6,0,6,0.0,12,1,23,11,20,8,12,Augsburg,14,Germany - 1. Bundesliga
20,Allan Saint-Maximin,137,87.0,50,63.503649635036496,12,3,9,25.0,91,69,22,75.82417582417582,8,4,4,50.0,14.815434405825986,7,3,4,42.857142857142854,4,0,30,18,15,7,9,Hannover 96,16,Germany - 1. Bundesliga
21,Almog Cohen,275,181.0,94,65.81818181818181,57,20,37,35.08771929824561,125,106,19,84.8,26,9,17,34.61538461538461,16.831163361089455,1,1,0,100.0,4,1,6,3,2,1,14,Ingolstadt,20,Germany - 1. Bundesliga
22,Andre Hoffmann,312,244.0,68,78.2051282051282,42,26,16,61.904761904761905,215,193,22,89.76744186046511,21,5,16,23.809523809523807,16.759294128323077,0,0,0,0.0,1,0,5,3,1,0,4,Hannover 96,8,Germany - 1. Bundesliga
23,Andreas Christensen,1807,1596.0,211,88.32318760376315,115,62,53,53.91304347826087,1218,1185,33,97.29064039408867,104,33,71,31.73076923076923,20.239556713884934,1,1,0,100.0,1,1,7,6,0,0,26,Borussia Mönchengladbach,31,Germany - 1. Bundesliga
24,Andreas Hirzel,21,11.0,10,52.38095238095239,4,1,3,25.0,3,3,0,100.0,17,7,10,41.17647058823529,45.83100461996572,0,0,0,0.0,0,0,0,0,0,0,0,Hamburger SV,1,Germany - 1. Bundesliga
25,Andrej Kramarić,336,253.0,83,75.29761904761905,28,19,9,67.85714285714286,230,202,28,87.82608695652175,24,12,12,50.0,14.983987357521428,15,6,9,40.0,7,2,32,26,21,17,15,Hoffenheim,15,Germany - 1. Bundesliga
26,André Hahn,267,153.0,114,57.30337078651685,25,11,14,44.0,131,101,30,77.09923664122137,18,3,15,16.666666666666664,13.927809119722246,12,1,11,8.333333333333332,5,0,12,3,9,3,18,Borussia Mönchengladbach,15,Germany - 1. Bundesliga
27,André Ramalho Silva,612,499.0,113,81.5359477124183,61,21,40,34.42622950819672,294,286,8,97.27891156462584,89,30,59,33.70786516853933,22.424659327555293,1,0,1,0.0,1,0,5,5,0,0,8,Bayer Leverkusen,19,Germany - 1. Bundesliga
28,André Schürrle,732,570.0,162,77.8688524590164,36,23,13,63.888888888888886,516,451,65,87.40310077519379,32,12,20,37.5,14.604650632535408,38,10,28,26.31578947368421,18,3,74,34,41,20,31,Wolfsburg,29,Germany - 1. Bundesliga
29,Anthony Modeste,618,374.0,244,60.517799352750814,117,46,71,39.31623931623932,261,215,46,82.37547892720306,20,8,12,40.0,14.668934162002717,8,1,7,12.5,15,3,40,13,18,2,79,FC Köln,34,Germany - 1. Bundesliga
30,Anthony Ujah,593,359.0,234,60.53962900505903,85,40,45,47.05882352941176,271,228,43,84.13284132841329,12,5,7,41.66666666666667,13.02775335666601,14,4,10,28.57142857142857,18,0,32,16,20,7,37,Werder Bremen,32,Germany - 1. Bundesliga
31,Arianit Ferati,46,36.0,10,78.26086956521739,10,6,4,60.0,30,28,2,93.33333333333333,5,3,2,60.0,15.24846451996174,2,1,1,50.0,3,1,4,2,0,0,0,VfB Stuttgart,3,Germany - 1. Bundesliga
32,Arjen Robben,620,495.0,125,79.83870967741935,36,24,12,66.66666666666666,419,371,48,88.54415274463007,41,20,21,48.78048780487805,15.670901299346712,26,9,17,34.61538461538461,24,1,34,19,24,13,15,Bayern Munich,15,Germany - 1. Bundesliga
33,Aron Jóhannsson,100,67.0,33,67.0,6,4,2,66.66666666666666,54,47,7,87.03703703703704,15,8,7,53.333333333333336,17.602431956762402,6,2,4,33.33333333333333,7,0,7,3,4,2,6,Werder Bremen,6,Germany - 1. Bundesliga
34,Artem Kravets,180,122.0,58,67.77777777777779,20,7,13,35.0,106,89,17,83.9622641509434,5,0,5,0.0,12.9919407997596,6,0,6,0.0,4,1,11,6,8,3,5,VfB Stuttgart,15,Germany - 1. Bundesliga
35,Artoms Rudņevs,163,100.0,63,61.34969325153374,24,10,14,41.66666666666667,72,58,14,80.55555555555556,6,1,5,16.666666666666664,14.108558737048345,7,2,5,28.57142857142857,4,1,10,3,6,2,5,Hamburger SV,11,Germany - 1. Bundesliga
36,Artur Sobiech,415,297.0,118,71.56626506024097,45,16,29,35.55555555555556,232,208,24,89.65517241379311,8,3,5,37.5,11.621555991791999,6,3,3,50.0,20,0,10,7,5,3,26,Hannover 96,25,Germany - 1. Bundesliga
37,Arturo Erasmo Vidal Pardo,2027,1822.0,205,89.88653182042428,211,174,37,82.46445497630332,1468,1392,76,94.82288828337875,148,96,52,64.86486486486487,18.00913937199487,21,9,12,42.857142857142854,42,5,15,9,7,6,38,Bayern Munich,30,Germany - 1. Bundesliga
38,Assani Lukimya-Mulongoti,380,266.0,114,70.0,76,32,44,42.10526315789473,166,151,15,90.96385542168674,98,39,59,39.795918367346935,25.551067102247366,0,0,0,0.0,1,0,1,0,0,0,8,Werder Bremen,12,Germany - 1. Bundesliga
39,Aytac Sulu,568,324.0,244,57.04225352112676,172,60,112,34.883720930232556,127,116,11,91.33858267716536,196,60,136,30.612244897959183,27.853183415914227,0,0,0,0.0,10,0,2,2,0,0,56,Darmstadt 98,33,Germany - 1. Bundesliga
40,Bas Dost,398,311.0,87,78.14070351758794,40,22,18,55.00000000000001,217,200,17,92.16589861751152,13,8,5,61.53846153846154,13.820514408253267,4,1,3,25.0,10,2,4,2,3,1,10,Wolfsburg,22,Germany - 1. Bundesliga
41,Bastian Oczipka,1656,1259.0,397,76.02657004830918,145,76,69,52.41379310344828,907,821,86,90.51819184123484,180,58,122,32.22222222222222,16.788075477243478,69,15,54,21.73913043478261,22,0,69,44,36,22,34,Eintracht Frankfurt,30,Germany - 1. Bundesliga
42,Benedikt Höwedes,534,457.0,77,85.58052434456928,68,46,22,67.64705882352942,345,330,15,95.65217391304348,42,20,22,47.61904761904761,19.57581785958472,5,3,2,60.0,5,0,0,0,0,0,8,Schalke 04,15,Germany - 1. Bundesliga
43,Benjamin Gorka,5,3.0,2,60.0,2,1,1,50.0,1,1,0,100.0,1,0,1,0.0,27.1595654928,0,0,0,0.0,0,0,0,0,0,0,0,Darmstadt 98,4,Germany - 1. Bundesliga
44,Benjamin Henrichs,237,169.0,68,71.30801687763713,41,19,22,46.34146341463415,102,88,14,86.27450980392157,23,5,18,21.73913043478261,17.975682523145316,0,0,0,0.0,2,1,2,2,1,1,11,Bayer Leverkusen,9,Germany - 1. Bundesliga
45,Benjamin Hübner,720,470.0,250,65.27777777777779,142,42,100,29.577464788732392,219,196,23,89.49771689497716,147,48,99,32.6530612244898,22.902242323693997,0,0,0,0.0,3,0,7,3,0,0,42,Ingolstadt,30,Germany - 1. Bundesliga
46,Bernd Leno,1092,707.0,385,64.74358974358975,203,57,146,28.078817733990146,417,415,2,99.52038369304557,596,221,375,37.080536912751676,41.35251309450527,0,0,0,0.0,2,0,0,0,0,0,3,Bayer Leverkusen,33,Germany - 1. Bundesliga
47,Borys Tashchy,52,33.0,19,63.46153846153846,6,3,3,50.0,29,23,6,79.3103448275862,0,0,0,0.0,12.087171500566154,1,0,1,0.0,1,0,2,0,2,0,4,VfB Stuttgart,9,Germany - 1. Bundesliga
48,Branimir Hrgota,39,33.0,6,84.61538461538461,1,1,0,100.0,29,25,4,86.20689655172413,0,0,0,0.0,11.726651950412307,0,0,0,0.0,0,0,6,5,5,5,4,Borussia Mönchengladbach,9,Germany - 1. Bundesliga
49,Bruno Henrique Pinto,77,53.0,24,68.83116883116884,6,2,4,33.33333333333333,43,36,7,83.72093023255815,2,1,1,50.0,15.093713288889349,6,3,3,50.0,3,1,12,5,9,3,11,Wolfsburg,7,Germany - 1. Bundesliga
50,Caiuby Francisco da Silva,771,493.0,278,63.94293125810635,112,57,55,50.89285714285714,347,288,59,82.9971181556196,48,15,33,31.25,15.405112185200311,30,9,21,30.0,33,4,75,45,37,19,39,Augsburg,26,Germany - 1. Bundesliga
51,Carlos Antonio Ascues Ávila,6,5.0,1,83.33333333333334,1,0,1,0.0,3,3,0,100.0,2,1,1,50.0,28.208708428799998,0,0,0,0.0,0,0,1,1,0,0,0,Wolfsburg,1,Germany - 1. Bundesliga
52,Carlos Armando Gruezo Arboleda,18,10.0,8,55.55555555555556,5,1,4,20.0,7,5,2,71.42857142857143,3,1,2,33.33333333333333,19.80316741924,0,0,0,0.0,0,0,0,0,0,0,0,VfB Stuttgart,2,Germany - 1. Bundesliga
53,Carlos Augusto Zambrano Ochandarte,920,767.0,153,83.36956521739131,91,48,43,52.74725274725275,560,528,32,94.28571428571428,99,35,64,35.35353535353536,20.67851362223207,0,0,0,0.0,1,0,13,12,0,0,62,Eintracht Frankfurt,24,Germany - 1. Bundesliga
54,Ceyhun Gülselam,423,308.0,115,72.81323877068559,83,43,40,51.80722891566265,218,195,23,89.44954128440367,56,26,30,46.42857142857143,19.502470383596595,4,3,1,75.0,6,1,12,8,4,2,18,Hannover 96,13,Germany - 1. Bundesliga
55,Charles Mariano Aránguiz Sandoval,224,165.0,59,73.66071428571429,25,16,9,64.0,117,100,17,85.47008547008546,40,22,18,55.00000000000001,19.491098659148573,5,1,4,20.0,4,1,2,2,0,0,14,Bayer Leverkusen,7,Germany - 1. Bundesliga
56,Charlison Benschop,74,52.0,22,70.27027027027027,8,3,5,37.5,35,30,5,85.71428571428571,1,0,1,0.0,13.787584980363244,2,0,2,0.0,1,0,0,0,0,0,2,Hannover 96,9,Germany - 1. Bundesliga
57,Christian Clemens,535,337.0,198,62.99065420560748,58,30,28,51.724137931034484,272,218,54,80.14705882352942,100,30,70,30.0,18.718081976929795,33,12,21,36.36363636363637,28,2,38,18,22,10,20,FSV Mainz 05,28,Germany - 1. Bundesliga
58,Christian Gentner,1354,993.0,361,73.33825701624815,229,135,94,58.951965065502186,730,653,77,89.45205479452055,138,56,82,40.57971014492754,17.614886106620208,33,5,28,15.151515151515152,25,2,28,20,12,8,63,VfB Stuttgart,29,Germany - 1. Bundesliga
59,Christian Mathenia,1067,431.0,636,40.393626991565135,515,167,348,32.42718446601941,41,39,2,95.1219512195122,995,368,627,36.984924623115575,59.141881885111154,0,0,0,0.0,2,0,0,0,0,0,4,Darmstadt 98,33,Germany - 1. Bundesliga
60,Christian Pulisic,190,143.0,47,75.26315789473685,9,8,1,88.88888888888889,143,123,20,86.01398601398601,10,2,8,20.0,13.448800836579789,19,5,14,26.31578947368421,7,0,19,7,12,3,10,Borussia Dortmund,9,Germany - 1. Bundesliga
61,Christian Schulz,996,821.0,175,82.429718875502,92,40,52,43.47826086956522,584,565,19,96.74657534246576,103,35,68,33.980582524271846,20.447789517503132,4,1,3,25.0,4,0,2,2,1,1,12,Hannover 96,25,Germany - 1. Bundesliga
62,Christian Träsch,1729,1363.0,366,78.8316946211683,230,142,88,61.73913043478261,908,848,60,93.3920704845815,234,92,142,39.31623931623932,19.54043791289344,82,23,59,28.04878048780488,24,1,43,23,19,5,32,Wolfsburg,29,Germany - 1. Bundesliga
63,Christoph Janker,150,124.0,26,82.66666666666667,11,5,6,45.45454545454545,84,81,3,96.42857142857143,14,6,8,42.857142857142854,21.1062494915568,0,0,0,0.0,0,0,1,0,0,0,7,Augsburg,11,Germany - 1. Bundesliga
64,Christoph Kramer,1558,1283.0,275,82.34916559691912,184,99,85,53.80434782608695,970,904,66,93.19587628865979,145,72,73,49.6551724137931,16.827704542195995,16,6,10,37.5,14,1,39,21,22,9,38,Bayer Leverkusen,28,Germany - 1. Bundesliga
65,Christoph Moritz,118,101.0,17,85.59322033898306,8,3,5,37.5,79,75,4,94.9367088607595,3,0,3,0.0,15.16634153967051,2,0,2,0.0,0,0,2,1,1,0,3,FSV Mainz 05,8,Germany - 1. Bundesliga
66,Claudio Miguel Pizarro Bossio,593,414.0,179,69.81450252951096,81,43,38,53.086419753086425,343,277,66,80.75801749271136,25,17,8,68.0,13.968141866167933,3,2,1,66.66666666666666,27,3,46,29,16,9,23,Werder Bremen,28,Germany - 1. Bundesliga
67,Cleber Janderson Pereira Reis,758,587.0,171,77.44063324538259,93,43,50,46.236559139784944,377,357,20,94.6949602122016,137,59,78,43.06569343065693,24.132281628519262,1,0,1,0.0,1,0,18,15,1,0,15,Hamburger SV,23,Germany - 1. Bundesliga
68,Clemens Fritz,1035,764.0,271,73.81642512077295,189,111,78,58.730158730158735,541,475,66,87.8003696857671,154,72,82,46.75324675324675,20.185696720683826,16,5,11,31.25,15,2,47,33,14,9,91,Werder Bremen,29,Germany - 1. Bundesliga
69,Daniel Baier,1511,1123.0,388,74.3216412971542,316,170,146,53.79746835443038,754,699,55,92.70557029177718,294,108,186,36.734693877551024,22.528017824196294,20,10,10,50.0,48,2,16,10,6,2,49,Augsburg,28,Germany - 1. Bundesliga
70,Daniel Brosinski,1362,933.0,429,68.5022026431718,207,97,110,46.85990338164252,513,445,68,86.74463937621833,288,108,180,37.5,22.01065471287436,55,17,38,30.909090909090907,20,2,28,18,15,7,33,FSV Mainz 05,30,Germany - 1. Bundesliga
71,Daniel Caligiuri,844,644.0,200,76.30331753554502,65,34,31,52.307692307692314,539,469,70,87.01298701298701,60,30,30,50.0,16.65518806376019,48,15,33,31.25,26,5,112,53,71,35,55,Wolfsburg,29,Germany - 1. Bundesliga
72,Daniel Didavi,1027,752.0,275,73.22297955209348,154,78,76,50.649350649350644,622,556,66,89.38906752411575,110,35,75,31.818181818181817,17.993341799898346,47,17,30,36.17021276595745,32,3,36,23,26,14,66,VfB Stuttgart,31,Germany - 1. Bundesliga
73,Daniel Ginczek,190,111.0,79,58.42105263157895,9,4,5,44.44444444444444,89,70,19,78.65168539325843,4,2,2,50.0,12.610432594038317,7,2,5,28.57142857142857,12,1,21,13,17,10,15,VfB Stuttgart,7,Germany - 1. Bundesliga
74,Daniel Schwaab,1187,904.0,283,76.15838247683236,214,109,105,50.93457943925234,545,509,36,93.39449541284404,168,59,109,35.11904761904761,21.717754872019615,9,4,5,44.44444444444444,5,1,18,16,4,3,20,VfB Stuttgart,29,Germany - 1. Bundesliga
75,Daniel Tawiah Opare,138,89.0,49,64.4927536231884,19,6,13,31.57894736842105,50,43,7,86.0,32,9,23,28.125,20.92191897992348,7,2,5,28.57142857142857,2,0,14,6,3,2,7,Augsburg,4,Germany - 1. Bundesliga
76,Danilo Teodoro Soares,36,20.0,16,55.55555555555556,7,1,6,14.285714285714285,8,6,2,75.0,4,1,3,25.0,18.61647337658,3,2,1,66.66666666666666,0,0,2,1,2,1,6,Ingolstadt,1,Germany - 1. Bundesliga
77,Danny Latza,1189,950.0,239,79.89907485281749,132,75,57,56.81818181818182,690,638,52,92.46376811594203,140,63,77,45.0,19.745216580768645,21,6,15,28.57142857142857,28,2,13,10,5,2,38,FSV Mainz 05,27,Germany - 1. Bundesliga
78,Danny Vieira da Costa,807,547.0,260,67.7819083023544,151,85,66,56.29139072847682,269,216,53,80.29739776951673,96,32,64,33.33333333333333,17.891622472200446,27,7,20,25.925925925925924,10,3,36,18,24,12,17,Ingolstadt,19,Germany - 1. Bundesliga
79,Dante Bonfim da Costa Santos,1678,1477.0,201,88.02145411203814,167,93,74,55.688622754491014,1098,1070,28,97.44990892531877,166,60,106,36.144578313253014,22.215838365909224,0,0,0,0.0,4,0,3,2,1,1,19,Wolfsburg,24,Germany - 1. Bundesliga
80,Dario Kresic,18,11.0,7,61.111111111111114,2,1,1,50.0,1,1,0,100.0,16,10,6,62.5,52.731817218399996,0,0,0,0.0,0,0,0,0,0,0,0,Bayer Leverkusen,1,Germany - 1. Bundesliga
81,Dario Lezcano,311,211.0,100,67.84565916398714,29,10,19,34.48275862068966,184,146,38,79.34782608695652,6,3,3,50.0,11.727538770573377,9,1,8,11.11111111111111,15,1,40,23,25,14,43,Ingolstadt,17,Germany - 1. Bundesliga
82,David Kinsombi,15,11.0,4,73.33333333333333,5,2,3,40.0,7,7,0,100.0,4,1,3,25.0,22.245152922864,0,0,0,0.0,0,0,0,0,0,0,0,Eintracht Frankfurt,1,Germany - 1. Bundesliga
83,David Olatukunbo Alaba,2536,2340.0,196,92.27129337539432,282,234,48,82.97872340425532,1912,1864,48,97.48953974895397,119,54,65,45.378151260504204,17.60081585112199,31,10,21,32.25806451612903,18,0,12,7,7,4,22,Bayern Munich,30,Germany - 1. Bundesliga
84,David Yelldell,20,6.0,14,30.0,4,1,3,25.0,1,1,0,100.0,17,3,14,17.647058823529413,56.106960333480004,0,0,0,0.0,0,0,0,0,0,0,0,Bayer Leverkusen,1,Germany - 1. Bundesliga
85,David Ángel Abraham,1104,892.0,212,80.79710144927536,107,47,60,43.925233644859816,595,577,18,96.97478991596638,152,60,92,39.473684210526315,21.98992594386,1,0,1,0.0,5,0,9,3,1,0,31,Eintracht Frankfurt,31,Germany - 1. Bundesliga
86,Dennis Aogo,1224,982.0,242,80.22875816993465,96,67,29,69.79166666666666,619,579,40,93.53796445880452,125,53,72,42.4,18.01323311426765,72,21,51,29.166666666666668,25,1,12,8,5,3,15,Schalke 04,23,Germany - 1. Bundesliga
87,Dennis Diekmeier,669,493.0,176,73.69207772795217,67,30,37,44.776119402985074,329,302,27,91.7933130699088,75,25,50,33.33333333333333,18.494536508827263,37,12,25,32.432432432432435,8,0,14,9,5,3,22,Hamburger SV,22,Germany - 1. Bundesliga
88,Devante James Parker,1,1.0,0,100.0,0,0,0,0.0,1,1,0,100.0,0,0,0,0.0,4.42705607856,0,0,0,0.0,0,0,0,0,0,0,0,FSV Mainz 05,1,Germany - 1. Bundesliga
89,Diego Orlando Benaglio,733,587.0,146,80.0818553888131,30,4,26,13.333333333333334,366,365,1,99.72677595628416,261,119,142,45.593869731800766,32.25667414181697,0,0,0,0.0,0,0,0,0,0,0,3,Wolfsburg,21,Germany - 1. Bundesliga
90,Dominik Kohr,1124,860.0,264,76.51245551601423,185,108,77,58.37837837837838,623,550,73,88.28250401284109,132,48,84,36.36363636363637,19.90195512143253,5,1,4,20.0,5,2,25,10,13,3,51,Augsburg,31,Germany - 1. Bundesliga
91,Dominik Maroh,1162,1019.0,143,87.69363166953529,55,28,27,50.90909090909091,696,679,17,97.5574712643678,99,46,53,46.464646464646464,21.400460712567572,0,0,0,0.0,0,0,1,0,0,0,16,FC Köln,25,Germany - 1. Bundesliga
92,Dominik Stroh-Engel,119,68.0,51,57.14285714285714,20,9,11,45.0,44,36,8,81.81818181818183,4,2,2,50.0,12.660878315181177,2,1,1,50.0,3,1,2,0,2,0,10,Darmstadt 98,15,Germany - 1. Bundesliga
93,Dominique Heintz,1484,1219.0,265,82.14285714285714,199,94,105,47.23618090452261,803,769,34,95.76587795765879,228,82,146,35.96491228070175,23.5648720097641,13,3,10,23.076923076923077,3,0,20,14,2,0,18,FC Köln,33,Germany - 1. Bundesliga
94,Dong-Won Ji,308,230.0,78,74.67532467532467,36,19,17,52.77777777777778,163,141,22,86.50306748466258,23,10,13,43.47826086956522,15.694933753019221,10,5,5,50.0,13,0,15,5,7,2,13,Augsburg,21,Germany - 1. Bundesliga
95,Douglas Costa de Souza,1118,812.0,306,72.62969588550983,84,53,31,63.095238095238095,740,619,121,83.64864864864865,133,48,85,36.09022556390977,17.536029855398212,114,36,78,31.57894736842105,36,9,116,59,69,37,26,Bayern Munich,27,Germany - 1. Bundesliga
96,Dušan Švento,62,35.0,27,56.451612903225815,9,5,4,55.55555555555556,30,24,6,80.0,12,2,10,16.666666666666664,18.649635259587097,8,1,7,12.5,1,0,4,3,3,2,1,FC Köln,7,Germany - 1. Bundesliga
97,Edgar Prib,630,425.0,205,67.46031746031747,82,49,33,59.756097560975604,303,269,34,88.77887788778878,120,39,81,32.5,18.83592681938057,36,10,26,27.77777777777778,16,2,39,16,18,8,28,Hannover 96,20,Germany - 1. Bundesliga
98,Eduardo Jesús Vargas Rojas,557,407.0,150,73.07001795332137,82,43,39,52.4390243902439,348,295,53,84.77011494252874,34,17,17,50.0,15.287740497322254,13,4,9,30.76923076923077,24,3,58,39,27,19,23,Hoffenheim,24,Germany - 1. Bundesliga
99,Elias Kachunga,75,48.0,27,64.0,9,2,7,22.22222222222222,44,35,9,79.54545454545455,3,0,3,0.0,12.3126295658016,2,0,2,0.0,0,0,5,2,2,1,10,Ingolstadt,10,Germany - 1. Bundesliga
100,Emiliano Adrián Insúa Zapata,1678,1224.0,454,72.94398092967819,258,136,122,52.71317829457365,709,638,71,89.98589562764458,218,67,151,30.73394495412844,18.80342992601764,69,24,45,34.78260869565217,29,1,56,37,28,15,37,VfB Stuttgart,33,Germany - 1. Bundesliga
101,Emir Spahić,1290,999.0,291,77.44186046511628,188,81,107,43.08510638297872,637,606,31,95.13343799058084,229,83,146,36.24454148471616,23.26676906346257,5,2,3,40.0,2,0,9,8,1,0,10,Hamburger SV,26,Germany - 1. Bundesliga
102,Erik Durm,527,404.0,123,76.66034155597723,58,34,24,58.620689655172406,298,262,36,87.91946308724832,49,18,31,36.734693877551024,17.204706441521214,19,5,14,26.31578947368421,7,1,20,14,7,4,10,Borussia Dortmund,14,Germany - 1. Bundesliga
103,Ermin Bičakčić,760,631.0,129,83.02631578947368,82,39,43,47.5609756097561,462,449,13,97.18614718614718,85,30,55,35.294117647058826,20.573142739327988,1,0,1,0.0,2,0,4,2,1,1,21,Hoffenheim,21,Germany - 1. Bundesliga
104,Eugen Polanski,899,691.0,208,76.86318131256952,158,78,80,49.36708860759494,589,526,63,89.30390492359932,79,21,58,26.582278481012654,18.4693002950707,8,2,6,25.0,14,3,24,16,6,4,48,Hoffenheim,27,Germany - 1. Bundesliga
105,Fabian Frei,441,336.0,105,76.19047619047619,55,28,27,50.90909090909091,236,221,15,93.64406779661016,45,20,25,44.44444444444444,19.358193790208983,8,4,4,50.0,7,2,6,3,3,2,4,FSV Mainz 05,17,Germany - 1. Bundesliga
106,Fabian Holland,451,281.0,170,62.3059866962306,120,52,68,43.333333333333336,110,95,15,86.36363636363636,97,31,66,31.958762886597935,21.757936545506873,12,2,10,16.666666666666664,5,0,5,4,2,1,25,Darmstadt 98,18,Germany - 1. Bundesliga
107,Fabian Johnson,917,706.0,211,76.99018538713194,68,34,34,50.0,641,558,83,87.05148205928236,34,15,19,44.11764705882353,13.831177161384078,20,7,13,35.0,26,3,37,17,19,8,26,Borussia Mönchengladbach,26,Germany - 1. Bundesliga
108,Fabian Lukas Schär,888,705.0,183,79.3918918918919,157,71,86,45.22292993630573,446,422,24,94.61883408071749,167,70,97,41.91616766467065,24.99270859129054,0,0,0,0.0,5,0,9,7,2,2,21,Hoffenheim,24,Germany - 1. Bundesliga
109,Fabian Lustenberger,1389,1221.0,168,87.90496760259178,100,51,49,51.0,852,816,36,95.77464788732394,115,58,57,50.43478260869565,21.542645521432743,0,0,0,0.0,8,0,5,4,1,1,51,Hertha Berlin,30,Germany - 1. Bundesliga
110,Fabian Reese,3,2.0,1,66.66666666666666,0,0,0,0.0,1,1,0,100.0,0,0,0,0.0,7.3267270788,0,0,0,0.0,1,0,0,0,0,0,0,Schalke 04,1,Germany - 1. Bundesliga
111,Federico Barba,75,60.0,15,80.0,9,4,5,44.44444444444444,42,39,3,92.85714285714286,7,4,3,57.14285714285714,18.8982095670816,0,0,0,0.0,0,0,0,0,0,0,2,VfB Stuttgart,2,Germany - 1. Bundesliga
112,Felipe Trevizan Martins,28,20.0,8,71.42857142857143,4,3,1,75.0,9,9,0,100.0,5,2,3,40.0,21.239602961400003,0,0,0,0.0,0,0,2,1,1,1,5,Hannover 96,8,Germany - 1. Bundesliga
113,Felix Klaus,208,148.0,60,71.15384615384616,10,4,6,40.0,115,95,20,82.6086956521739,12,7,5,58.333333333333336,14.037984704596154,3,2,1,66.66666666666666,5,0,23,10,16,9,29,Hannover 96,18,Germany - 1. Bundesliga
114,Felix Kroos,101,75.0,26,74.25742574257426,20,11,9,55.00000000000001,50,44,6,88.0,11,3,8,27.27272727272727,16.82731957841822,1,0,1,0.0,3,0,2,1,0,0,5,Werder Bremen,8,Germany - 1. Bundesliga
115,Felix Passlack,126,107.0,19,84.92063492063492,13,10,3,76.92307692307693,88,82,6,93.18181818181817,5,1,4,20.0,15.144467156485714,2,0,2,0.0,1,0,1,0,1,0,1,Borussia Dortmund,3,Germany - 1. Bundesliga
116,Felix Platte,49,24.0,25,48.97959183673469,11,5,6,45.45454545454545,15,11,4,73.33333333333333,7,1,6,14.285714285714285,16.750527586207347,2,0,2,0.0,2,0,4,2,2,1,4,Darmstadt 98,12,Germany - 1. Bundesliga
117,Felix Wiedwald,1033,633.0,400,61.27783155856727,131,42,89,32.06106870229007,245,242,3,98.77551020408163,700,312,388,44.57142857142857,44.36361885871202,0,0,0,0.0,0,0,1,1,0,0,8,Werder Bremen,34,Germany - 1. Bundesliga
118,Filip Kostić,1089,589.0,500,54.08631772268136,94,42,52,44.680851063829785,489,354,135,72.39263803680981,239,75,164,31.380753138075313,19.728742982897188,162,45,117,27.77777777777778,71,5,88,50,51,32,47,VfB Stuttgart,30,Germany - 1. Bundesliga
119,Filip Mladenović,383,277.0,106,72.32375979112271,29,15,14,51.724137931034484,178,155,23,87.07865168539325,63,26,37,41.269841269841265,19.57247564760188,28,10,18,35.714285714285715,11,2,15,5,6,4,7,FC Köln,14,Germany - 1. Bundesliga
120,Fin Bartels,663,487.0,176,73.45399698340876,69,44,25,63.76811594202898,406,338,68,83.2512315270936,45,16,29,35.55555555555556,15.95252649185267,30,9,21,30.0,21,1,78,39,44,23,36,Werder Bremen,30,Germany - 1. Bundesliga
121,Florian Grillitsch,913,670.0,243,73.38444687842278,120,66,54,55.00000000000001,485,425,60,87.62886597938144,119,48,71,40.33613445378151,19.07391917953262,16,6,10,37.5,19,2,27,12,13,3,43,Werder Bremen,25,Germany - 1. Bundesliga
122,Florian Jungwirth,492,298.0,194,60.56910569105691,75,38,37,50.66666666666667,132,108,24,81.81818181818183,76,23,53,30.263157894736842,20.145760248242926,15,6,9,40.0,5,0,3,1,2,1,22,Darmstadt 98,19,Germany - 1. Bundesliga
123,Florian Klein,670,481.0,189,71.7910447761194,94,56,38,59.57446808510638,269,241,28,89.59107806691449,68,17,51,25.0,16.92531596337958,29,13,16,44.827586206896555,12,1,12,9,10,7,17,VfB Stuttgart,22,Germany - 1. Bundesliga
124,Florian Kohls,3,2.0,1,66.66666666666666,0,0,0,0.0,2,2,0,100.0,0,0,0,0.0,13.0675087392,0,0,0,0.0,0,0,0,0,0,0,0,Hertha Berlin,1,Germany - 1. Bundesliga
125,Florian Niederlechner,37,20.0,17,54.054054054054056,5,1,4,20.0,22,16,6,72.72727272727273,2,0,2,0.0,14.624831556077837,0,0,0,0.0,0,0,2,0,2,0,4,FSV Mainz 05,12,Germany - 1. Bundesliga
126,Francisco José Rodriguez Araya,19,16.0,3,84.21052631578947,4,3,1,75.0,12,11,1,91.66666666666666,3,2,1,66.66666666666666,21.31419832976842,0,0,0,0.0,1,0,0,0,0,0,0,Wolfsburg,1,Germany - 1. Bundesliga
127,Franck Bilal Ribéry,558,431.0,127,77.24014336917563,55,37,18,67.27272727272727,396,347,49,87.62626262626263,59,25,34,42.3728813559322,16.299209990025805,37,11,26,29.72972972972973,23,3,61,29,39,19,17,Bayern Munich,13,Germany - 1. Bundesliga
128,Franco Matías Di Santo,299,185.0,114,61.87290969899666,37,17,20,45.94594594594595,128,97,31,75.78125,25,13,12,52.0,14.056793939699396,16,10,6,62.5,16,1,17,8,7,3,16,Schalke 04,25,Germany - 1. Bundesliga
129,Frederik Hillesborg Sørensen,905,685.0,220,75.69060773480662,142,61,81,42.95774647887324,399,375,24,93.98496240601504,190,73,117,38.421052631578945,24.892150059394208,3,1,2,33.33333333333333,1,2,8,5,1,0,18,FC Köln,22,Germany - 1. Bundesliga
130,Fynn Arkenberg,59,36.0,23,61.016949152542374,12,4,8,33.33333333333333,19,17,2,89.47368421052632,10,3,7,30.0,18.995551547271866,2,1,1,50.0,0,0,3,2,2,2,3,Hannover 96,2,Germany - 1. Bundesliga
131,Gaëtan Bussmann,613,403.0,210,65.74225122349104,103,47,56,45.63106796116505,199,172,27,86.4321608040201,88,23,65,26.136363636363637,18.927795535231713,19,4,15,21.052631578947366,10,0,5,4,3,2,10,FSV Mainz 05,13,Germany - 1. Bundesliga
132,Genki Haraguchi,778,558.0,220,71.72236503856041,70,39,31,55.714285714285715,482,397,85,82.36514522821577,39,18,21,46.15384615384615,14.867374266777377,57,21,36,36.84210526315789,23,3,90,54,47,29,42,Hertha Berlin,32,Germany - 1. Bundesliga
133,Georg Niedermeier,638,524.0,114,82.13166144200626,50,22,28,44.0,350,337,13,96.28571428571429,71,26,45,36.61971830985916,22.020493236597368,0,0,0,0.0,3,1,0,0,0,0,8,VfB Stuttgart,18,Germany - 1. Bundesliga
134,Gian-Luca Waldschmidt,72,53.0,19,73.61111111111111,6,4,2,66.66666666666666,52,40,12,76.92307692307693,5,1,4,20.0,13.055440881700001,5,3,2,60.0,7,1,11,4,10,3,6,Eintracht Frankfurt,12,Germany - 1. Bundesliga
135,Gideon Jung,455,350.0,105,76.92307692307693,63,33,30,52.38095238095239,270,236,34,87.4074074074074,44,19,25,43.18181818181818,17.551837780832493,0,0,0,0.0,3,0,16,9,5,2,26,Hamburger SV,18,Germany - 1. Bundesliga
136,Giulio Donati,1043,720.0,323,69.03163950143816,186,108,78,58.06451612903226,391,326,65,83.37595907928389,153,53,100,34.64052287581699,19.656717201278543,31,6,25,19.35483870967742,8,1,27,13,13,6,52,FSV Mainz 05,23,Germany - 1. Bundesliga
137,Gojko Kačar,529,412.0,117,77.882797731569,70,29,41,41.42857142857143,303,273,30,90.0990099009901,41,13,28,31.70731707317073,18.343152981807652,1,1,0,100.0,1,0,5,4,1,0,14,Hamburger SV,19,Germany - 1. Bundesliga
138,Gonzalo Alejandro Jara Reyes,229,178.0,51,77.72925764192141,30,21,9,70.0,112,105,7,93.75,39,17,22,43.58974358974359,21.236098504433187,2,0,2,0.0,3,0,4,2,0,0,4,FSV Mainz 05,6,Germany - 1. Bundesliga
139,Gonzalo Castro Randon,1016,833.0,183,81.98818897637796,108,65,43,60.18518518518518,758,680,78,89.70976253298153,55,24,31,43.63636363636363,16.060664266739998,13,0,13,0.0,22,7,35,16,19,10,23,Borussia Dortmund,25,Germany - 1. Bundesliga
140,Gotoku Sakai,1031,761.0,270,73.81183317167799,111,61,50,54.95495495495496,472,423,49,89.61864406779661,130,50,80,38.46153846153847,17.84463113927907,30,8,22,26.666666666666668,13,1,24,16,7,5,13,Hamburger SV,22,Germany - 1. Bundesliga
141,Granit Xhaka,2219,1895.0,324,85.3988283010365,359,243,116,67.68802228412257,1403,1312,91,93.51389878831077,232,139,93,59.91379310344828,19.903410596566236,4,0,4,0.0,17,0,38,25,6,5,56,Borussia Mönchengladbach,28,Germany - 1. Bundesliga
142,Gustavo Adrián Ramos Vásquez,258,179.0,79,69.37984496124031,29,16,13,55.172413793103445,144,119,25,82.63888888888889,13,10,3,76.92307692307693,14.110546784963722,5,2,3,40.0,7,3,23,16,20,15,20,Borussia Dortmund,27,Germany - 1. Bundesliga
143,György Garics,627,392.0,235,62.51993620414673,125,51,74,40.8,159,143,16,89.937106918239,127,41,86,32.28346456692913,21.28165533646966,12,5,7,41.66666666666667,3,0,6,5,3,2,7,Darmstadt 98,21,Germany - 1. Bundesliga
144,Hakan Çalhanoğlu,1457,997.0,460,68.42827728208648,202,116,86,57.42574257425742,749,670,79,89.45260347129505,333,124,209,37.23723723723724,19.931473569850493,86,29,57,33.72093023255814,74,5,54,31,31,19,34,Bayer Leverkusen,31,Germany - 1. Bundesliga
145,Halil Altıntop,378,298.0,80,78.83597883597884,45,22,23,48.888888888888886,265,230,35,86.79245283018868,25,12,13,48.0,16.30560752745238,3,0,3,0.0,13,2,19,11,8,3,18,Augsburg,19,Germany - 1. Bundesliga
146,Haris Seferović,900,576.0,324,64.0,97,34,63,35.051546391752574,455,372,83,81.75824175824175,57,23,34,40.35087719298245,15.526143920472,43,14,29,32.55813953488372,20,4,27,15,14,7,32,Eintracht Frankfurt,29,Germany - 1. Bundesliga
147,Henrikh Mkhitaryan,1487,1059.0,428,71.21721587088096,127,62,65,48.818897637795274,971,803,168,82.6982492276004,150,63,87,42.0,16.284688149494446,80,23,57,28.749999999999996,63,13,136,74,69,37,70,Borussia Dortmund,31,Germany - 1. Bundesliga
148,Heung-Min Son,18,14.0,4,77.77777777777779,2,1,1,50.0,15,12,3,80.0,1,1,0,100.0,13.6632514644,1,0,1,0.0,0,0,3,1,1,1,0,Bayer Leverkusen,1,Germany - 1. Bundesliga
149,Hiroki Sakai,1300,935.0,365,71.92307692307692,152,76,76,50.0,576,498,78,86.45833333333334,129,41,88,31.782945736434108,17.45991088773231,40,9,31,22.5,11,0,19,11,8,3,22,Hannover 96,26,Germany - 1. Bundesliga
150,Hiroshi Kiyotake,996,719.0,277,72.18875502008032,148,102,46,68.91891891891892,586,516,70,88.05460750853243,159,58,101,36.477987421383645,17.55156938400072,48,11,37,22.916666666666664,50,6,59,43,27,17,39,Hannover 96,21,Germany - 1. Bundesliga
151,Holger Badstuber,395,357.0,38,90.37974683544304,22,15,7,68.18181818181817,260,257,3,98.84615384615385,31,15,16,48.38709677419355,19.854613187258128,1,0,1,0.0,1,0,0,0,0,0,2,Bayern Munich,7,Germany - 1. Bundesliga
152,Hotaru Yamaguchi,167,139.0,28,83.23353293413174,14,8,6,57.14285714285714,116,108,8,93.10344827586206,7,3,4,42.857142857142854,15.17795963946625,1,0,1,0.0,1,0,1,0,0,0,1,Hannover 96,6,Germany - 1. Bundesliga
153,Hugo Miguel Pereira de Almeida,210,113.0,97,53.80952380952381,27,10,17,37.03703703703704,57,45,12,78.94736842105263,21,6,15,28.57142857142857,15.681252732500571,11,4,7,36.36363636363637,6,0,4,3,3,3,6,Hannover 96,7,Germany - 1. Bundesliga
154,Håvard Nordtveit,1768,1471.0,297,83.20135746606336,240,117,123,48.75,1030,979,51,95.04854368932038,204,74,130,36.27450980392157,22.201319869922035,5,3,2,60.0,7,1,9,6,4,3,23,Borussia Mönchengladbach,31,Germany - 1. Bundesliga
155,Ibrahima Traoré,775,569.0,206,73.41935483870968,61,37,24,60.65573770491803,497,409,88,82.29376257545272,107,47,60,43.925233644859816,17.969293008544412,47,16,31,34.04255319148936,34,1,94,60,42,25,43,Borussia Mönchengladbach,24,Germany - 1. Bundesliga
156,Ismail Azzaoui,9,7.0,2,77.77777777777779,1,1,0,100.0,8,7,1,87.5,0,0,0,0.0,12.5489905484,2,0,2,0.0,0,0,1,1,1,1,0,Wolfsburg,2,Germany - 1. Bundesliga
157,Ivan Perišić,84,59.0,25,70.23809523809523,9,7,2,77.77777777777779,53,44,9,83.01886792452831,9,3,6,33.33333333333333,16.644130279654284,9,1,8,11.11111111111111,2,0,2,1,0,0,1,Wolfsburg,2,Germany - 1. Bundesliga
158,Iver Tobias Rørvik Fossum,323,235.0,88,72.75541795665634,36,21,15,58.333333333333336,208,180,28,86.53846153846155,15,7,8,46.666666666666664,14.143261665270094,7,2,5,28.57142857142857,10,0,13,7,5,2,9,Hannover 96,9,Germany - 1. Bundesliga
159,Ivica Olić,54,32.0,22,59.25925925925925,1,0,1,0.0,25,16,9,64.0,4,0,4,0.0,12.423328141186666,5,0,5,0.0,1,0,1,1,1,1,0,Hamburger SV,9,Germany - 1. Bundesliga
160,Ivo Iličević,839,602.0,237,71.75208581644816,102,62,40,60.78431372549019,513,427,86,83.23586744639377,68,26,42,38.23529411764706,15.761189619978737,44,8,36,18.181818181818183,26,2,69,44,29,19,47,Hamburger SV,31,Germany - 1. Bundesliga
161,Ja-Cheol Koo,843,666.0,177,79.00355871886121,94,58,36,61.702127659574465,533,486,47,91.18198874296435,60,25,35,41.66666666666667,15.401952291846234,16,7,9,43.75,26,1,41,28,14,9,51,Augsburg,29,Germany - 1. Bundesliga
162,Jairo Samperio Bustara,658,437.0,221,66.41337386018236,75,41,34,54.666666666666664,399,309,90,77.44360902255639,37,15,22,40.54054054054054,14.72135424980553,25,6,19,24.0,23,4,106,44,64,26,56,FSV Mainz 05,31,Germany - 1. Bundesliga
163,Jan Kliment,45,34.0,11,75.55555555555556,5,2,3,40.0,29,25,4,86.20689655172413,2,0,2,0.0,13.5875771428,3,2,1,66.66666666666666,3,0,5,2,4,1,1,VfB Stuttgart,8,Germany - 1. Bundesliga
164,Jan Morávek,177,136.0,41,76.8361581920904,15,8,7,53.333333333333336,114,99,15,86.8421052631579,6,2,4,33.33333333333333,13.809961623315255,1,0,1,0.0,5,0,5,2,4,2,2,Augsburg,11,Germany - 1. Bundesliga
165,Jan Rosenthal,375,221.0,154,58.93333333333334,59,16,43,27.11864406779661,167,134,33,80.23952095808383,26,8,18,30.76923076923077,15.085475335029118,10,4,6,40.0,8,1,22,13,11,7,19,Darmstadt 98,23,Germany - 1. Bundesliga
166,Jan-Ingwer Callsen-Bracker,346,291.0,55,84.10404624277457,37,17,20,45.94594594594595,177,174,3,98.30508474576271,53,22,31,41.509433962264154,24.846472781977106,0,0,0,0.0,1,0,0,0,0,0,4,Augsburg,10,Germany - 1. Bundesliga
167,Janek Sternberg,201,134.0,67,66.66666666666666,24,9,15,37.5,84,75,9,89.28571428571429,26,9,17,34.61538461538461,18.949540491693135,12,4,8,33.33333333333333,2,0,7,6,2,2,9,Werder Bremen,9,Germany - 1. Bundesliga
168,Jannik Vestergaard,1292,974.0,318,75.38699690402477,229,100,129,43.66812227074236,619,582,37,94.02261712439419,228,88,140,38.59649122807017,24.180765638573313,2,0,2,0.0,4,0,15,11,1,1,30,Werder Bremen,33,Germany - 1. Bundesliga
169,Jaroslav Drobný,314,158.0,156,50.318471337579616,70,13,57,18.571428571428573,62,62,0,100.0,224,71,153,31.69642857142857,49.5829791693149,0,0,0,0.0,0,1,2,2,0,0,1,Hamburger SV,10,Germany - 1. Bundesliga
170,Javier Hernández Balcázar,549,407.0,142,74.13479052823315,38,24,14,63.1578947368421,334,277,57,82.93413173652695,28,10,18,35.714285714285715,13.565221187395409,23,7,16,30.434782608695656,24,2,45,22,22,10,60,Bayer Leverkusen,28,Germany - 1. Bundesliga
171,Javier Martínez Aginaga,907,811.0,96,89.41565600882029,77,56,21,72.72727272727273,629,620,9,98.5691573926868,49,25,24,51.02040816326531,18.883772507554134,4,2,2,50.0,5,1,2,0,0,0,15,Bayern Munich,16,Germany - 1. Bundesliga
172,Jean-Eric Maxim Choupo-Moting,732,529.0,203,72.26775956284153,66,30,36,45.45454545454545,433,374,59,86.37413394919169,46,28,18,60.86956521739131,14.794269471849836,39,21,18,53.84615384615385,31,2,123,79,57,33,48,Schalke 04,28,Germany - 1. Bundesliga
173,Jeffrey Gouweleeuw,511,403.0,108,78.86497064579257,95,44,51,46.31578947368421,264,248,16,93.93939393939394,104,40,64,38.46153846153847,25.449020214553972,1,0,1,0.0,3,0,3,2,1,0,6,Augsburg,11,Germany - 1. Bundesliga
174,Jens Grahl,25,20.0,5,80.0,1,0,1,0.0,17,17,0,100.0,7,2,5,28.57142857142857,28.676097417311997,0,0,0,0.0,0,0,0,0,0,0,0,Hoffenheim,1,Germany - 1. Bundesliga
175,Jens Hegeler,215,180.0,35,83.72093023255815,27,18,9,66.66666666666666,144,134,10,93.05555555555556,5,1,4,20.0,14.63603124478772,0,0,0,0.0,1,0,5,5,1,1,8,Hertha Berlin,15,Germany - 1. Bundesliga
176,Jeong-Ho Hong,919,776.0,143,84.43960826985855,95,57,38,60.0,478,458,20,95.81589958158996,124,64,60,51.61290322580645,24.807868270039783,2,1,1,50.0,3,0,2,2,0,0,14,Augsburg,23,Germany - 1. Bundesliga
177,Jeremy Toljan,703,517.0,186,73.54196301564723,81,49,32,60.49382716049383,324,275,49,84.87654320987654,56,21,35,37.5,17.42636868010515,14,1,13,7.142857142857142,5,0,23,14,17,10,23,Hoffenheim,18,Germany - 1. Bundesliga
178,Jhon Andrés Córdoba Copete,266,201.0,65,75.56390977443608,18,11,7,61.111111111111114,171,144,27,84.21052631578947,2,0,2,0.0,12.817145365999849,5,0,5,0.0,7,2,25,15,12,5,68,FSV Mainz 05,22,Germany - 1. Bundesliga
179,Jiloan Hamad,126,84.0,42,66.66666666666666,17,7,10,41.17647058823529,80,66,14,82.5,7,2,5,28.57142857142857,17.7151617248,2,0,2,0.0,2,0,6,2,2,0,5,Hoffenheim,7,Germany - 1. Bundesliga
180,Jin-Su Kim,662,480.0,182,72.50755287009063,83,47,36,56.62650602409639,288,256,32,88.88888888888889,95,34,61,35.78947368421053,19.237084002804835,9,5,4,55.55555555555556,4,0,15,5,6,2,20,Hoffenheim,15,Germany - 1. Bundesliga
181,Joel Gerezgiher,31,15.0,16,48.38709677419355,9,4,5,44.44444444444444,17,11,6,64.70588235294117,3,1,2,33.33333333333333,17.48576618860645,0,0,0,0.0,1,0,3,2,1,0,2,Eintracht Frankfurt,3,Germany - 1. Bundesliga
182,Joelinton Cassio Apolinário de Lira,3,2.0,1,66.66666666666666,0,0,0,0.0,1,1,0,100.0,0,0,0,0.0,14.8769140104,0,0,0,0.0,0,0,0,0,0,0,0,Hoffenheim,1,Germany - 1. Bundesliga
183,Johan Danon Djourou-Gbadjere,1123,933.0,190,83.08103294746215,112,50,62,44.642857142857146,570,552,18,96.84210526315789,186,86,100,46.236559139784944,24.32788465478233,3,1,2,33.33333333333333,1,0,2,1,0,0,12,Hamburger SV,26,Germany - 1. Bundesliga
184,Johannes Flum,80,54.0,26,67.5,14,3,11,21.428571428571427,38,31,7,81.57894736842105,11,6,5,54.54545454545454,18.213781629006,3,2,1,66.66666666666666,0,1,0,0,0,0,6,Eintracht Frankfurt,5,Germany - 1. Bundesliga
185,Johannes Geis,1701,1307.0,394,76.83715461493239,315,174,141,55.23809523809524,792,762,30,96.21212121212122,481,219,262,45.53014553014553,24.862833304231533,42,16,26,38.095238095238095,52,5,10,8,2,2,57,Schalke 04,28,Germany - 1. Bundesliga
186,Johannes van den Bergh,98,69.0,29,70.40816326530613,9,6,3,66.66666666666666,63,55,8,87.3015873015873,11,2,9,18.181818181818183,17.081795230420408,8,2,6,25.0,2,1,2,1,0,0,3,Hertha Berlin,13,Germany - 1. Bundesliga
187,John Anthony Brooks,1211,1039.0,172,85.79686209744013,116,59,57,50.86206896551724,640,623,17,97.34375,126,42,84,33.33333333333333,25.008292003704376,0,0,0,0.0,1,1,8,3,1,0,21,Hertha Berlin,22,Germany - 1. Bundesliga
188,Jonas Hector,1853,1469.0,384,79.27684835402052,181,117,64,64.64088397790056,997,926,71,92.87863590772318,226,85,141,37.610619469026545,18.88271781360246,48,22,26,45.83333333333333,49,4,44,31,19,11,53,FC Köln,32,Germany - 1. Bundesliga
189,Jonas Hofmann,252,201.0,51,79.76190476190477,27,21,6,77.77777777777779,187,164,23,87.70053475935828,16,8,8,50.0,15.882496509917143,11,4,7,36.36363636363637,9,3,17,10,11,6,13,Borussia Mönchengladbach,15,Germany - 1. Bundesliga
190,Jonathan Schmid,419,285.0,134,68.01909307875896,44,21,23,47.72727272727273,230,196,34,85.21739130434783,63,18,45,28.57142857142857,17.342583439609545,23,5,18,21.73913043478261,24,0,23,6,13,3,25,Hoffenheim,23,Germany - 1. Bundesliga
191,Jonathan Tah,1194,951.0,243,79.64824120603015,160,90,70,56.25,621,596,25,95.97423510466989,148,59,89,39.86486486486486,22.091745255565023,1,0,1,0.0,4,0,16,8,2,1,26,Bayer Leverkusen,29,Germany - 1. Bundesliga
192,Joo-Ho Park,308,263.0,45,85.3896103896104,37,26,11,70.27027027027027,194,187,7,96.3917525773196,20,6,14,30.0,15.779683380649091,3,2,1,66.66666666666666,2,0,4,3,0,0,10,Borussia Dortmund,6,Germany - 1. Bundesliga
193,Joshua Kimmich,1527,1408.0,119,92.20694171578258,196,156,40,79.59183673469387,1107,1074,33,97.01897018970189,110,71,39,64.54545454545455,18.571775884953244,7,1,6,14.285714285714285,7,2,12,10,4,2,29,Bayern Munich,22,Germany - 1. Bundesliga
194,Josip Drmic,279,188.0,91,67.38351254480287,23,11,12,47.82608695652174,148,117,31,79.05405405405406,12,7,5,58.333333333333336,13.907538709894194,8,1,7,12.5,5,0,22,8,7,4,5,Hamburger SV,19,Germany - 1. Bundesliga
195,Josuha Guilavogui,1449,1273.0,176,87.85369220151829,167,121,46,72.45508982035929,1022,970,52,94.9119373776908,85,51,34,60.0,18.640561829074286,6,2,4,33.33333333333333,18,0,20,12,4,2,30,Wolfsburg,30,Germany - 1. Bundesliga
196,Joël Andre Job Matip,1732,1447.0,285,83.54503464203233,242,144,98,59.50413223140496,1000,936,64,93.60000000000001,182,84,98,46.15384615384615,22.047118529312286,6,2,4,33.33333333333333,8,3,18,13,7,7,25,Schalke 04,34,Germany - 1. Bundesliga
197,Juan Bernat Velasco,948,845.0,103,89.13502109704642,90,73,17,81.11111111111111,673,642,31,95.39375928677563,42,19,23,45.23809523809524,15.724048777353417,18,4,14,22.22222222222222,7,1,27,14,10,4,16,Bayern Munich,16,Germany - 1. Bundesliga
198,Julian Baumgartlinger,1467,1228.0,239,83.70824812542604,185,115,70,62.16216216216216,947,896,51,94.61457233368532,120,68,52,56.666666666666664,17.313031262192148,6,2,4,33.33333333333333,19,1,17,11,5,4,64,FSV Mainz 05,31,Germany - 1. Bundesliga
199,Julian Brandt,735,544.0,191,74.01360544217687,47,30,17,63.829787234042556,473,399,74,84.35517970401692,45,13,32,28.888888888888886,13.99878138945208,26,11,15,42.30769230769231,29,3,56,28,35,15,24,Bayer Leverkusen,29,Germany - 1. Bundesliga
200,Julian Draxler,842,676.0,166,80.28503562945369,101,69,32,68.31683168316832,529,471,58,89.03591682419659,110,58,52,52.72727272727272,19.545699488219572,27,13,14,48.148148148148145,35,5,85,51,54,32,23,Wolfsburg,24,Germany - 1. Bundesliga
201,Julian Korb,759,588.0,171,77.4703557312253,88,61,27,69.31818181818183,445,390,55,87.64044943820225,37,7,30,18.91891891891892,16.002226346889486,15,3,12,20.0,6,1,14,8,11,6,15,Borussia Mönchengladbach,17,Germany - 1. Bundesliga
202,Julian Schieber,31,16.0,15,51.61290322580645,5,1,4,20.0,11,10,1,90.9090909090909,0,0,0,0.0,11.957256440384516,0,0,0,0.0,1,1,2,0,2,0,4,Hertha Berlin,6,Germany - 1. Bundesliga
203,Julian Weigl,2277,2097.0,180,92.09486166007905,282,231,51,81.91489361702128,1758,1697,61,96.5301478953356,108,63,45,58.333333333333336,18.068996680486638,4,4,0,100.0,15,0,25,17,7,3,66,Borussia Dortmund,30,Germany - 1. Bundesliga
204,Jérôme Boateng,1285,1100.0,185,85.60311284046692,226,149,77,65.929203539823,740,717,23,96.89189189189189,189,89,100,47.08994708994709,23.72211117554876,11,4,7,36.36363636363637,9,3,4,4,2,2,5,Bayern Munich,19,Germany - 1. Bundesliga
205,Jérôme Gondorf,872,521.0,351,59.747706422018354,186,82,104,44.086021505376344,331,247,84,74.62235649546828,140,50,90,35.714285714285715,18.29193503598578,17,8,9,47.05882352941176,12,4,37,25,11,7,73,Darmstadt 98,33,Germany - 1. Bundesliga
206,Júnior Enrique Díaz Campbell,275,168.0,107,61.09090909090909,65,33,32,50.76923076923077,53,45,8,84.90566037735849,57,25,32,43.859649122807014,21.112432854518747,11,1,10,9.090909090909092,4,0,4,0,2,0,9,Darmstadt 98,12,Germany - 1. Bundesliga
207,Kaan Ayhan,38,30.0,8,78.94736842105263,8,4,4,50.0,21,20,1,95.23809523809523,10,5,5,50.0,25.96527143071579,0,0,0,0.0,0,0,0,0,0,0,1,Eintracht Frankfurt,2,Germany - 1. Bundesliga
208,Karim Bellarabi,875,577.0,298,65.94285714285715,92,59,33,64.13043478260869,581,452,129,77.79690189328744,49,17,32,34.69387755102041,14.67941787071358,67,12,55,17.91044776119403,31,11,144,75,84,44,69,Bayer Leverkusen,33,Germany - 1. Bundesliga
209,Karim Onisiwo,72,44.0,28,61.111111111111114,6,1,5,16.666666666666664,39,29,10,74.35897435897436,8,4,4,50.0,16.52977246998,10,6,4,60.0,4,1,12,5,9,5,11,FSV Mainz 05,9,Germany - 1. Bundesliga
210,Kazuki Nagasawa,16,10.0,6,62.5,1,1,0,100.0,7,6,1,85.71428571428571,0,0,0,0.0,11.851942570515,1,0,1,0.0,0,0,0,0,0,0,1,FC Köln,1,Germany - 1. Bundesliga
211,Kenan Karaman,505,356.0,149,70.49504950495049,41,22,19,53.65853658536586,359,300,59,83.56545961002786,24,5,19,20.833333333333336,14.441061411549624,16,8,8,50.0,14,2,51,27,20,11,39,Hannover 96,23,Germany - 1. Bundesliga
212,Kevin De Bruyne,107,80.0,27,74.76635514018692,8,7,1,87.5,65,57,8,87.6923076923077,15,7,8,46.666666666666664,18.89961986829533,9,1,8,11.11111111111111,3,0,8,5,3,2,3,Wolfsburg,2,Germany - 1. Bundesliga
213,Kevin Großkreutz,448,339.0,109,75.66964285714286,48,28,20,58.333333333333336,212,180,32,84.90566037735849,32,9,23,28.125,16.303036975122858,17,7,10,41.17647058823529,6,0,5,3,3,1,7,VfB Stuttgart,10,Germany - 1. Bundesliga
214,Kevin Kampl,1050,848.0,202,80.76190476190476,174,104,70,59.77011494252874,741,661,80,89.20377867746289,69,27,42,39.130434782608695,16.830247807298743,15,7,8,46.666666666666664,15,2,38,24,22,13,21,Bayer Leverkusen,23,Germany - 1. Bundesliga
215,Kevin Kuranyi,183,105.0,78,57.377049180327866,21,8,13,38.095238095238095,80,54,26,67.5,6,4,2,66.66666666666666,13.577081832653114,1,0,1,0.0,4,0,13,5,7,2,8,Hoffenheim,14,Germany - 1. Bundesliga
216,Kevin Vogt,861,692.0,169,80.37166085946573,139,88,51,63.30935251798561,455,425,30,93.4065934065934,106,61,45,57.54716981132076,21.894282851822716,11,3,8,27.27272727272727,11,2,12,7,3,1,32,FC Köln,23,Germany - 1. Bundesliga
217,Kevin Volland,921,523.0,398,56.78610206297503,123,61,62,49.59349593495935,496,344,152,69.35483870967742,102,37,65,36.27450980392157,16.964740327276612,93,23,70,24.731182795698924,35,7,93,49,58,27,86,Hoffenheim,33,Germany - 1. Bundesliga
218,Kingsley Coman,878,704.0,174,80.18223234624145,24,15,9,62.5,639,585,54,91.54929577464789,58,22,36,37.93103448275862,15.38630403537485,98,37,61,37.755102040816325,31,6,92,63,69,48,59,Bayern Munich,23,Germany - 1. Bundesliga
219,Klaas-Jan Huntelaar,520,386.0,134,74.23076923076923,41,21,20,51.21951219512195,326,286,40,87.73006134969326,13,7,6,53.84615384615385,12.389903360932292,14,5,9,35.714285714285715,22,3,18,10,12,7,48,Schalke 04,31,Germany - 1. Bundesliga
220,Koen Casteels,486,352.0,134,72.42798353909465,27,7,20,25.925925925925924,201,201,0,100.0,229,100,129,43.66812227074236,35.80974639295111,0,0,0,0.0,0,0,0,0,0,0,1,Wolfsburg,13,Germany - 1. Bundesliga
221,Konstantin Engel,87,46.0,41,52.87356321839081,20,8,12,40.0,20,15,5,75.0,14,2,12,14.285714285714285,21.979564861431722,2,0,2,0.0,1,0,2,1,0,0,2,Ingolstadt,4,Germany - 1. Bundesliga
222,Konstantin Rausch,633,330.0,303,52.13270142180095,83,30,53,36.144578313253014,270,190,80,70.37037037037037,186,43,143,23.118279569892472,21.473297075826085,70,18,52,25.71428571428571,31,5,27,7,15,5,29,Darmstadt 98,31,Germany - 1. Bundesliga
223,Konstantinos Stafylidis,381,268.0,113,70.34120734908137,45,26,19,57.77777777777777,149,136,13,91.2751677852349,79,28,51,35.44303797468354,23.65020563208,21,6,15,28.57142857142857,3,0,8,6,3,1,6,Augsburg,11,Germany - 1. Bundesliga
224,Kyriakos Papadopoulos,381,282.0,99,74.01574803149606,33,13,20,39.39393939393939,185,173,12,93.51351351351352,37,6,31,16.216216216216218,19.35306090408,0,0,0,0.0,2,0,3,2,0,0,6,Bayer Leverkusen,16,Germany - 1. Bundesliga
225,Lars Bender,545,421.0,124,77.24770642201835,84,50,34,59.523809523809526,329,299,30,90.88145896656535,38,17,21,44.73684210526316,15.81835072668903,4,2,2,50.0,6,1,11,6,6,2,13,Bayer Leverkusen,11,Germany - 1. Bundesliga
226,Lars Edi Stindl,1413,1127.0,286,79.7593772116065,150,98,52,65.33333333333333,1040,904,136,86.92307692307692,40,19,21,47.5,14.088477979882345,24,7,17,29.166666666666668,49,8,48,21,30,11,71,Borussia Mönchengladbach,30,Germany - 1. Bundesliga
227,Leandro Putaro,12,9.0,3,75.0,2,1,1,50.0,7,7,0,100.0,0,0,0,0.0,12.429133096980001,0,0,0,0.0,0,0,3,1,2,0,0,Wolfsburg,4,Germany - 1. Bundesliga
228,Leon Aderemi Balogun,705,522.0,183,74.04255319148936,70,29,41,41.42857142857143,317,297,20,93.69085173501577,95,30,65,31.57894736842105,21.755252472373787,4,1,3,25.0,3,0,14,8,3,1,18,FSV Mainz 05,21,Germany - 1. Bundesliga
229,Leon Andreasen,389,269.0,120,69.1516709511568,65,35,30,53.84615384615385,187,166,21,88.77005347593582,62,22,40,35.483870967741936,19.28680237987126,12,3,9,25.0,12,1,6,3,2,2,12,Hannover 96,15,Germany - 1. Bundesliga
230,Leon Goretzka,952,783.0,169,82.24789915966386,86,52,34,60.46511627906976,586,539,47,91.97952218430035,56,27,29,48.214285714285715,16.74085071521647,7,1,6,14.285714285714285,22,3,48,29,13,6,39,Schalke 04,25,Germany - 1. Bundesliga
231,Leon Guwara,45,31.0,14,68.88888888888889,4,2,2,50.0,28,20,8,71.42857142857143,3,1,2,33.33333333333333,15.296396042656001,1,0,1,0.0,0,0,4,2,3,1,4,Werder Bremen,1,Germany - 1. Bundesliga
232,Leonardo Bittencourt,866,603.0,263,69.63048498845265,91,52,39,57.14285714285714,528,437,91,82.76515151515152,61,23,38,37.704918032786885,16.020912242085174,43,12,31,27.906976744186046,28,4,60,30,34,17,73,FC Köln,29,Germany - 1. Bundesliga
233,Leroy Sané,616,477.0,139,77.43506493506493,48,30,18,62.5,475,393,82,82.73684210526315,13,4,9,30.76923076923077,14.20509694854974,26,12,14,46.15384615384615,21,6,161,83,100,54,44,Schalke 04,33,Germany - 1. Bundesliga
234,Levin Mete Öztunali,375,231.0,144,61.6,23,15,8,65.21739130434783,232,163,69,70.25862068965517,19,9,10,47.368421052631575,13.4200642862592,39,14,25,35.8974358974359,15,3,73,36,43,21,22,Werder Bremen,25,Germany - 1. Bundesliga
235,Lewis Harry Holtby,1795,1382.0,413,76.991643454039,237,137,100,57.80590717299579,983,874,109,88.91149542217701,250,120,130,48.0,19.626287960652085,33,13,20,39.39393939393939,37,2,71,40,25,11,72,Hamburger SV,34,Germany - 1. Bundesliga
236,Loris Karius,1265,730.0,535,57.70750988142292,153,28,125,18.30065359477124,382,382,0,100.0,757,236,521,31.175693527080583,42.23668457176335,0,0,0,0.0,0,0,1,1,0,0,6,FSV Mainz 05,34,Germany - 1. Bundesliga
237,Luc Castaignos,208,137.0,71,65.86538461538461,22,5,17,22.727272727272727,124,95,29,76.61290322580645,7,0,7,0.0,13.016755198730769,7,1,6,14.285714285714285,6,1,15,11,9,7,16,Eintracht Frankfurt,19,Germany - 1. Bundesliga
238,Luca Caldirola,685,416.0,269,60.72992700729927,187,74,113,39.57219251336899,166,148,18,89.1566265060241,190,59,131,31.05263157894737,24.023937958164787,8,1,7,12.5,5,0,2,0,2,0,61,Darmstadt 98,34,Germany - 1. Bundesliga
239,Luca-Milan Zander,35,23.0,12,65.71428571428571,2,1,1,50.0,14,10,4,71.42857142857143,4,3,1,75.0,15.520166372283429,0,0,0,0.0,0,0,0,0,0,0,1,Werder Bremen,2,Germany - 1. Bundesliga
240,Luiz Gustavo Dias,1087,955.0,132,87.85648574057038,115,79,36,68.69565217391305,756,719,37,95.1058201058201,68,35,33,51.470588235294116,19.33377396983702,7,3,4,42.857142857142854,6,1,13,9,4,3,31,Wolfsburg,22,Germany - 1. Bundesliga
241,Lukas Fröde,50,29.0,21,57.99999999999999,5,2,3,40.0,13,12,1,92.3076923076923,6,2,4,33.33333333333333,15.3799764282,0,0,0,0.0,1,0,0,0,0,0,3,Werder Bremen,6,Germany - 1. Bundesliga
242,Lukas Hinterseer,543,328.0,215,60.40515653775322,51,21,30,41.17647058823529,307,231,76,75.2442996742671,14,3,11,21.428571428571427,11.830004680163668,12,3,9,25.0,11,0,36,8,26,6,40,Ingolstadt,28,Germany - 1. Bundesliga
243,Lukas Klünter,5,1.0,4,20.0,1,0,1,0.0,2,1,1,50.0,0,0,0,0.0,8.434986986736,0,0,0,0.0,0,0,0,0,0,0,0,FC Köln,1,Germany - 1. Bundesliga
244,Lukas Rupp,978,732.0,246,74.84662576687117,139,74,65,53.23741007194245,599,516,83,86.14357262103506,69,17,52,24.637681159420293,15.35334818851141,20,5,15,25.0,29,4,48,30,19,9,25,VfB Stuttgart,29,Germany - 1. Bundesliga
245,Lukáš Hrádecký,1342,828.0,514,61.698956780924,159,48,111,30.18867924528302,366,364,2,99.4535519125683,839,338,501,40.286054827175214,42.47603556785812,0,0,0,0.0,0,0,0,0,0,0,2,Eintracht Frankfurt,34,Germany - 1. Bundesliga
246,László Kleinheisler,78,59.0,19,75.64102564102564,13,8,5,61.53846153846154,49,44,5,89.79591836734694,9,3,6,33.33333333333333,16.866282907135385,5,1,4,20.0,1,0,10,5,3,1,7,Werder Bremen,6,Germany - 1. Bundesliga
247,Mahmoud Dahoud,1279,1071.0,208,83.73729476153244,129,86,43,66.66666666666666,890,808,82,90.78651685393258,58,31,27,53.44827586206896,17.46348789894136,1,1,0,100.0,23,7,36,28,11,8,41,Borussia Mönchengladbach,32,Germany - 1. Bundesliga
248,Makoto Hasebe,1412,1049.0,363,74.29178470254958,215,124,91,57.674418604651166,719,639,80,88.87343532684284,172,65,107,37.7906976744186,19.180559439174388,28,6,22,21.428571428571427,26,2,13,11,5,4,46,Eintracht Frankfurt,32,Germany - 1. Bundesliga
249,Manuel Neuer,1288,1071.0,217,83.15217391304348,55,11,44,20.0,665,661,4,99.3984962406015,373,171,202,45.84450402144772,29.937216269096833,0,0,0,0.0,0,0,2,2,0,0,2,Bayern Munich,34,Germany - 1. Bundesliga
250,Manuel Schmiedebach,1000,733.0,267,73.3,172,86,86,50.0,566,498,68,87.98586572438163,122,44,78,36.0655737704918,18.23885871625584,13,2,11,15.384615384615385,18,1,22,16,6,6,34,Hannover 96,22,Germany - 1. Bundesliga
251,Marc Stendera,1078,781.0,297,72.44897959183673,202,113,89,55.940594059405946,652,581,71,89.11042944785275,190,74,116,38.94736842105263,19.52242398061113,27,7,20,25.925925925925924,23,1,59,42,23,18,42,Eintracht Frankfurt,26,Germany - 1. Bundesliga
252,Marcel  Hilßner,12,7.0,5,58.333333333333336,3,1,2,33.33333333333333,6,6,0,100.0,3,1,2,33.33333333333333,18.9428288148,0,0,0,0.0,0,0,0,0,0,0,1,Werder Bremen,1,Germany - 1. Bundesliga
253,Marcel Hartel,48,34.0,14,70.83333333333334,0,0,0,0.0,33,27,6,81.81818181818183,3,0,3,0.0,16.386268235145,0,0,0,0.0,0,0,7,3,6,2,2,FC Köln,6,Germany - 1. Bundesliga
254,Marcel Heller,605,307.0,298,50.743801652892564,43,17,26,39.53488372093023,246,168,78,68.29268292682927,81,25,56,30.864197530864196,16.455574201320594,97,28,69,28.865979381443296,22,5,57,30,42,25,47,Darmstadt 98,33,Germany - 1. Bundesliga
255,Marcel Risse,1504,912.0,592,60.63829787234043,254,95,159,37.40157480314961,574,455,119,79.26829268292683,398,134,264,33.66834170854271,23.51282886739101,125,35,90,28.000000000000004,60,5,82,48,43,30,22,FC Köln,33,Germany - 1. Bundesliga
256,Marcel Schmelzer,1602,1320.0,282,82.39700374531836,125,92,33,73.6,1032,942,90,91.27906976744185,79,31,48,39.24050632911392,15.656923975835504,65,22,43,33.84615384615385,22,4,22,10,15,7,38,Borussia Dortmund,26,Germany - 1. Bundesliga
257,Marcel Schäfer,772,590.0,182,76.42487046632125,68,51,17,75.0,408,373,35,91.42156862745098,89,44,45,49.43820224719101,18.195747644197304,45,16,29,35.55555555555556,32,2,14,5,11,2,12,Wolfsburg,21,Germany - 1. Bundesliga
258,Marcelo Alfonso Díaz Rojas,377,319.0,58,84.61538461538461,55,41,14,74.54545454545455,233,215,18,92.27467811158799,41,18,23,43.90243902439025,19.253018434493793,2,0,2,0.0,6,0,3,1,2,0,6,Hamburger SV,11,Germany - 1. Bundesliga
259,Marcelo Antônio Guedes Filho,922,742.0,180,80.4772234273319,122,53,69,43.44262295081967,483,471,12,97.51552795031056,143,50,93,34.96503496503497,23.773931529871234,0,0,0,0.0,2,0,4,3,0,0,6,Hannover 96,19,Germany - 1. Bundesliga
260,Marco Höger,118,84.0,34,71.1864406779661,23,16,7,69.56521739130434,67,60,7,89.55223880597015,9,5,4,55.55555555555556,17.689110126717967,4,1,3,25.0,0,0,0,0,0,0,5,Schalke 04,5,Germany - 1. Bundesliga
261,Marco Jhonfai Fabián De La Mora,431,330.0,101,76.5661252900232,49,27,22,55.10204081632652,267,244,23,91.38576779026218,43,22,21,51.162790697674424,16.916013617203713,20,6,14,30.0,17,2,21,13,14,11,19,Eintracht Frankfurt,11,Germany - 1. Bundesliga
262,Marco Reus,814,650.0,164,79.85257985257985,63,39,24,61.904761904761905,596,531,65,89.09395973154362,54,19,35,35.18518518518518,15.434105937860345,37,14,23,37.83783783783784,42,3,65,31,43,20,36,Borussia Dortmund,26,Germany - 1. Bundesliga
263,Marco Russ,1021,815.0,206,79.82370225269344,125,73,52,58.4,572,545,27,95.27972027972028,87,29,58,33.33333333333333,18.916702289977433,5,0,5,0.0,4,2,16,9,5,3,30,Eintracht Frankfurt,28,Germany - 1. Bundesliga
264,Marco Sailer,66,38.0,28,57.57575757575758,8,1,7,12.5,30,25,5,83.33333333333334,3,0,3,0.0,13.950534594961091,2,0,2,0.0,3,0,4,1,2,0,9,Darmstadt 98,14,Germany - 1. Bundesliga
265,Mario Götze,547,470.0,77,85.92321755027422,45,32,13,71.11111111111111,433,400,33,92.37875288683603,20,9,11,45.0,12.974316251591517,18,7,11,38.88888888888889,14,4,27,18,16,12,16,Bayern Munich,14,Germany - 1. Bundesliga
266,Mario Vrančić,335,216.0,119,64.4776119402985,56,23,33,41.07142857142857,143,121,22,84.61538461538461,65,23,42,35.38461538461539,19.95003309332203,14,5,9,35.714285714285715,14,1,11,8,9,6,25,Darmstadt 98,22,Germany - 1. Bundesliga
267,Marius Wolf,16,8.0,8,50.0,2,0,2,0.0,7,6,1,85.71428571428571,2,0,2,0.0,17.588655169965,1,0,1,0.0,0,0,1,0,1,0,1,Hannover 96,2,Germany - 1. Bundesliga
268,Mark Uth,388,284.0,104,73.19587628865979,33,19,14,57.57575757575758,256,212,44,82.8125,20,8,12,40.0,15.392233220431548,9,3,6,33.33333333333333,14,1,38,16,26,9,23,Hoffenheim,25,Germany - 1. Bundesliga
269,Markus Feulner,441,316.0,125,71.65532879818595,53,27,26,50.943396226415096,199,174,25,87.43718592964824,49,17,32,34.69387755102041,18.8601419357551,23,6,17,26.08695652173913,7,0,21,11,12,6,20,Augsburg,19,Germany - 1. Bundesliga
270,Markus Suttner,618,385.0,233,62.297734627831716,123,60,63,48.78048780487805,163,145,18,88.95705521472392,164,54,110,32.926829268292686,23.402196740620195,38,11,27,28.947368421052634,15,0,14,10,10,6,5,Ingolstadt,18,Germany - 1. Bundesliga
271,Marlon Frey,97,69.0,28,71.1340206185567,19,15,4,78.94736842105263,42,38,4,90.47619047619048,13,9,4,69.23076923076923,19.333880829397113,0,0,0,0.0,0,0,5,4,4,3,2,Bayer Leverkusen,9,Germany - 1. Bundesliga
272,Mart Ristl,28,22.0,6,78.57142857142857,2,1,1,50.0,19,16,3,84.21052631578947,1,0,1,0.0,13.35225098766857,0,0,0,0.0,1,0,0,0,0,0,1,VfB Stuttgart,3,Germany - 1. Bundesliga
273,Martin Harnik,335,223.0,112,66.56716417910448,35,19,16,54.285714285714285,183,142,41,77.59562841530054,16,7,9,43.75,14.643786044219103,15,5,10,33.33333333333333,9,0,23,12,14,6,10,VfB Stuttgart,19,Germany - 1. Bundesliga
274,Martin Hinteregger,414,327.0,87,78.98550724637681,45,24,21,53.333333333333336,251,228,23,90.83665338645417,40,9,31,22.5,19.133926668956523,4,1,3,25.0,1,0,3,1,1,0,3,Borussia Mönchengladbach,10,Germany - 1. Bundesliga
275,Martin Stranzl,119,104.0,15,87.39495798319328,4,1,3,25.0,75,73,2,97.33333333333334,11,3,8,27.27272727272727,20.271686466191596,1,0,1,0.0,0,0,0,0,0,0,3,Borussia Mönchengladbach,3,Germany - 1. Bundesliga
276,Marvin Friedrich,1,0.0,1,0.0,0,0,0,0.0,0,0,0,0.0,1,0,1,0.0,65.019948192,1,0,1,0.0,0,0,0,0,0,0,0,Schalke 04,2,Germany - 1. Bundesliga
277,Marvin Matip,1056,811.0,245,76.79924242424242,136,62,74,45.588235294117645,488,461,27,94.4672131147541,148,49,99,33.108108108108105,21.678728403401593,5,1,4,20.0,5,1,4,4,1,1,24,Ingolstadt,33,Germany - 1. Bundesliga
278,Marvin Plattenhardt,1774,1359.0,415,76.6065388951522,179,117,62,65.36312849162012,873,820,53,93.92898052691866,234,67,167,28.63247863247863,18.924564541521306,96,21,75,21.875,29,4,31,12,19,7,41,Hertha Berlin,33,Germany - 1. Bundesliga
279,Marvin Schulz,267,239.0,28,89.51310861423221,15,9,6,60.0,206,195,11,94.66019417475728,11,0,11,0.0,18.980764732740674,0,0,0,0.0,0,1,0,0,0,0,3,Borussia Mönchengladbach,8,Germany - 1. Bundesliga
280,Marvin Wanitzek,5,4.0,1,80.0,1,0,1,0.0,1,1,0,100.0,0,0,0,0.0,16.24073301504,0,0,0,0.0,0,0,0,0,0,0,0,VfB Stuttgart,1,Germany - 1. Bundesliga
281,Marwin Hitz,1229,795.0,434,64.68673718470302,160,50,110,31.25,357,355,2,99.43977591036415,748,326,422,43.58288770053476,44.17547441925325,0,0,0,0.0,1,0,0,0,0,0,9,Augsburg,33,Germany - 1. Bundesliga
282,Mathew Leckie,926,646.0,280,69.76241900647948,104,54,50,51.92307692307693,497,421,76,84.70824949698189,43,15,28,34.883720930232556,14.11197869690203,28,9,19,32.142857142857146,29,0,121,63,61,27,60,Ingolstadt,32,Germany - 1. Bundesliga
283,Matija Nastasić,6,6.0,0,100.0,0,0,0,0.0,5,5,0,100.0,0,0,0,0.0,19.472629507799997,0,0,0,0.0,0,0,0,0,0,0,0,Schalke 04,1,Germany - 1. Bundesliga
284,Mats Hummels,2349,2019.0,330,85.9514687100894,320,185,135,57.8125,1583,1523,60,96.20972836386608,222,80,142,36.03603603603604,21.09746398325318,7,2,5,28.57142857142857,5,2,18,10,7,1,20,Borussia Dortmund,30,Germany - 1. Bundesliga
285,Matthias Ginter,1336,1094.0,242,81.88622754491018,104,66,38,63.46153846153846,795,730,65,91.82389937106919,70,31,39,44.285714285714285,16.865203423297906,45,17,28,37.77777777777778,13,4,18,11,11,6,28,Borussia Dortmund,24,Germany - 1. Bundesliga
286,Matthias Lehmann,1363,1116.0,247,81.8782098312546,212,122,90,57.54716981132076,802,761,41,94.88778054862843,143,59,84,41.25874125874126,19.671400537152987,6,1,5,16.666666666666664,16,2,7,5,2,2,34,FC Köln,32,Germany - 1. Bundesliga
287,Matthias Ostrzolek,1634,1183.0,451,72.39902080783354,197,104,93,52.79187817258884,715,617,98,86.2937062937063,216,73,143,33.7962962962963,18.86766545500788,54,20,34,37.03703703703704,22,2,41,22,19,6,61,Hamburger SV,32,Germany - 1. Bundesliga
288,Matthias Zimmermann,79,53.0,26,67.08860759493672,9,3,6,33.33333333333333,32,27,5,84.375,13,2,11,15.384615384615385,19.189233839137213,3,0,3,0.0,1,0,3,2,1,0,0,VfB Stuttgart,2,Germany - 1. Bundesliga
289,Maurice Multhaup,18,13.0,5,72.22222222222221,0,0,0,0.0,8,8,0,100.0,1,0,1,0.0,12.78085999576,1,0,1,0.0,0,0,0,0,0,0,5,Ingolstadt,4,Germany - 1. Bundesliga
290,Max Christiansen,457,310.0,147,67.83369803063457,66,43,23,65.15151515151516,236,202,34,85.59322033898306,51,18,33,35.294117647058826,16.228636203346344,14,3,11,21.428571428571427,8,1,13,5,5,1,27,Ingolstadt,18,Germany - 1. Bundesliga
291,Max Kruse,1119,895.0,224,79.98212689901698,100,73,27,73.0,707,619,88,87.55304101838756,98,72,26,73.46938775510205,17.486255770945416,49,15,34,30.612244897959183,45,6,54,33,27,17,19,Wolfsburg,32,Germany - 1. Bundesliga
292,Max Meyer,1023,856.0,167,83.67546432062561,94,66,28,70.2127659574468,785,710,75,90.44585987261146,43,17,26,39.53488372093023,15.122767559065338,12,2,10,16.666666666666664,37,6,59,36,36,24,58,Schalke 04,32,Germany - 1. Bundesliga
293,Maximilian Arnold,1252,1055.0,197,84.26517571884983,174,113,61,64.9425287356322,810,750,60,92.5925925925926,126,69,57,54.761904761904766,19.741141399872077,15,6,9,40.0,44,2,16,13,4,3,87,Wolfsburg,31,Germany - 1. Bundesliga
294,Maximilian Beister,1,0.0,1,0.0,1,0,1,0.0,1,0,1,0.0,0,0,0,0.0,15.5952785376,0,0,0,0.0,0,0,0,0,0,0,1,FSV Mainz 05,1,Germany - 1. Bundesliga
295,Maximilian Eggestein,62,44.0,18,70.96774193548387,10,5,5,50.0,37,31,6,83.78378378378379,5,2,3,40.0,16.54724064868258,1,1,0,100.0,4,0,1,1,1,1,2,Werder Bremen,7,Germany - 1. Bundesliga
296,Maximilian Mittelstädt,73,56.0,17,76.71232876712328,11,5,6,45.45454545454545,45,39,6,86.66666666666667,8,3,5,37.5,18.505234132007672,2,2,0,100.0,1,1,2,0,1,0,3,Hertha Berlin,3,Germany - 1. Bundesliga
297,Medhi Amine El Mouttaqi Benatia,822,740.0,82,90.02433090024331,61,37,24,60.65573770491803,620,603,17,97.25806451612902,43,16,27,37.2093023255814,18.367762414297225,0,0,0,0.0,1,1,4,4,0,0,8,Bayern Munich,14,Germany - 1. Bundesliga
298,Melvyn Lorenzen,24,13.0,11,54.166666666666664,0,0,0,0.0,16,9,7,56.25,0,0,0,0.0,14.51240166348,2,1,1,50.0,0,0,9,3,2,1,4,Werder Bremen,9,Germany - 1. Bundesliga
299,Mevlüt Erdinç,49,40.0,9,81.63265306122449,2,1,1,50.0,28,25,3,89.28571428571429,1,1,0,100.0,12.531657671338774,1,0,1,0.0,3,1,10,3,8,3,8,Hannover 96,11,Germany - 1. Bundesliga
300,Michael Gregoritsch,595,372.0,223,62.52100840336134,114,45,69,39.473684210526315,269,221,48,82.15613382899627,36,7,29,19.444444444444446,15.029299521744806,10,2,8,20.0,18,0,21,9,7,2,27,Hamburger SV,25,Germany - 1. Bundesliga
301,Miiko Martín Albornoz Inola,1039,747.0,292,71.89605389797883,145,80,65,55.172413793103445,405,363,42,89.62962962962962,211,76,135,36.018957345971565,20.300121734230913,56,13,43,23.214285714285715,29,1,28,18,14,10,40,Hannover 96,23,Germany - 1. Bundesliga
302,Mijat Gaćinović,123,72.0,51,58.536585365853654,11,3,8,27.27272727272727,73,55,18,75.34246575342466,16,2,14,12.5,17.84901930923122,7,0,7,0.0,2,0,10,2,7,1,9,Eintracht Frankfurt,7,Germany - 1. Bundesliga
303,Mike-Steven Bähre,4,3.0,1,75.0,0,0,0,0.0,3,3,0,100.0,0,0,0,0.0,11.617629393600001,0,0,0,0.0,0,0,1,0,0,0,0,Hannover 96,1,Germany - 1. Bundesliga
304,Milos Veljkovic,18,14.0,4,77.77777777777779,1,1,0,100.0,8,7,1,87.5,3,1,2,33.33333333333333,20.0613983836,0,0,0,0.0,0,0,1,0,0,0,1,Werder Bremen,3,Germany - 1. Bundesliga
305,Miloš Jojić,222,155.0,67,69.81981981981981,21,11,10,52.38095238095239,117,98,19,83.76068376068376,37,16,21,43.24324324324324,17.838133163017297,9,2,7,22.22222222222222,15,0,14,7,7,4,7,FC Köln,15,Germany - 1. Bundesliga
306,Miloš Pantović,1,1.0,0,100.0,1,1,0,100.0,0,0,0,0.0,0,0,0,0.0,38.954942359200004,0,0,0,0.0,0,0,0,0,0,0,0,Bayern Munich,1,Germany - 1. Bundesliga
307,Mitchell James Langerak,57,31.0,26,54.385964912280706,6,4,2,66.66666666666666,10,10,0,100.0,36,12,24,33.33333333333333,45.085441724715785,0,0,0,0.0,0,0,0,0,0,0,0,VfB Stuttgart,2,Germany - 1. Bundesliga
308,Mitchell Weiser,1228,888.0,340,72.31270358306189,125,63,62,50.4,661,553,108,83.66111951588502,99,28,71,28.28282828282828,15.899282997415446,48,11,37,22.916666666666664,17,4,97,52,47,23,69,Hertha Berlin,29,Germany - 1. Bundesliga
309,Moritz Hartmann,574,367.0,207,63.937282229965156,46,21,25,45.65217391304348,307,246,61,80.13029315960912,30,10,20,33.33333333333333,13.24501253199345,22,6,16,27.27272727272727,19,1,24,11,12,7,39,Ingolstadt,30,Germany - 1. Bundesliga
310,Moritz Leitner,244,213.0,31,87.29508196721312,28,27,1,96.42857142857143,176,169,7,96.02272727272727,17,9,8,52.94117647058824,16.81290948103967,5,0,5,0.0,4,1,9,6,2,1,8,Borussia Dortmund,9,Germany - 1. Bundesliga
311,Mustafa Batuhan Altıntaş,6,4.0,2,66.66666666666666,1,0,1,0.0,2,2,0,100.0,0,0,0,0.0,14.5197598098,0,0,0,0.0,0,0,0,0,0,0,0,Hamburger SV,1,Germany - 1. Bundesliga
312,Márcio Rafael Ferreira de Souza,1920,1755.0,165,91.40625,214,180,34,84.11214953271028,1384,1338,46,96.67630057803468,93,55,38,59.13978494623656,17.053164563862374,40,16,24,40.0,15,2,21,9,13,5,25,Bayern Munich,25,Germany - 1. Bundesliga
313,Mërgim Mavraj,387,331.0,56,85.52971576227391,33,16,17,48.484848484848484,225,219,6,97.33333333333334,39,14,25,35.8974358974359,22.647696280383258,0,0,0,0.0,0,0,2,1,0,0,12,FC Köln,11,Germany - 1. Bundesliga
314,Nabil Bahoui,56,31.0,25,55.35714285714286,4,2,2,50.0,21,17,4,80.95238095238095,12,5,7,41.66666666666667,18.82519855367143,2,0,2,0.0,3,0,4,4,2,2,1,Hamburger SV,6,Germany - 1. Bundesliga
315,Nadiem Amiri,630,463.0,167,73.4920634920635,65,41,24,63.07692307692307,401,343,58,85.53615960099751,76,24,52,31.57894736842105,18.45089220601943,23,11,12,47.82608695652174,31,4,57,27,21,10,41,Hoffenheim,25,Germany - 1. Bundesliga
316,Neven Subotić,454,398.0,56,87.66519823788546,49,29,20,59.183673469387756,299,289,10,96.65551839464884,40,18,22,45.0,21.167612972057974,1,0,1,0.0,2,0,1,1,0,0,4,Borussia Dortmund,6,Germany - 1. Bundesliga
317,Nicklas Bendtner,104,70.0,34,67.3076923076923,16,6,10,37.5,59,47,12,79.66101694915254,4,1,3,25.0,15.3971808642,1,0,1,0.0,3,0,1,0,1,0,4,Wolfsburg,13,Germany - 1. Bundesliga
318,Nico Elvedi,1063,888.0,175,83.53715898400753,99,65,34,65.65656565656566,669,631,38,94.31988041853513,42,11,31,26.190476190476193,15.967732581637026,6,2,4,33.33333333333333,2,2,14,8,4,1,17,Borussia Mönchengladbach,21,Germany - 1. Bundesliga
319,Nico Rinderknecht,2,2.0,0,100.0,0,0,0,0.0,2,2,0,100.0,0,0,0,0.0,11.4793567974,0,0,0,0.0,0,0,0,0,0,0,0,Eintracht Frankfurt,1,Germany - 1. Bundesliga
320,Nico Schulz,15,11.0,4,73.33333333333333,2,0,2,0.0,10,7,3,70.0,1,0,1,0.0,14.566140802127999,0,0,0,0.0,1,0,4,1,3,1,1,Borussia Mönchengladbach,2,Germany - 1. Bundesliga
321,Nicolai Müller,686,463.0,223,67.4927113702624,81,46,35,56.79012345679012,429,339,90,79.02097902097903,30,7,23,23.333333333333332,14.490410291668443,27,11,16,40.74074074074074,20,5,64,32,26,13,38,Hamburger SV,29,Germany - 1. Bundesliga
322,Niklas Stark,794,688.0,106,86.64987405541562,69,42,27,60.86956521739131,464,446,18,96.12068965517241,65,25,40,38.46153846153847,21.65374882573209,0,0,0,0.0,1,0,7,5,2,1,30,Hertha Berlin,21,Germany - 1. Bundesliga
323,Niklas Süle,1691,1441.0,250,85.21584861028977,166,92,74,55.42168674698795,1070,1035,35,96.72897196261682,173,71,102,41.040462427745666,21.970920475739323,2,1,1,50.0,5,0,3,3,0,0,21,Hoffenheim,33,Germany - 1. Bundesliga
324,Niko Bungert,873,729.0,144,83.50515463917526,90,39,51,43.333333333333336,464,449,15,96.76724137931035,96,38,58,39.58333333333333,22.24726976108454,0,0,0,0.0,1,0,3,2,0,0,15,FSV Mainz 05,20,Germany - 1. Bundesliga
325,Noah-Joel Sarenren-Bazee,60,30.0,30,50.0,4,0,4,0.0,28,18,10,64.28571428571429,2,1,1,50.0,12.534379800887999,8,4,4,50.0,3,3,11,10,8,8,10,Hannover 96,5,Germany - 1. Bundesliga
326,Nuri Şahin,509,452.0,57,88.8015717092338,68,50,18,73.52941176470588,395,377,18,95.44303797468355,27,14,13,51.85185185185185,17.516964104296267,1,0,1,0.0,5,2,2,1,0,0,10,Borussia Dortmund,9,Germany - 1. Bundesliga
327,Odisseas Vlachodimos,60,39.0,21,65.0,3,1,2,33.33333333333333,24,24,0,100.0,32,11,21,34.375,37.20202250208,0,0,0,0.0,0,0,0,0,0,0,0,VfB Stuttgart,3,Germany - 1. Bundesliga
328,Oliver Baumann,1478,941.0,537,63.667117726657644,171,31,140,18.128654970760234,559,557,2,99.6422182468694,777,257,520,33.07593307593308,39.09304628825699,0,0,0,0.0,2,0,0,0,0,0,6,Hoffenheim,33,Germany - 1. Bundesliga
329,Oliver Hüsing,1,0.0,1,0.0,0,0,0,0.0,0,0,0,0.0,1,0,1,0.0,35.489674512,0,0,0,0.0,0,0,0,0,0,0,0,Werder Bremen,1,Germany - 1. Bundesliga
330,Oliver Sorg,747,524.0,223,70.14725568942436,119,55,64,46.21848739495798,314,288,26,91.71974522292994,108,29,79,26.851851851851855,19.190801785898795,16,3,13,18.75,6,0,15,6,4,2,25,Hannover 96,20,Germany - 1. Bundesliga
331,Oscar Wendt,1740,1356.0,384,77.93103448275862,179,93,86,51.955307262569825,1015,935,80,92.11822660098522,151,37,114,24.503311258278146,17.22836089321324,53,18,35,33.9622641509434,25,2,29,16,16,9,16,Borussia Mönchengladbach,30,Germany - 1. Bundesliga
332,Pablo Ezequiel De Blasis,622,405.0,217,65.11254019292605,100,50,50,50.0,306,243,63,79.41176470588235,74,34,40,45.94594594594595,17.411479665372347,33,10,23,30.303030303030305,17,4,52,27,30,16,33,FSV Mainz 05,26,Germany - 1. Bundesliga
333,Papiss Mison Djilobodji,667,447.0,220,67.01649175412294,159,69,90,43.39622641509434,291,273,18,93.81443298969072,177,60,117,33.89830508474576,26.30866878924018,7,2,5,28.57142857142857,7,0,12,12,4,4,10,Werder Bremen,14,Germany - 1. Bundesliga
334,Pascal Groß,2026,1275.0,751,62.93188548864757,427,193,234,45.19906323185012,889,727,162,81.77727784026997,494,176,318,35.62753036437247,20.78048638872622,112,28,84,25.0,95,4,32,24,22,14,57,Ingolstadt,32,Germany - 1. Bundesliga
335,Patrick Herrmann,222,158.0,64,71.17117117117117,15,7,8,46.666666666666664,151,120,31,79.47019867549669,9,5,4,55.55555555555556,14.491244735127568,12,5,7,41.66666666666667,10,1,14,6,10,3,22,Borussia Mönchengladbach,18,Germany - 1. Bundesliga
336,Paul Seguin,76,57.0,19,75.0,8,3,5,37.5,47,46,1,97.87234042553192,10,2,8,20.0,17.587856689114734,3,1,2,33.33333333333333,1,0,1,0,0,0,2,Wolfsburg,4,Germany - 1. Bundesliga
337,Paul Verhaegh,1325,1064.0,261,80.30188679245282,165,94,71,56.96969696969697,668,620,48,92.81437125748504,165,61,104,36.96969696969697,20.01480098849769,46,14,32,30.434782608695656,16,2,9,6,6,4,19,Augsburg,25,Germany - 1. Bundesliga
338,Pavel Kadeřábek,1045,747.0,298,71.48325358851675,124,61,63,49.193548387096776,432,373,59,86.3425925925926,106,28,78,26.41509433962264,17.557926701054537,47,12,35,25.53191489361702,10,1,18,10,13,6,27,Hoffenheim,28,Germany - 1. Bundesliga
339,Paweł Olkowski,545,379.0,166,69.54128440366972,64,32,32,50.0,259,224,35,86.48648648648648,58,15,43,25.862068965517242,17.339719978538422,14,4,10,28.57142857142857,2,0,17,6,10,2,15,FC Köln,19,Germany - 1. Bundesliga
340,Per Ciljan Skjelbred,1551,1318.0,233,84.97743391360413,153,99,54,64.70588235294117,1032,967,65,93.7015503875969,83,42,41,50.602409638554214,17.507611433156054,5,0,5,0.0,6,2,22,18,3,3,39,Hertha Berlin,31,Germany - 1. Bundesliga
341,Peter Niemeyer,703,394.0,309,56.04551920341394,181,73,108,40.331491712707184,211,178,33,84.36018957345972,114,38,76,33.33333333333333,19.17325164601823,2,0,2,0.0,5,0,3,2,1,1,51,Darmstadt 98,31,Germany - 1. Bundesliga
342,Peter Pekarík,611,475.0,136,77.74140752864157,77,52,25,67.53246753246754,278,256,22,92.08633093525181,66,31,35,46.96969696969697,17.049989588264484,27,11,16,40.74074074074074,5,1,20,8,11,5,16,Hertha Berlin,12,Germany - 1. Bundesliga
343,Philip Heise,90,66.0,24,73.33333333333333,14,8,6,57.14285714285714,38,31,7,81.57894736842105,16,7,9,43.75,20.799902446848,2,1,1,50.0,0,0,4,1,2,0,6,VfB Stuttgart,5,Germany - 1. Bundesliga
344,Philipp Bargfrede,511,375.0,136,73.38551859099805,87,43,44,49.42528735632184,263,241,22,91.63498098859316,53,18,35,33.9622641509434,19.1150163897027,2,0,2,0.0,5,1,8,4,1,0,22,Werder Bremen,14,Germany - 1. Bundesliga
345,Philipp Hosiner,154,106.0,48,68.83116883116884,13,6,7,46.15384615384615,73,61,12,83.56164383561644,14,3,11,21.428571428571427,14.956260173812986,11,2,9,18.181818181818183,4,0,9,5,7,4,11,FC Köln,15,Germany - 1. Bundesliga
346,Philipp Lahm,2127,1924.0,203,90.45604137282558,213,173,40,81.2206572769953,1475,1412,63,95.72881355932203,114,71,43,62.28070175438597,17.132681127021495,37,14,23,37.83783783783784,46,1,15,10,10,6,21,Bayern Munich,26,Germany - 1. Bundesliga
347,Philipp Max,1031,761.0,270,73.81183317167799,114,55,59,48.24561403508772,459,415,44,90.41394335511983,148,51,97,34.45945945945946,19.66243686178801,66,23,43,34.84848484848485,14,0,9,4,5,1,21,Augsburg,26,Germany - 1. Bundesliga
348,Philipp Ochs,246,183.0,63,74.39024390243902,20,12,8,60.0,152,126,26,82.89473684210526,16,1,15,6.25,15.55046118049756,2,0,2,0.0,6,1,6,3,3,2,5,Hoffenheim,13,Germany - 1. Bundesliga
349,Phillipp Klement,24,17.0,7,70.83333333333334,3,1,2,33.33333333333333,16,15,1,93.75,5,0,5,0.0,20.98423436241,0,0,0,0.0,0,0,0,0,0,0,0,FSV Mainz 05,2,Germany - 1. Bundesliga
350,Pierre Bengtsson,714,508.0,206,71.1484593837535,104,49,55,47.11538461538461,292,262,30,89.72602739726028,104,30,74,28.846153846153843,20.16311778221244,17,5,12,29.411764705882355,9,0,10,2,9,1,12,FSV Mainz 05,16,Germany - 1. Bundesliga
351,Pierre-Emerick Aubameyang,552,367.0,185,66.48550724637681,30,12,18,40.0,333,271,62,81.38138138138137,19,7,12,36.84210526315789,12.95841769350913,50,17,33,34.0,25,5,28,14,21,10,16,Borussia Dortmund,31,Germany - 1. Bundesliga
352,Pierre-Emile Højbjerg,783,682.0,101,87.10089399744572,106,79,27,74.52830188679245,553,523,30,94.57504520795659,64,39,25,60.9375,18.04975740150345,3,1,2,33.33333333333333,6,1,26,15,8,3,36,Schalke 04,23,Germany - 1. Bundesliga
353,Pierre-Michel Lasogga,491,336.0,155,68.43177189409369,64,26,38,40.625,250,202,48,80.80000000000001,16,7,9,43.75,13.555529345874866,13,2,11,15.384615384615385,16,2,28,15,14,7,34,Hamburger SV,30,Germany - 1. Bundesliga
354,Piotr Trochowski,77,60.0,17,77.92207792207793,14,8,6,57.14285714285714,47,44,3,93.61702127659575,12,4,8,33.33333333333333,19.03911906672,1,0,1,0.0,3,0,1,0,1,0,5,Augsburg,5,Germany - 1. Bundesliga
355,Pirmin Schwegler,743,597.0,146,80.34993270524899,91,52,39,57.14285714285714,467,438,29,93.79014989293361,69,24,45,34.78260869565217,17.797149132679138,6,1,5,16.666666666666664,9,0,13,7,4,1,30,Hoffenheim,21,Germany - 1. Bundesliga
356,Przemysław Tytoń,919,549.0,370,59.73884657236126,115,29,86,25.217391304347824,270,268,2,99.25925925925925,547,184,363,33.63802559414991,42.690431264623285,0,0,0,0.0,1,0,0,0,0,0,3,VfB Stuttgart,30,Germany - 1. Bundesliga
357,Raffael Caetano de Araújo,1184,948.0,236,80.06756756756756,98,65,33,66.3265306122449,842,742,100,88.12351543942994,77,30,47,38.961038961038966,14.493379501219255,38,12,26,31.57894736842105,49,10,88,55,48,27,68,Borussia Mönchengladbach,31,Germany - 1. Bundesliga
358,Ragnar Klavan,1501,1266.0,235,84.3437708194537,173,80,93,46.24277456647399,844,823,21,97.51184834123224,220,82,138,37.27272727272727,25.4597701933132,2,2,0,100.0,6,0,2,2,0,0,16,Augsburg,31,Germany - 1. Bundesliga
359,Ralf Fährmann,1333,901.0,432,67.59189797449362,102,27,75,26.47058823529412,437,435,2,99.54233409610984,721,302,419,41.88626907073509,39.4651515685633,0,0,0,0.0,0,0,0,0,0,0,5,Schalke 04,34,Germany - 1. Bundesliga
360,Ramazan Özcan,1102,515.0,587,46.73321234119782,502,157,345,31.274900398406373,148,147,1,99.32432432432432,893,314,579,35.162374020156776,55.54173999647303,0,0,0,0.0,0,0,4,3,0,0,8,Ingolstadt,28,Germany - 1. Bundesliga
361,Raúl Marcelo Bobadilla,506,384.0,122,75.8893280632411,39,27,12,69.23076923076923,295,254,41,86.10169491525423,49,23,26,46.93877551020408,15.776780620758544,20,6,14,30.0,26,2,69,41,43,24,65,Augsburg,27,Germany - 1. Bundesliga
362,René Adler,831,434.0,397,52.226233453670275,113,11,102,9.734513274336283,175,173,2,98.85714285714286,562,176,386,31.316725978647685,45.1216946663792,0,0,0,0.0,0,1,1,1,0,0,4,Hamburger SV,24,Germany - 1. Bundesliga
363,Ricardo Iván Rodríguez Araya,1563,1266.0,297,80.99808061420346,154,103,51,66.88311688311688,903,854,49,94.57364341085271,254,121,133,47.63779527559055,20.39509237424361,68,19,49,27.941176470588236,33,3,24,19,5,4,19,Wolfsburg,24,Germany - 1. Bundesliga
364,Robbie Kruse,170,114.0,56,67.05882352941175,10,4,6,40.0,101,84,17,83.16831683168317,9,0,9,0.0,11.64339646080353,11,1,10,9.090909090909092,5,0,5,1,4,1,16,VfB Stuttgart,12,Germany - 1. Bundesliga
365,Robert Bauer,724,462.0,262,63.812154696132595,142,73,69,51.40845070422535,239,206,33,86.19246861924687,126,36,90,28.57142857142857,20.089479749910165,16,5,11,31.25,7,0,11,8,5,3,29,Ingolstadt,24,Germany - 1. Bundesliga
366,Robert Lewandowski,765,608.0,157,79.47712418300654,51,33,18,64.70588235294117,583,505,78,86.62092624356775,17,8,9,47.05882352941176,13.011162914005459,13,2,11,15.384615384615385,16,2,53,29,38,21,55,Bayern Munich,32,Germany - 1. Bundesliga
367,Roberto Hilbert,467,299.0,168,64.02569593147751,95,46,49,48.421052631578945,188,156,32,82.97872340425532,90,31,59,34.44444444444444,21.18376363015041,19,6,13,31.57894736842105,6,1,23,16,11,7,7,Bayer Leverkusen,12,Germany - 1. Bundesliga
368,Robin Knoche,608,528.0,80,86.8421052631579,46,23,23,50.0,398,380,18,95.47738693467338,60,23,37,38.333333333333336,22.026756671737104,0,0,0,0.0,3,0,2,1,0,0,5,Wolfsburg,11,Germany - 1. Bundesliga
369,Roel Brouwers,185,173.0,12,93.51351351351352,5,4,1,80.0,142,138,4,97.1830985915493,3,0,3,0.0,19.607517829198702,0,0,0,0.0,0,0,1,0,1,0,2,Borussia Mönchengladbach,8,Germany - 1. Bundesliga
370,Roger de Oliveira Bernardo,811,542.0,269,66.83107274969173,183,70,113,38.25136612021858,307,279,28,90.87947882736157,129,38,91,29.457364341085274,20.83789205527472,4,0,4,0.0,6,0,24,18,5,3,85,Ingolstadt,29,Germany - 1. Bundesliga
371,Romain Brégerie,378,246.0,132,65.07936507936508,88,45,43,51.13636363636363,132,118,14,89.39393939393939,71,25,46,35.2112676056338,21.364636920918286,2,0,2,0.0,4,0,1,0,0,0,7,Ingolstadt,21,Germany - 1. Bundesliga
372,Roman Bürki,1012,770.0,242,76.08695652173914,73,7,66,9.58904109589041,532,528,4,99.24812030075188,332,101,231,30.42168674698795,33.08966004794727,0,0,0,0.0,0,0,2,2,0,0,6,Borussia Dortmund,33,Germany - 1. Bundesliga
373,Roman Neustädter,1418,1270.0,148,89.56276445698167,103,65,38,63.10679611650486,924,891,33,96.42857142857143,89,36,53,40.44943820224719,20.987667390214103,0,0,0,0.0,3,0,6,4,0,0,10,Schalke 04,30,Germany - 1. Bundesliga
374,Roman Weidenfeller,29,18.0,11,62.06896551724138,2,0,2,0.0,12,12,0,100.0,16,5,11,31.25,36.33604520151724,0,0,0,0.0,0,0,0,0,0,0,0,Borussia Dortmund,1,Germany - 1. Bundesliga
375,Ron-Robert Zieler,1227,841.0,386,68.54115729421353,152,38,114,25.0,389,387,2,99.48586118251927,632,256,376,40.50632911392405,39.744196445129774,0,0,0,0.0,0,0,0,0,0,0,5,Hannover 96,34,Germany - 1. Bundesliga
376,Ronaldo Aparecido Rodrigues,1790,1552.0,238,86.70391061452514,197,119,78,60.40609137055838,1153,1113,40,96.53078924544666,171,80,91,46.783625730994146,21.05128881466029,4,2,2,50.0,9,0,11,11,2,2,26,Wolfsburg,29,Germany - 1. Bundesliga
377,Ronny Heberson Furtado de Araújo,10,8.0,2,80.0,2,2,0,100.0,7,6,1,85.71428571428571,3,2,1,66.66666666666666,19.047274252848002,0,0,0,0.0,0,0,0,0,0,0,1,Hertha Berlin,1,Germany - 1. Bundesliga
378,Roy Beerens,25,18.0,7,72.0,2,1,1,50.0,19,14,5,73.68421052631578,2,2,0,100.0,14.285604222028802,3,2,1,66.66666666666666,1,0,2,1,1,1,2,Hertha Berlin,2,Germany - 1. Bundesliga
379,Rune Almenning Jarstein,1399,878.0,521,62.75911365260901,171,34,137,19.883040935672515,464,462,2,99.56896551724138,773,265,508,34.28201811125485,41.67767628121098,0,0,0,0.0,0,0,1,1,0,0,4,Hertha Berlin,29,Germany - 1. Bundesliga
380,Russell Canouse,8,7.0,1,87.5,1,0,1,0.0,6,6,0,100.0,1,0,1,0.0,18.3800399607,0,0,0,0.0,0,0,0,0,0,0,0,Hoffenheim,1,Germany - 1. Bundesliga
381,Salif Sané,1531,1177.0,354,76.87785760940562,253,137,116,54.1501976284585,859,801,58,93.24796274738067,167,69,98,41.31736526946108,19.457198937273937,11,4,7,36.36363636363637,9,0,46,33,7,5,63,Hannover 96,31,Germany - 1. Bundesliga
382,Salomon Armand Magloire Kalou,666,511.0,155,76.72672672672672,65,39,26,60.0,469,397,72,84.64818763326227,23,9,14,39.130434782608695,13.673370467619245,25,7,18,28.000000000000004,20,2,81,43,46,25,42,Hertha Berlin,32,Germany - 1. Bundesliga
383,Sambou Yatabaré,223,127.0,96,56.95067264573991,25,14,11,56.00000000000001,92,70,22,76.08695652173914,28,10,18,35.714285714285715,17.10170644232696,25,4,21,16.0,5,1,20,14,12,9,8,Werder Bremen,8,Germany - 1. Bundesliga
384,Sandro Sirigu,28,9.0,19,32.142857142857146,3,1,2,33.33333333333333,16,7,9,43.75,6,0,6,0.0,20.757850096757146,3,2,1,66.66666666666666,0,2,2,1,0,0,0,Darmstadt 98,5,Germany - 1. Bundesliga
385,Sandro Wagner,914,453.0,461,49.562363238512035,172,64,108,37.2093023255814,292,232,60,79.45205479452055,65,26,39,40.0,15.127110332640077,25,6,19,24.0,18,3,31,14,16,7,78,Darmstadt 98,32,Germany - 1. Bundesliga
386,Santiago García,1304,896.0,408,68.71165644171779,185,85,100,45.94594594594595,467,410,57,87.79443254817987,181,66,115,36.46408839779006,19.625715831336073,61,21,40,34.42622950819672,28,2,34,21,18,11,68,Werder Bremen,29,Germany - 1. Bundesliga
387,Sascha Mölders,7,2.0,5,28.57142857142857,2,0,2,0.0,2,1,1,50.0,0,0,0,0.0,12.737002407942855,0,0,0,0.0,0,0,1,0,1,0,0,Augsburg,4,Germany - 1. Bundesliga
388,Sascha Riether,813,647.0,166,79.58179581795818,92,53,39,57.608695652173914,406,379,27,93.34975369458128,95,32,63,33.68421052631579,19.37350836857535,35,8,27,22.857142857142858,11,0,6,0,3,0,8,Schalke 04,17,Germany - 1. Bundesliga
389,Sead Kolašinac,990,760.0,230,76.76767676767676,89,52,37,58.42696629213483,508,437,71,86.0236220472441,74,30,44,40.54054054054054,16.589145307181166,30,14,16,46.666666666666664,15,0,24,12,17,8,18,Schalke 04,23,Germany - 1. Bundesliga
390,Sebastian Boenisch,383,250.0,133,65.27415143603133,76,36,40,47.368421052631575,134,112,22,83.5820895522388,51,12,39,23.52941176470588,18.818001876717492,11,2,9,18.181818181818183,3,0,6,5,2,1,6,Bayer Leverkusen,8,Germany - 1. Bundesliga
391,Sebastian Jung,374,299.0,75,79.94652406417111,36,22,14,61.111111111111114,206,183,23,88.83495145631069,37,17,20,45.94594594594595,18.4649148842169,17,10,7,58.82352941176471,11,1,9,7,4,3,6,Wolfsburg,11,Germany - 1. Bundesliga
392,Sebastian Langkamp,1190,1024.0,166,86.05042016806723,97,46,51,47.42268041237113,744,718,26,96.50537634408603,119,45,74,37.81512605042017,21.710165836256472,0,0,0,0.0,2,1,4,3,1,1,31,Hertha Berlin,22,Germany - 1. Bundesliga
393,Sebastian Rode,311,273.0,38,87.78135048231512,27,22,5,81.48148148148148,234,222,12,94.87179487179486,11,7,4,63.63636363636363,15.563076826531834,2,1,1,50.0,2,1,5,4,3,2,5,Bayern Munich,15,Germany - 1. Bundesliga
394,Sebastian Rudy,964,733.0,231,76.03734439834025,147,87,60,59.183673469387756,613,532,81,86.7862969004894,99,52,47,52.52525252525253,18.103097714857096,13,3,10,23.076923076923077,19,1,26,13,8,1,26,Hoffenheim,24,Germany - 1. Bundesliga
395,Serdar Taşçı,194,173.0,21,89.17525773195877,15,11,4,73.33333333333333,150,147,3,98.0,6,4,2,66.66666666666666,17.301877790247836,0,0,0,0.0,0,0,1,1,0,0,1,Bayern Munich,3,Germany - 1. Bundesliga
396,Sereso Geoffroy Gonzaroua Dié,956,798.0,158,83.47280334728033,136,85,51,62.5,627,568,59,90.59011164274322,85,42,43,49.411764705882355,19.778187331211047,8,2,6,25.0,15,2,60,39,23,13,28,VfB Stuttgart,23,Germany - 1. Bundesliga
397,Shinji Kagawa,1436,1218.0,218,84.81894150417827,158,120,38,75.9493670886076,1056,977,79,92.51893939393939,99,68,31,68.68686868686868,15.483541399835767,27,10,17,37.03703703703704,32,7,43,25,22,12,42,Borussia Dortmund,29,Germany - 1. Bundesliga
398,Sidney Sam,9,5.0,4,55.55555555555556,2,1,1,50.0,8,4,4,50.0,0,0,0,0.0,11.142877201120001,0,0,0,0.0,0,0,0,0,0,0,1,Schalke 04,2,Germany - 1. Bundesliga
399,Simon Zoller,276,189.0,87,68.47826086956522,21,10,11,47.61904761904761,151,125,26,82.78145695364239,15,4,11,26.666666666666668,15.464808368175651,19,5,14,26.31578947368421,8,1,13,5,9,4,12,FC Köln,24,Germany - 1. Bundesliga
400,Slobodan Medojević,252,199.0,53,78.96825396825396,33,19,14,57.57575757575758,174,157,17,90.22988505747126,10,2,8,20.0,16.00091036286,3,0,3,0.0,3,1,4,4,2,2,9,Eintracht Frankfurt,12,Germany - 1. Bundesliga
401,Slobodan Rajković,212,118.0,94,55.660377358490564,58,18,40,31.03448275862069,45,38,7,84.44444444444444,65,20,45,30.76923076923077,25.038149943824152,0,0,0,0.0,1,1,2,2,0,0,9,Darmstadt 98,14,Germany - 1. Bundesliga
402,Sokratis Papastathopoulos,1862,1671.0,191,89.7422126745435,157,89,68,56.68789808917197,1341,1317,24,98.2102908277405,116,31,85,26.72413793103448,19.816104560815297,3,1,2,33.33333333333333,3,0,8,7,2,2,32,Borussia Dortmund,25,Germany - 1. Bundesliga
403,Sonny Kittel,95,62.0,33,65.26315789473685,9,3,6,33.33333333333333,53,41,12,77.35849056603774,7,2,5,28.57142857142857,14.716256625473685,4,2,2,50.0,1,0,6,3,5,2,9,Eintracht Frankfurt,8,Germany - 1. Bundesliga
404,Stefan Aigner,762,541.0,221,70.99737532808399,52,24,28,46.15384615384615,439,363,76,82.6879271070615,47,15,32,31.914893617021278,14.123126975279998,51,16,35,31.372549019607842,18,4,48,18,25,10,56,Eintracht Frankfurt,31,Germany - 1. Bundesliga
405,Stefan Bell,1563,1229.0,334,78.63083813179782,211,86,125,40.758293838862556,759,720,39,94.86166007905138,277,98,179,35.37906137184115,24.32828322974096,2,0,2,0.0,3,2,13,10,1,0,17,FSV Mainz 05,30,Germany - 1. Bundesliga
406,Stefan Kießling,634,398.0,236,62.77602523659306,85,30,55,35.294117647058826,264,210,54,79.54545454545455,19,4,15,21.052631578947366,11.700113054714915,6,2,4,33.33333333333333,10,3,42,15,34,12,74,Bayer Leverkusen,30,Germany - 1. Bundesliga
407,Stefan Lex,160,99.0,61,61.875,14,5,9,35.714285714285715,84,65,19,77.38095238095238,9,2,7,22.22222222222222,13.6670571219906,12,2,10,16.666666666666664,14,0,7,2,5,2,21,Ingolstadt,20,Germany - 1. Bundesliga
408,Stefan Reinartz,841,706.0,135,83.94768133174792,116,71,45,61.206896551724135,544,506,38,93.01470588235294,76,43,33,56.57894736842105,18.405127497024687,0,0,0,0.0,5,1,6,4,1,1,6,Eintracht Frankfurt,15,Germany - 1. Bundesliga
409,Stefan Wannenwetsch,9,6.0,3,66.66666666666666,0,0,0,0.0,7,5,2,71.42857142857143,0,0,0,0.0,11.65343868952,0,0,0,0.0,0,0,0,0,0,0,0,Ingolstadt,1,Germany - 1. Bundesliga
410,Steven Zuber,220,148.0,72,67.27272727272727,17,9,8,52.94117647058824,136,104,32,76.47058823529412,18,7,11,38.88888888888889,14.651975628772362,11,3,8,27.27272727272727,7,0,22,10,13,7,9,Hoffenheim,12,Germany - 1. Bundesliga
411,Suat Serdar,82,64.0,18,78.04878048780488,7,3,4,42.857142857142854,58,49,9,84.48275862068965,5,5,0,100.0,16.816911516992192,1,0,1,0.0,1,0,6,5,2,1,5,FSV Mainz 05,12,Germany - 1. Bundesliga
412,Sven Bender,1163,1053.0,110,90.54170249355116,131,95,36,72.51908396946564,873,855,18,97.9381443298969,68,29,39,42.64705882352941,18.28608762399725,1,0,1,0.0,7,0,9,7,3,2,8,Borussia Dortmund,19,Germany - 1. Bundesliga
413,Sven Schipplock,257,171.0,86,66.53696498054474,22,13,9,59.09090909090909,141,118,23,83.68794326241135,9,3,6,33.33333333333333,13.379555567578834,8,4,4,50.0,10,4,16,5,8,2,24,Hamburger SV,20,Germany - 1. Bundesliga
414,Sven Ulreich,18,12.0,6,66.66666666666666,0,0,0,0.0,7,7,0,100.0,9,3,6,33.33333333333333,32.76575445312,0,0,0,0.0,0,0,0,0,0,0,0,Bayern Munich,1,Germany - 1. Bundesliga
415,Szabolcs Huszti,678,474.0,204,69.91150442477876,100,49,51,49.0,367,328,39,89.3732970027248,132,42,90,31.818181818181817,18.94196422046867,46,17,29,36.95652173913043,32,1,18,6,6,2,36,Eintracht Frankfurt,15,Germany - 1. Bundesliga
416,Takashi Inui,10,7.0,3,70.0,0,0,0,0.0,6,5,1,83.33333333333334,1,1,0,100.0,15.631447181544,1,1,0,100.0,1,0,1,0,0,0,1,Eintracht Frankfurt,1,Germany - 1. Bundesliga
417,Tarik Elyounoussi,160,117.0,43,73.125,15,9,6,60.0,113,93,20,82.30088495575221,8,3,5,37.5,14.2415746869105,9,3,6,33.33333333333333,5,1,10,6,4,1,13,Hoffenheim,6,Germany - 1. Bundesliga
418,Theodor Gebre Selassie,1419,1030.0,389,72.58632840028189,140,87,53,62.142857142857146,580,521,59,89.82758620689654,99,34,65,34.34343434343434,16.508361094180465,47,21,26,44.680851063829785,23,2,23,10,11,6,49,Werder Bremen,33,Germany - 1. Bundesliga
419,Thiago Alcântara do Nascimento,1590,1396.0,194,87.79874213836479,210,161,49,76.66666666666667,1117,1052,65,94.18084153983885,163,101,62,61.963190184049076,18.327919577557132,16,8,8,50.0,32,3,56,42,18,13,45,Bayern Munich,27,Germany - 1. Bundesliga
420,Thomas Kessler,27,16.0,11,59.25925925925925,1,1,0,100.0,2,2,0,100.0,21,10,11,47.61904761904761,51.34676006133333,0,0,0,0.0,0,0,1,1,0,0,0,FC Köln,1,Germany - 1. Bundesliga
421,Thomas Kraft,247,150.0,97,60.72874493927125,25,6,19,24.0,81,81,0,100.0,139,45,94,32.37410071942446,41.63026211583158,0,0,0,0.0,0,0,0,0,0,0,3,Hertha Berlin,6,Germany - 1. Bundesliga
422,Thomas Müller,1112,846.0,266,76.07913669064749,89,59,30,66.29213483146067,733,621,112,84.72032742155525,47,19,28,40.42553191489361,15.058722529390144,51,22,29,43.13725490196079,57,3,49,29,32,19,35,Bayern Munich,31,Germany - 1. Bundesliga
423,Thorgan Hazard,823,600.0,223,72.90400972053463,65,41,24,63.07692307692307,516,433,83,83.91472868217055,87,32,55,36.7816091954023,16.809180132203256,36,6,30,16.666666666666664,31,3,57,38,37,24,29,Borussia Mönchengladbach,29,Germany - 1. Bundesliga
424,Tim Dierßen,3,1.0,2,33.33333333333333,1,0,1,0.0,1,1,0,100.0,1,0,1,0.0,28.081462963199996,1,0,1,0.0,0,0,0,0,0,0,0,Hannover 96,1,Germany - 1. Bundesliga
425,Tim Matavž,71,43.0,28,60.56338028169014,7,2,5,28.57142857142857,33,27,6,81.81818181818183,3,1,2,33.33333333333333,13.348167441566197,8,2,6,25.0,4,0,6,5,3,2,12,Augsburg,11,Germany - 1. Bundesliga
426,Timm Klose,485,434.0,51,89.48453608247424,40,24,16,60.0,295,286,9,96.94915254237289,41,21,20,51.21951219512195,22.19815697061229,0,0,0,0.0,0,0,2,2,0,0,4,Wolfsburg,8,Germany - 1. Bundesliga
427,Timo Baumgartl,688,544.0,144,79.06976744186046,104,45,59,43.269230769230774,377,354,23,93.89920424403184,92,24,68,26.08695652173913,22.150824814413838,0,0,0,0.0,0,0,2,0,0,0,19,VfB Stuttgart,19,Germany - 1. Bundesliga
428,Timo Horn,1003,597.0,406,59.52143569292123,193,60,133,31.088082901554404,272,270,2,99.26470588235294,635,238,397,37.480314960629926,46.2992680617509,0,0,0,0.0,1,0,0,0,0,0,10,FC Köln,33,Germany - 1. Bundesliga
429,Timo Werner,562,382.0,180,67.97153024911033,47,20,27,42.5531914893617,331,271,60,81.87311178247734,16,5,11,31.25,12.795723093277152,31,6,25,19.35483870967742,17,3,48,18,33,13,48,VfB Stuttgart,33,Germany - 1. Bundesliga
430,Timothy Chandler,309,202.0,107,65.37216828478964,52,25,27,48.07692307692308,117,97,20,82.90598290598291,50,18,32,36.0,18.57648261840932,20,6,14,30.0,0,0,5,1,4,1,14,Eintracht Frankfurt,12,Germany - 1. Bundesliga
431,Tin Jedvaj,470,321.0,149,68.29787234042554,102,54,48,52.94117647058824,200,171,29,85.5,56,20,36,35.714285714285715,19.533302494371572,11,4,7,36.36363636363637,4,0,13,7,7,4,13,Bayer Leverkusen,15,Germany - 1. Bundesliga
432,Tobias Kempe,437,237.0,200,54.23340961098398,61,26,35,42.62295081967213,170,136,34,80.0,106,36,70,33.9622641509434,19.312466412639544,36,12,24,33.33333333333333,26,3,32,15,16,5,16,Darmstadt 98,31,Germany - 1. Bundesliga
433,Tobias Levels,928,725.0,203,78.125,96,51,45,53.125,379,339,40,89.44591029023746,81,27,54,33.33333333333333,16.719863259426205,19,6,13,31.57894736842105,5,2,12,7,9,5,18,Ingolstadt,16,Germany - 1. Bundesliga
434,Tobias Sippel,75,56.0,19,74.66666666666667,8,0,8,0.0,47,47,0,100.0,22,3,19,13.636363636363635,32.3795150484096,0,0,0,0.0,0,0,0,0,0,0,0,Borussia Mönchengladbach,2,Germany - 1. Bundesliga
435,Tobias Strobl,1128,926.0,202,82.09219858156028,145,85,60,58.620689655172406,668,620,48,92.81437125748504,116,57,59,49.137931034482754,19.227241114153404,18,7,11,38.88888888888889,10,1,18,8,7,1,37,Hoffenheim,26,Germany - 1. Bundesliga
436,Tobias Werner,193,116.0,77,60.10362694300518,16,6,10,37.5,74,63,11,85.13513513513513,53,17,36,32.075471698113205,21.36943613928124,17,6,11,35.294117647058826,15,1,8,5,4,3,7,Augsburg,13,Germany - 1. Bundesliga
437,Tohouri Zahoui Constant Djakpa,413,266.0,147,64.40677966101694,77,36,41,46.75324675324675,166,146,20,87.95180722891565,79,23,56,29.11392405063291,20.605222067334626,19,4,15,21.052631578947366,7,0,11,3,7,2,10,Eintracht Frankfurt,11,Germany - 1. Bundesliga
438,Tolga Ciğerci,664,540.0,124,81.32530120481928,63,37,26,58.730158730158735,412,384,28,93.20388349514563,68,24,44,35.294117647058826,18.816456763056145,13,5,8,38.46153846153847,7,2,27,15,10,4,20,Hertha Berlin,18,Germany - 1. Bundesliga
439,Tom Mickel,24,17.0,7,70.83333333333334,8,4,4,50.0,4,4,0,100.0,17,10,7,58.82352941176471,49.4399085495,0,0,0,0.0,0,0,0,0,0,0,0,Hamburger SV,1,Germany - 1. Bundesliga
440,Tomáš Pekhart,19,14.0,5,73.68421052631578,4,2,2,50.0,7,7,0,100.0,0,0,0,0.0,13.717791319225263,1,1,0,100.0,1,0,0,0,0,0,0,Ingolstadt,4,Germany - 1. Bundesliga
441,Toni Šunjić,516,401.0,115,77.71317829457365,50,27,23,54.0,264,253,11,95.83333333333334,59,23,36,38.983050847457626,20.02995031139163,0,0,0,0.0,2,0,4,4,0,0,12,VfB Stuttgart,19,Germany - 1. Bundesliga
442,Tony Jantschke,607,500.0,107,82.37232289950576,55,28,27,50.90909090909091,412,379,33,91.99029126213593,39,12,27,30.76923076923077,18.804336910244718,1,0,1,0.0,2,0,0,0,0,0,14,Borussia Mönchengladbach,12,Germany - 1. Bundesliga
443,Uffe Manich Bech,212,147.0,65,69.33962264150944,19,8,11,42.10526315789473,118,99,19,83.89830508474576,14,6,8,42.857142857142854,13.751866452341886,15,4,11,26.666666666666668,8,1,15,5,9,4,12,Hannover 96,11,Germany - 1. Bundesliga
444,Uilson de Souza Paula Júnior,1285,962.0,323,74.86381322957199,139,91,48,65.46762589928058,679,580,99,85.41973490427098,107,45,62,42.05607476635514,16.68222362723841,54,23,31,42.592592592592595,36,3,40,17,23,11,13,Schalke 04,23,Germany - 1. Bundesliga
445,Ulisses Alexandre Garcia Lopes,243,174.0,69,71.60493827160494,32,15,17,46.875,148,126,22,85.13513513513513,18,8,10,44.44444444444444,17.529282025063704,11,4,7,36.36363636363637,5,0,17,9,9,4,6,Werder Bremen,11,Germany - 1. Bundesliga
446,Valentin Stocker,212,125.0,87,58.9622641509434,21,5,16,23.809523809523807,108,83,25,76.85185185185185,20,6,14,30.0,16.513316849151508,15,4,11,26.666666666666668,8,0,19,8,15,5,8,Hertha Berlin,20,Germany - 1. Bundesliga
447,Valmir Sulejmani,33,20.0,13,60.60606060606061,6,4,2,66.66666666666666,23,18,5,78.26086956521739,0,0,0,0.0,12.874268795018182,2,0,2,0.0,0,0,4,2,3,2,3,Hannover 96,4,Germany - 1. Bundesliga
448,Vedad Ibišević,571,392.0,179,68.65148861646234,83,41,42,49.39759036144578,303,235,68,77.55775577557755,24,15,9,62.5,13.678011882151313,7,1,6,14.285714285714285,17,4,33,15,19,10,43,Hertha Berlin,26,Germany - 1. Bundesliga
449,Vladimír Darida,1710,1356.0,354,79.2982456140351,166,97,69,58.43373493975904,1082,985,97,91.03512014787431,171,66,105,38.59649122807017,17.092492587669472,43,6,37,13.953488372093023,33,2,25,18,11,9,56,Hertha Berlin,31,Germany - 1. Bundesliga
450,Vladlen Yurchenko,156,124.0,32,79.48717948717949,34,21,13,61.76470588235294,91,84,7,92.3076923076923,26,13,13,50.0,19.06600426196769,0,0,0,0.0,3,0,0,0,0,0,3,Bayer Leverkusen,7,Germany - 1. Bundesliga
451,Václav Kadlec,15,13.0,2,86.66666666666667,2,1,1,50.0,9,9,0,100.0,0,0,0,0.0,18.875010875759997,1,0,1,0.0,0,0,2,0,1,0,3,Eintracht Frankfurt,5,Germany - 1. Bundesliga
452,Waldemar Anton,246,187.0,59,76.01626016260163,29,17,12,58.620689655172406,146,128,18,87.67123287671232,30,12,18,40.0,18.32901796377073,1,0,1,0.0,1,0,2,2,0,0,5,Hannover 96,8,Germany - 1. Bundesliga
453,Wendell Nascimento Borges,1584,1201.0,383,75.82070707070707,190,114,76,60.0,795,704,91,88.55345911949686,165,55,110,33.33333333333333,16.70146556662591,39,8,31,20.51282051282051,18,0,39,18,24,10,42,Bayer Leverkusen,28,Germany - 1. Bundesliga
454,Xabier Alonso Olano,2351,2105.0,246,89.53636750319014,347,259,88,74.63976945244957,1729,1662,67,96.12492770387507,214,117,97,54.67289719626168,18.72525473282885,16,3,13,18.75,39,2,5,3,2,0,40,Bayern Munich,26,Germany - 1. Bundesliga
455,Yann Sommer,1375,961.0,414,69.89090909090909,80,14,66,17.5,612,610,2,99.67320261437908,559,158,401,28.264758497316638,35.07898080602304,0,0,0,0.0,0,0,0,0,0,0,2,Borussia Mönchengladbach,32,Germany - 1. Bundesliga
456,Yanni Regäsel,676,503.0,173,74.40828402366864,89,58,31,65.1685393258427,293,261,32,89.07849829351537,66,18,48,27.27272727272727,17.525527911151244,25,5,20,20.0,7,0,16,5,9,1,15,Eintracht Frankfurt,16,Germany - 1. Bundesliga
457,Yannick Gerhardt,795,616.0,179,77.48427672955975,94,61,33,64.8936170212766,505,450,55,89.10891089108911,56,18,38,32.142857142857146,18.36836756996649,24,7,17,29.166666666666668,18,4,43,22,22,11,52,FC Köln,29,Germany - 1. Bundesliga
458,Yoshinori Muto,265,182.0,83,68.67924528301886,25,12,13,48.0,169,129,40,76.33136094674556,12,6,6,50.0,12.71953462893283,14,8,6,57.14285714285714,10,2,39,19,27,13,25,FSV Mainz 05,20,Germany - 1. Bundesliga
459,Younès Belhanda,408,321.0,87,78.67647058823529,43,26,17,60.46511627906976,290,253,37,87.24137931034483,31,16,15,51.61290322580645,15.028656497408823,6,2,4,33.33333333333333,19,1,32,17,17,9,14,Schalke 04,15,Germany - 1. Bundesliga
460,Yunus Mallı,873,620.0,253,71.01947308132875,97,58,39,59.79381443298969,555,459,96,82.70270270270271,36,15,21,41.66666666666667,14.748726348872989,32,10,22,31.25,38,4,109,49,66,27,47,FSV Mainz 05,34,Germany - 1. Bundesliga
461,Yūya Ōsako,487,366.0,121,75.15400410677618,76,46,30,60.526315789473685,286,251,35,87.76223776223776,40,25,15,62.5,16.858670029126078,23,9,14,39.130434782608695,17,0,28,18,19,12,42,FC Köln,25,Germany - 1. Bundesliga
462,Zlatko Junuzović,1071,679.0,392,63.39869281045751,171,78,93,45.614035087719294,497,423,74,85.11066398390342,289,103,186,35.6401384083045,21.266320098805377,71,22,49,30.985915492957744,69,9,45,21,26,10,59,Werder Bremen,30,Germany - 1. Bundesliga
463,Zoltán Stieber,2,2.0,0,100.0,0,0,0,0.0,2,2,0,100.0,0,0,0,0.0,18.112531669200003,0,0,0,0.0,0,0,0,0,0,0,0,Hamburger SV,1,Germany - 1. Bundesliga
464,Ádám Szalai,264,182.0,82,68.93939393939394,29,19,10,65.51724137931035,149,122,27,81.87919463087249,4,1,3,25.0,12.447379921617273,7,0,7,0.0,8,1,26,18,13,9,12,Hannover 96,16,Germany - 1. Bundesliga
465,Álvaro Domínguez Soto,302,246.0,56,81.45695364238411,39,11,28,28.205128205128204,184,183,1,99.45652173913044,45,12,33,26.666666666666668,23.09972379862649,0,0,0,0.0,1,0,2,1,1,0,8,Borussia Mönchengladbach,6,Germany - 1. Bundesliga
466,Änis Ben-Hatira,168,115.0,53,68.45238095238095,24,11,13,45.83333333333333,98,82,16,83.6734693877551,12,7,5,58.333333333333336,15.72145446870857,9,5,4,55.55555555555556,3,1,26,15,12,6,17,Eintracht Frankfurt,9,Germany - 1. Bundesliga
467,Ömer Toprak,722,554.0,168,76.73130193905817,116,58,58,50.0,361,342,19,94.73684210526315,142,57,85,40.140845070422536,22.342279331374403,0,0,0,0.0,6,0,8,6,0,0,13,Bayer Leverkusen,19,Germany - 1. Bundesliga
468,Özkan Yıldırım,7,7.0,0,100.0,0,0,0,0.0,7,7,0,100.0,0,0,0,0.0,9.016666090148572,0,0,0,0.0,0,0,1,0,0,0,0,Werder Bremen,1,Germany - 1. Bundesliga
469,Ørjan Håskjold Nyland,214,93.0,121,43.45794392523364,96,29,67,30.208333333333332,17,16,1,94.11764705882352,186,68,118,36.55913978494624,58.046074902706536,0,0,0,0.0,0,0,0,0,0,0,0,Ingolstadt,6,Germany - 1. Bundesliga
470,İlkay Gündoğan,2007,1760.0,247,87.69307424015945,292,217,75,74.31506849315068,1492,1409,83,94.43699731903486,131,58,73,44.274809160305345,18.191332028757667,13,3,10,23.076923076923077,20,3,66,48,23,15,51,Borussia Dortmund,25,Germany - 1. Bundesliga
471,Łukasz Piszczek,1281,1055.0,226,82.35753317720531,124,90,34,72.58064516129032,847,777,70,91.73553719008265,77,31,46,40.25974025974026,16.308692615983137,34,11,23,32.35294117647059,16,3,15,9,4,0,11,Borussia Dortmund,20,Germany - 1. Bundesliga
472,Łukasz Załuska,32,19.0,13,59.375,5,2,3,40.0,1,1,0,100.0,27,15,12,55.55555555555556,51.16351172535,0,0,0,0.0,0,0,0,0,0,0,0,Darmstadt 98,1,Germany - 1. Bundesliga
