index,player,total_passes,total_completed,total_uncompleted,total_percentage%,f3_passes,f3_completed,f3_uncompleted,f3_percentage%,short_passes,short_completed,short_uncompleted,short_percentage%,long_passes,long_completed,long_uncompleted,long_percentage%,average_pass_length,crosses,crosses_completed,crosses_uncompleted,crosses_percentage%,total_shot_assists,total_goal_assists,dribbles,dribbles_completed,dribbles_f3,dribbles_f3_completed,fouls_won,team,MP,competition
0,Abdoul Karim Yoda,526,392,134,74.52471482889734,48,30,18,62.5,295,262,33,88.8135593220339,59,19,40,32.20338983050847,17.709534917397445,27,7,20,25.925925925925924,10,0,67,40,36,23,10,Getafe,18,Spain - La Liga
1,Abdoulaye Doucouré,577,482,95,83.53552859618716,48,31,17,64.58333333333334,378,351,27,92.85714285714286,41,21,20,51.21951219512195,17.36005746690967,3,2,1,66.66666666666666,9,2,18,10,2,1,8,Granada,15,Spain - La Liga
2,Abraham González Casanova,531,414,117,77.96610169491525,66,41,25,62.121212121212125,293,264,29,90.10238907849829,74,35,39,47.2972972972973,18.88360286264,12,1,11,8.333333333333332,15,1,6,2,2,1,9,Espanyol,20,Spain - La Liga
3,Adalberto Peñaranda Maestre,381,276,105,72.44094488188976,32,16,16,50.0,264,214,50,81.06060606060606,18,9,9,50.0,13.72778394888,17,3,14,17.647058823529413,12,3,66,40,37,20,41,Granada,23,Spain - La Liga
4,Aderllan Leandro de Jesus Santos,657,545,112,82.95281582952816,46,17,29,36.95652173913043,376,361,15,96.01063829787235,74,20,54,27.027027027027028,22.013345835746847,0,0,0,0.0,1,0,9,8,0,0,6,Valencia,17,Spain - La Liga
5,Adil Rami,1099,861,238,78.343949044586,166,73,93,43.97590361445783,563,537,26,95.38188277087033,204,88,116,43.13725490196079,24.144540646282657,6,0,6,0.0,4,1,5,3,3,1,19,Sevilla,28,Spain - La Liga
6,Adnane Tighadouini,146,88,58,60.273972602739725,14,8,6,57.14285714285714,84,63,21,75.0,22,9,13,40.909090909090914,17.127779499996162,9,4,5,44.44444444444444,5,0,34,16,17,7,6,Málaga,10,Spain - La Liga
7,Adriano Correia Claro,361,326,35,90.30470914127424,26,23,3,88.46153846153845,239,229,10,95.81589958158996,23,14,9,60.86956521739131,17.229726512181276,10,2,8,20.0,5,1,3,3,0,0,7,Barcelona,8,Spain - La Liga
8,Adrián Embarba Blázquez,761,480,281,63.074901445466494,46,24,22,52.17391304347826,410,339,71,82.68292682926828,118,34,84,28.8135593220339,17.025230150399686,93,23,70,24.731182795698924,24,4,70,30,32,13,35,Rayo Vallecano,28,Spain - La Liga
9,Adrián González Morales,1030,732,298,71.06796116504854,167,94,73,56.287425149700596,512,441,71,86.1328125,100,37,63,37.0,17.281175552041773,29,8,21,27.586206896551722,17,0,29,12,15,4,17,Eibar,32,Spain - La Liga
10,Adrián López Álvarez,345,229,116,66.3768115942029,31,15,16,48.38709677419355,206,168,38,81.55339805825243,11,6,5,54.54545454545454,13.490014271455305,10,5,5,50.0,13,4,24,9,10,5,12,Villarreal,16,Spain - La Liga
11,Adrián Marín Gómez,545,412,133,75.59633027522936,52,30,22,57.692307692307686,277,244,33,88.08664259927798,56,20,36,35.714285714285715,18.123017474860184,14,5,9,35.714285714285715,6,0,17,8,10,3,5,Villarreal,11,Spain - La Liga
12,Ager Aketxe Barrutia,95,70,25,73.68421052631578,12,9,3,75.0,52,47,5,90.38461538461539,15,7,8,46.666666666666664,16.01581880743579,5,0,5,0.0,1,0,2,1,1,1,3,Athletic Club,3,Spain - La Liga
13,Alberto De La Bella Madureño,808,599,209,74.13366336633663,84,53,31,63.095238095238095,362,320,42,88.39779005524862,97,31,66,31.958762886597935,18.26186072253193,38,8,30,21.052631578947366,8,0,10,5,7,4,16,Real Sociedad,15,Spain - La Liga
14,Alberto García Cabrera,206,102,104,49.51456310679612,43,8,35,18.6046511627907,49,48,1,97.95918367346938,137,35,102,25.547445255474454,49.08030286358447,0,0,0,0.0,0,0,0,0,0,0,1,Sporting Gijón,6,Spain - La Liga
15,Alberto Guitián Ceballos,28,17,11,60.71428571428571,5,1,4,20.0,3,3,0,100.0,8,3,5,37.5,27.05280711456857,0,0,0,0.0,0,0,1,1,0,0,0,Sporting Gijón,1,Spain - La Liga
16,Alberto Lopo García,342,262,80,76.60818713450293,48,16,32,33.33333333333333,171,165,6,96.49122807017544,58,15,43,25.862068965517242,24.87828205783579,0,0,0,0.0,1,0,1,1,0,0,6,RC Deportivo La Coruña,10,Spain - La Liga
17,Alberto Lora Ramos,1333,999,334,74.94373593398349,177,90,87,50.847457627118644,687,633,54,92.13973799126637,171,44,127,25.730994152046783,18.617105722112317,37,12,25,32.432432432432435,17,3,19,11,10,6,27,Sporting Gijón,31,Spain - La Liga
18,Alberto Mateus Contreiras Gonçalves,241,155,86,64.31535269709543,36,14,22,38.88888888888889,97,91,6,93.81443298969072,7,3,4,42.857142857142854,13.716783259863236,6,1,5,16.666666666666664,8,1,12,6,9,4,18,Rayo Vallecano,28,Spain - La Liga
19,Aleix Vidal Parreu,451,386,65,85.58758314855875,36,25,11,69.44444444444444,292,275,17,94.17808219178082,19,9,10,47.368421052631575,16.123091703161506,12,1,11,8.333333333333332,3,1,6,2,1,0,6,Barcelona,9,Spain - La Liga
20,Alejandro Arribas Garrido,1144,841,303,73.51398601398601,148,49,99,33.108108108108105,528,498,30,94.31818181818183,196,48,148,24.489795918367346,23.136669260733775,1,0,1,0.0,4,0,12,7,1,0,36,RC Deportivo La Coruña,31,Spain - La Liga
21,Alejandro Barrera García,35,24,11,68.57142857142857,3,2,1,66.66666666666666,19,16,3,84.21052631578947,1,0,1,0.0,14.288836544516572,0,0,0,0.0,0,0,1,1,1,1,0,Sporting Gijón,5,Spain - La Liga
22,Alejandro Bergantiños García,876,687,189,78.42465753424658,153,97,56,63.39869281045751,481,439,42,91.26819126819127,66,33,33,50.0,16.958876743136713,2,0,2,0.0,20,0,10,7,3,3,11,RC Deportivo La Coruña,22,Spain - La Liga
23,Alejandro Menéndez Díez,392,239,153,60.96938775510205,43,16,27,37.2093023255814,179,147,32,82.12290502793296,80,15,65,18.75,20.335262222382244,32,7,25,21.875,12,1,31,15,17,6,5,Sporting Gijón,21,Spain - La Liga
24,Aleksandar Pantić,530,338,192,63.77358490566037,82,28,54,34.146341463414636,186,163,23,87.63440860215054,107,30,77,28.037383177570092,23.113933218224147,0,0,0,0.0,1,0,3,2,1,1,1,Eibar,20,Spain - La Liga
25,Alen Halilović,885,673,212,76.045197740113,134,99,35,73.88059701492537,559,469,90,83.89982110912342,116,66,50,56.896551724137936,18.1921612291021,34,16,18,47.05882352941176,23,5,131,71,63,28,59,Sporting Gijón,36,Spain - La Liga
26,Alexis Ruano Delgado,550,435,115,79.0909090909091,63,26,37,41.269841269841265,278,264,14,94.96402877697841,111,52,59,46.846846846846844,23.797333871217162,2,0,2,0.0,6,0,8,5,1,0,8,Getafe,15,Spain - La Liga
27,Alfonso Pedraza Sag,23,14,9,60.86956521739131,0,0,0,0.0,13,10,3,76.92307692307693,1,0,1,0.0,13.076439669422609,1,0,1,0.0,1,0,5,3,3,1,1,Villarreal,2,Spain - La Liga
28,Alfred John Momar N''Diaye,1190,945,245,79.41176470588235,123,71,52,57.72357723577236,727,663,64,91.19669876203577,88,37,51,42.04545454545455,17.866563164098487,8,2,6,25.0,3,0,45,26,7,2,34,Real Betis,34,Spain - La Liga
29,Alhassane Bangoura,313,201,112,64.21725239616613,17,11,6,64.70588235294117,183,143,40,78.14207650273224,30,9,21,30.0,15.64036673774032,50,13,37,26.0,14,1,63,31,36,17,14,Rayo Vallecano,16,Spain - La Liga
30,Alphonse Areola,861,481,380,55.86527293844367,86,22,64,25.581395348837212,179,178,1,99.4413407821229,591,220,371,37.22504230118444,46.5510002331763,0,0,0,0.0,0,0,1,1,0,0,8,Villarreal,32,Spain - La Liga
31,Anaitz Arbilla Zabala,421,329,92,78.14726840855107,57,30,27,52.63157894736842,231,200,31,86.58008658008657,52,23,29,44.230769230769226,17.848532746129596,7,2,5,28.57142857142857,7,0,10,6,2,1,8,Espanyol,7,Spain - La Liga
32,Ander Capa Rodríguez,1818,1137,681,62.541254125412536,337,149,188,44.21364985163205,690,561,129,81.30434782608695,352,99,253,28.125,19.96805353311295,77,21,56,27.27272727272727,16,4,59,34,27,17,32,Eibar,36,Spain - La Liga
33,Ander Gayoso Reina,6,4,2,66.66666666666666,1,0,1,0.0,2,2,0,100.0,2,0,2,0.0,24.9620618868,0,0,0,0.0,0,0,0,0,0,0,1,Eibar,1,Spain - La Liga
34,Ander Iturraspe Derteano,417,333,84,79.85611510791367,65,37,28,56.92307692307692,216,207,9,95.83333333333334,51,23,28,45.09803921568628,18.379620642241726,6,2,4,33.33333333333333,3,1,5,2,1,0,8,Athletic Club,16,Spain - La Liga
35,Andreu Fontàs Prat,468,418,50,89.31623931623932,57,38,19,66.66666666666666,316,305,11,96.51898734177216,42,15,27,35.714285714285715,20.274274586673847,0,0,0,0.0,3,0,0,0,0,0,2,Celta Vigo,7,Spain - La Liga
36,André Filipe Tavares Gomes,1342,1081,261,80.55141579731743,211,138,73,65.40284360189574,901,789,112,87.56936736958934,99,59,40,59.59595959595959,17.213626403933045,21,8,13,38.095238095238095,23,3,113,69,51,25,55,Valencia,30,Spain - La Liga
37,Andrés Eduardo Fernández Moreno,1136,644,492,56.690140845070424,133,30,103,22.55639097744361,251,248,3,98.80478087649402,784,304,480,38.775510204081634,45.70360547246936,0,0,0,0.0,2,0,2,1,0,0,9,Granada,37,Spain - La Liga
38,Andrés Iniesta Luján,1877,1641,236,87.42674480554075,297,252,45,84.84848484848484,1278,1195,83,93.5054773082942,172,118,54,68.6046511627907,18.267553767012338,25,7,18,28.000000000000004,31,2,80,54,28,14,54,Barcelona,28,Spain - La Liga
39,Andrés Pascual Santoja,6,5,1,83.33333333333334,0,0,0,0.0,5,4,1,80.0,0,0,0,0.0,10.412326216199999,0,0,0,0.0,0,0,2,1,0,0,2,Valencia,1,Spain - La Liga
40,Antoine Griezmann,1394,1093,301,78.40746054519369,150,104,46,69.33333333333334,906,776,130,85.65121412803532,68,44,24,64.70588235294117,14.162523141329096,37,15,22,40.54054054054054,49,5,82,46,37,17,45,Atlético Madrid,38,Spain - La Liga
41,Antolín Alcáraz Viveros,262,188,74,71.7557251908397,36,10,26,27.77777777777778,117,111,6,94.87179487179486,50,15,35,30.0,21.969212951511754,3,1,2,33.33333333333333,2,0,2,2,0,0,3,Las Palmas,6,Spain - La Liga
42,Antonio Adán Garrido,1144,496,648,43.35664335664335,239,52,187,21.75732217573222,157,157,0,100.0,888,256,632,28.82882882882883,50.868717983714895,0,0,0,0.0,2,0,1,1,0,0,3,Real Betis,36,Spain - La Liga
43,Antonio Amaya Carazo,515,389,126,75.53398058252428,44,15,29,34.090909090909086,267,249,18,93.25842696629213,68,26,42,38.23529411764706,21.138886535950135,1,0,1,0.0,0,0,6,5,0,0,6,Rayo Vallecano,17,Spain - La Liga
44,Antonio Barragán Fernández,1031,800,231,77.59456838021337,116,76,40,65.51724137931035,508,464,44,91.33858267716536,99,33,66,33.33333333333333,18.058323016513743,41,8,33,19.51219512195122,8,0,24,10,9,2,23,Valencia,24,Spain - La Liga
45,Antonio García Aranda,1356,981,375,72.34513274336283,145,72,73,49.6551724137931,582,507,75,87.11340206185567,172,60,112,34.883720930232556,17.529912968014777,92,20,72,21.73913043478261,21,2,63,35,27,15,46,Levante UD,27,Spain - La Liga
46,Antonio Jesús Cotán Pérez,50,42,8,84.0,5,2,3,40.0,30,28,2,93.33333333333333,9,5,4,55.55555555555556,23.268398982235198,0,0,0,0.0,1,0,3,2,0,0,2,Sevilla,1,Spain - La Liga
47,Antonio José Raillo Arenas,113,86,27,76.10619469026548,10,3,7,30.0,59,57,2,96.61016949152543,12,4,8,33.33333333333333,21.389981752353982,0,0,0,0.0,1,0,0,0,0,0,3,Espanyol,4,Spain - La Liga
48,Antonio Manuel Luna Rodríguez,524,374,150,71.37404580152672,72,41,31,56.94444444444444,223,190,33,85.20179372197309,64,29,35,45.3125,18.906744708252823,21,6,15,28.57142857142857,4,1,11,8,2,1,8,Eibar,15,Spain - La Liga
49,Antonio Rodríguez Martínez,331,242,89,73.1117824773414,27,10,17,37.03703703703704,110,107,3,97.27272727272728,149,68,81,45.63758389261745,37.52988028716834,0,0,0,0.0,0,0,0,0,0,0,3,Rayo Vallecano,10,Spain - La Liga
50,Antonio Rukavina,645,501,144,77.67441860465117,59,32,27,54.23728813559322,317,285,32,89.90536277602523,67,24,43,35.82089552238806,17.559027020413506,12,0,12,0.0,3,0,10,5,5,1,7,Villarreal,18,Spain - La Liga
51,António Alberto Bastos Pimparel,121,87,34,71.900826446281,11,3,8,27.27272727272727,38,38,0,100.0,65,31,34,47.69230769230769,41.379910434059504,0,0,0,0.0,0,0,0,0,0,0,2,Sevilla,4,Spain - La Liga
52,Aras Özbiliz,35,20,15,57.14285714285714,4,2,2,50.0,19,17,2,89.47368421052632,7,0,7,0.0,18.880693422397712,4,1,3,25.0,2,1,2,1,2,1,2,Rayo Vallecano,3,Spain - La Liga
53,Arda Turan,624,573,51,91.82692307692307,53,45,8,84.90566037735849,481,459,22,95.42619542619542,19,16,3,84.21052631578947,13.897887521523462,7,4,3,57.14285714285714,6,3,29,22,11,6,21,Barcelona,18,Spain - La Liga
54,Aritz Aduriz Zubeldia,759,476,283,62.71409749670619,113,50,63,44.24778761061947,377,292,85,77.45358090185677,15,5,10,33.33333333333333,13.484222660830671,18,6,12,33.33333333333333,26,6,64,25,47,17,69,Athletic Club,34,Spain - La Liga
55,Aritz Elustondo Irribaria,1469,1103,366,75.08509189925118,166,84,82,50.602409638554214,727,679,48,93.39752407152683,163,49,114,30.061349693251532,18.713531592207325,57,16,41,28.07017543859649,12,0,38,20,16,7,30,Real Sociedad,31,Spain - La Liga
56,Armindo Tué Na Bangna,679,513,166,75.55228276877762,38,18,20,47.368421052631575,519,441,78,84.97109826589595,30,8,22,26.666666666666668,13.678996067668098,52,17,35,32.69230769230769,22,1,99,63,68,44,27,Real Sociedad,32,Spain - La Liga
57,Arnaldo Antonio Sanabria Ayala,624,453,171,72.59615384615384,68,23,45,33.82352941176471,402,336,66,83.5820895522388,18,7,11,38.88888888888889,13.932557526087693,10,3,7,30.0,12,1,55,28,24,11,43,Sporting Gijón,29,Spain - La Liga
58,Arthur Etienne Boka,666,505,161,75.82582582582582,92,51,41,55.434782608695656,302,262,40,86.75496688741721,67,26,41,38.80597014925373,17.028340089707026,22,5,17,22.727272727272727,5,0,29,13,14,4,19,Málaga,14,Spain - La Liga
59,Asier Illarramendi Andonegi,1838,1444,394,78.56365614798693,278,182,96,65.46762589928058,1101,1021,80,92.7338782924614,220,106,114,48.18181818181818,19.185864277953428,29,6,23,20.689655172413794,27,1,40,29,15,12,71,Real Sociedad,33,Spain - La Liga
60,Asier Riesgo Unamuno,1066,506,560,47.467166979362105,188,59,129,31.382978723404253,70,69,1,98.57142857142858,910,361,549,39.67032967032967,52.42591567830056,0,0,0,0.0,1,0,0,0,0,0,10,Eibar,34,Spain - La Liga
61,Augusto Matías Fernández,1480,1305,175,88.17567567567568,141,95,46,67.37588652482269,1102,1036,66,94.01088929219601,78,38,40,48.717948717948715,17.580956814709783,3,2,1,66.66666666666666,6,1,32,22,4,4,27,Atlético Madrid,28,Spain - La Liga
62,Aymen Abdennour,894,736,158,82.32662192393735,61,26,35,42.62295081967213,526,508,18,96.57794676806084,112,39,73,34.82142857142857,21.60708707528295,0,0,0,0.0,3,0,11,11,0,0,14,Valencia,22,Spain - La Liga
63,Aymeric Laporte,1337,1093,244,81.75018698578907,169,93,76,55.02958579881657,718,682,36,94.98607242339833,195,89,106,45.64102564102564,22.472465025535378,7,1,6,14.285714285714285,5,1,19,11,1,0,27,Athletic Club,26,Spain - La Liga
64,Aythami Artiles Oliva,1616,1344,272,83.16831683168317,135,72,63,53.333333333333336,928,897,31,96.65948275862068,204,83,121,40.68627450980392,21.64411006732292,1,1,0,100.0,4,1,6,3,2,1,17,Las Palmas,31,Spain - La Liga
65,Benoît Trémoulinas,1185,867,318,73.16455696202532,139,76,63,54.67625899280576,563,503,60,89.34280639431617,149,50,99,33.557046979865774,18.309409441097014,78,20,58,25.64102564102564,16,3,31,13,18,6,30,Sevilla,24,Spain - La Liga
66,Bernard Mensah,42,38,4,90.47619047619048,7,5,2,71.42857142857143,28,26,2,92.85714285714286,3,2,1,66.66666666666666,19.057616124685712,1,0,1,0.0,0,0,6,4,2,2,2,Getafe,8,Spain - La Liga
67,Bernardo José Espinosa Zúñiga,558,396,162,70.96774193548387,68,24,44,35.294117647058826,218,208,10,95.41284403669725,120,40,80,33.33333333333333,23.34010567641032,0,0,0,0.0,4,0,1,1,0,0,12,Sporting Gijón,16,Spain - La Liga
68,Beñat Etxebarria Urkiaga,2157,1628,529,75.47519703291609,394,252,142,63.95939086294417,1147,1056,91,92.0662598081953,470,206,264,43.829787234042556,21.60777911606587,60,15,45,25.0,59,4,47,27,12,8,69,Athletic Club,36,Spain - La Liga
69,Bojan Jokić,67,49,18,73.13432835820896,16,7,9,43.75,32,30,2,93.75,12,2,10,16.666666666666664,20.435621133460298,2,0,2,0.0,0,0,0,0,0,0,1,Villarreal,2,Spain - La Liga
70,Borja Ekiza Imaz,98,52,46,53.06122448979592,20,8,12,40.0,21,15,6,71.42857142857143,15,4,11,26.666666666666668,20.118283733431838,3,0,3,0.0,0,0,1,1,0,0,1,Eibar,4,Spain - La Liga
71,Borja Fernández Fernández,62,46,16,74.19354838709677,5,1,4,20.0,30,29,1,96.66666666666667,8,2,6,25.0,19.445995003726452,0,0,0,0.0,1,0,2,1,1,0,0,Celta Vigo,4,Spain - La Liga
72,Borja González Tomás,647,449,198,69.39721792890263,58,23,35,39.6551724137931,393,326,67,82.95165394402035,14,6,8,42.857142857142854,12.815917423987328,14,3,11,21.428571428571427,16,3,26,15,12,4,35,Eibar,36,Spain - La Liga
73,Borja Mayoral Moya,84,68,16,80.95238095238095,3,3,0,100.0,71,61,10,85.91549295774648,0,0,0,0.0,10.765776219411428,3,1,2,33.33333333333333,1,0,8,6,5,3,3,Real Madrid,6,Spain - La Liga
74,Borja Viguera Manzanares,95,68,27,71.57894736842105,10,5,5,50.0,46,41,5,89.13043478260869,3,2,1,66.66666666666666,13.90702537317221,4,0,4,0.0,2,0,8,3,8,3,4,Athletic Club,9,Spain - La Liga
75,Bruno González Cabrera,1070,847,223,79.1588785046729,79,25,54,31.645569620253166,544,524,20,96.32352941176471,132,33,99,25.0,22.686013490719628,0,0,0,0.0,0,0,15,12,3,3,15,Real Betis,32,Spain - La Liga
76,Bruno Soriano Llido,1728,1455,273,84.20138888888889,259,176,83,67.95366795366795,1146,1064,82,92.84467713787086,107,57,50,53.271028037383175,18.177941439690418,5,2,3,40.0,13,1,27,20,6,4,25,Villarreal,31,Spain - La Liga
77,Carl Medjani,511,393,118,76.90802348336595,80,30,50,37.5,267,251,16,94.00749063670412,96,36,60,37.5,23.88364053336,1,0,1,0.0,3,0,3,2,0,0,8,Levante UD,14,Spain - La Liga
78,Carles Planas Antolínez,1157,895,262,77.35522904062229,142,87,55,61.267605633802816,625,585,40,93.60000000000001,130,35,95,26.923076923076923,18.73607906927668,28,7,21,25.0,6,2,8,5,4,2,10,Celta Vigo,24,Spain - La Liga
79,Carlos Alberto Vela Garrido,1174,862,312,73.42419080068143,130,78,52,60.0,715,618,97,86.43356643356643,144,56,88,38.88888888888889,16.935289842346712,71,20,51,28.169014084507044,48,4,121,59,60,29,98,Real Sociedad,35,Spain - La Liga
80,Carlos Carbonell Gil,2,1,1,50.0,0,0,0,0.0,1,1,0,100.0,0,0,0,0.0,13.238834533199999,0,0,0,0.0,0,0,1,0,0,0,0,Valencia,1,Spain - La Liga
81,Carlos Carmona Bonet,576,394,182,68.40277777777779,82,41,41,50.0,344,286,58,83.13953488372093,53,18,35,33.9622641509434,16.228964023941252,38,10,28,26.31578947368421,19,3,42,20,15,8,21,Sporting Gijón,20,Spain - La Liga
82,Carlos Castro García,203,159,44,78.32512315270937,12,5,7,41.66666666666667,151,129,22,85.43046357615894,4,1,3,25.0,11.517509734478425,2,1,1,50.0,4,0,22,10,10,4,24,Sporting Gijón,25,Spain - La Liga
83,Carlos Fernández Luna,9,8,1,88.88888888888889,1,0,1,0.0,7,7,0,100.0,0,0,0,0.0,10.061903828399998,0,0,0,0.0,1,0,0,0,0,0,1,Sevilla,1,Spain - La Liga
84,Carlos Gurpegi Nausia,544,433,111,79.59558823529412,57,25,32,43.859649122807014,260,252,8,96.92307692307692,70,21,49,30.0,21.13693125618375,3,1,2,33.33333333333333,2,0,2,2,0,0,12,Athletic Club,15,Spain - La Liga
85,Carlos Henrique Casimiro,1056,917,139,86.83712121212122,137,89,48,64.96350364963503,646,614,32,95.04643962848297,147,99,48,67.3469387755102,20.533804773627274,2,1,1,50.0,5,2,12,9,4,3,44,Real Madrid,23,Spain - La Liga
86,Carlos Martín Vigaray,507,383,124,75.54240631163708,72,39,33,54.166666666666664,243,220,23,90.53497942386831,64,21,43,32.8125,18.760102675856096,14,2,12,14.285714285714285,7,0,23,12,8,2,10,Getafe,14,Spain - La Liga
87,Carlos Martínez Díez,353,274,79,77.62039660056658,39,25,14,64.1025641025641,182,168,14,92.3076923076923,36,14,22,38.88888888888889,17.00852456076782,17,5,12,29.411764705882355,5,1,12,8,5,2,7,Real Sociedad,9,Spain - La Liga
88,Celso Borges Mora,972,787,185,80.96707818930041,148,90,58,60.810810810810814,532,499,33,93.796992481203,76,39,37,51.31578947368421,16.50577478855185,6,2,4,33.33333333333333,19,2,18,15,6,6,21,RC Deportivo La Coruña,24,Spain - La Liga
89,Charles Días Barbosa de Oliveira,873,620,253,71.01947308132875,86,37,49,43.02325581395349,458,401,57,87.55458515283843,25,12,13,48.0,13.075951851809483,17,5,12,29.411764705882355,31,3,26,15,17,9,50,Málaga,35,Spain - La Liga
90,Charly Musonda Junior,394,284,110,72.08121827411168,38,24,14,63.1578947368421,263,220,43,83.65019011406845,38,10,28,26.31578947368421,15.76206030280203,31,5,26,16.129032258064516,11,1,90,52,51,33,57,Real Betis,16,Spain - La Liga
91,Chengdong Zhang,3,2,1,66.66666666666666,0,0,0,0.0,0,0,0,0.0,0,0,0,0.0,19.694260941599996,1,0,1,0.0,0,0,0,0,0,0,0,Rayo Vallecano,1,Spain - La Liga
92,Christian Atsu Twasam,143,112,31,78.32167832167832,12,9,3,75.0,107,89,18,83.17757009345794,9,6,3,66.66666666666666,14.119911507363357,9,2,7,22.22222222222222,6,0,23,13,16,9,10,Málaga,11,Spain - La Liga
93,Ciro Immobile,63,41,22,65.07936507936508,4,1,3,25.0,42,31,11,73.80952380952381,3,2,1,66.66666666666666,13.692514493794285,6,0,6,0.0,1,0,5,2,2,0,5,Sevilla,8,Spain - La Liga
94,Claudio Andrés Bravo Muñoz,1004,848,156,84.4621513944223,38,10,28,26.31578947368421,573,570,3,99.47643979057592,247,107,140,43.31983805668016,28.53604019417307,0,0,0,0.0,0,0,1,1,0,0,1,Barcelona,32,Spain - La Liga
95,Claudio Beauvue,134,85,49,63.43283582089553,17,8,9,47.05882352941176,70,55,15,78.57142857142857,12,4,8,33.33333333333333,15.588869741376717,11,3,8,27.27272727272727,5,0,17,10,7,4,7,Celta Vigo,10,Spain - La Liga
96,Claudio Matías Kranevitter,133,100,33,75.18796992481202,13,6,7,46.15384615384615,80,70,10,87.5,14,4,10,28.57142857142857,19.095339896753686,1,0,1,0.0,0,0,3,3,0,0,3,Atlético Madrid,8,Spain - La Liga
97,Cristiano Biraghi,1372,939,433,68.4402332361516,179,83,96,46.36871508379888,483,429,54,88.81987577639751,242,85,157,35.12396694214876,20.136680495046996,67,16,51,23.88059701492537,15,1,24,12,16,8,16,Granada,32,Spain - La Liga
98,Cristiano Piccini,843,641,202,76.0379596678529,104,58,46,55.769230769230774,415,365,50,87.95180722891565,69,23,46,33.33333333333333,16.55772552094292,34,13,21,38.23529411764706,13,0,49,26,29,14,13,Real Betis,16,Spain - La Liga
99,Cristiano Ronaldo dos Santos Aveiro,1146,878,268,76.61431064572426,82,55,27,67.07317073170732,881,740,141,83.99545970488082,28,12,16,42.857142857142854,12.818792624585088,58,21,37,36.206896551724135,34,10,95,54,69,36,48,Real Madrid,36,Spain - La Liga
100,Cédric Bakambu,515,367,148,71.26213592233009,36,20,16,55.55555555555556,337,270,67,80.1186943620178,15,4,11,26.666666666666668,12.971806578212785,23,5,18,21.73913043478261,13,3,44,25,14,9,36,Villarreal,34,Spain - La Liga
101,Damián Nicolás Suárez Suárez,1684,1279,405,75.95011876484561,293,182,111,62.116040955631405,755,663,92,87.81456953642383,215,88,127,40.93023255813954,18.335962258633455,37,13,24,35.13513513513514,25,3,51,19,20,7,35,Getafe,31,Spain - La Liga
102,Dani Castellano Betancor,1383,1110,273,80.26030368763557,130,81,49,62.30769230769231,803,733,70,91.2826899128269,81,37,44,45.67901234567901,15.884379237521387,26,7,19,26.923076923076923,11,0,58,40,18,7,50,Las Palmas,27,Spain - La Liga
103,Daniel Alves da Silva,1971,1682,289,85.33739218670725,172,143,29,83.13953488372093,1211,1129,82,93.22873658133773,169,111,58,65.68047337278107,15.736490976865387,86,26,60,30.23255813953488,18,4,51,26,18,5,24,Barcelona,29,Spain - La Liga
104,Daniel Arnaud N''Di	,227,153,74,67.40088105726872,35,17,18,48.57142857142857,152,133,19,87.5,14,2,12,14.285714285714285,15.409988057145727,12,1,11,8.333333333333332,7,0,26,17,9,6,42,Sporting Gijón,15,Spain - La Liga
105,Daniel Carvajal Ramos,1228,1065,163,86.72638436482086,82,67,15,81.70731707317073,798,752,46,94.23558897243107,84,48,36,57.14285714285714,16.221732270769643,58,30,28,51.724137931034484,28,4,43,21,23,9,29,Real Madrid,22,Spain - La Liga
106,Daniel Ceballos Fernández,1245,995,250,79.91967871485943,191,136,55,71.20418848167539,844,746,98,88.38862559241706,81,46,35,56.79012345679012,15.850156692742555,16,7,9,43.75,21,2,108,59,49,24,96,Real Betis,34,Spain - La Liga
107,Daniel Filipe Martins Carriço,499,408,91,81.76352705410822,43,20,23,46.51162790697674,290,280,10,96.55172413793103,67,29,38,43.28358208955223,21.861224284608575,1,0,1,0.0,0,1,5,3,1,1,9,Sevilla,14,Spain - La Liga
108,Daniel García Carrillo,1761,1323,438,75.12776831345826,343,181,162,52.76967930029155,756,685,71,90.60846560846561,314,145,169,46.17834394904459,22.573425446368518,11,3,8,27.27272727272727,14,0,29,18,2,0,50,Eibar,35,Spain - La Liga
109,Daniel Giménez Hernández,86,47,39,54.65116279069767,16,6,10,37.5,18,18,0,100.0,55,16,39,29.09090909090909,47.11689770533953,0,0,0,0.0,0,0,0,0,0,0,0,Real Betis,3,Spain - La Liga
110,Daniel Parejo Muñoz,1885,1537,348,81.53846153846153,261,194,67,74.32950191570882,1188,1088,100,91.58249158249158,225,113,112,50.22222222222222,19.148564164874685,31,14,17,45.16129032258064,35,5,63,36,13,4,91,Valencia,33,Spain - La Liga
111,Daniel Wass,1665,1300,365,78.07807807807808,263,173,90,65.77946768060836,1049,946,103,90.1811248808389,189,82,107,43.386243386243386,19.04695132735308,32,9,23,28.125,34,5,34,22,16,9,47,Celta Vigo,36,Spain - La Liga
112,Daniele Bonera,504,432,72,85.71428571428571,62,33,29,53.2258064516129,289,280,9,96.88581314878893,67,31,36,46.26865671641791,23.207565019335714,0,0,0,0.0,1,0,1,1,0,0,7,Villarreal,14,Spain - La Liga
113,Danilo Barbosa da Silva,502,377,125,75.0996015936255,72,41,31,56.94444444444444,311,268,43,86.17363344051448,37,21,16,56.75675675675676,17.81730241227251,1,0,1,0.0,7,0,44,26,18,9,48,Valencia,19,Spain - La Liga
114,Danilo Luiz da Silva,1491,1260,231,84.50704225352112,130,89,41,68.46153846153847,969,902,67,93.08565531475749,102,34,68,33.33333333333333,16.588913451867523,57,15,42,26.31578947368421,12,5,24,16,14,7,24,Real Madrid,24,Spain - La Liga
115,David Barral Torres,110,87,23,79.0909090909091,6,4,2,66.66666666666666,60,56,4,93.33333333333333,6,2,4,33.33333333333333,14.234331906091636,7,0,7,0.0,2,0,7,3,4,2,13,Granada,14,Spain - La Liga
116,David Carmona Sierra,36,20,16,55.55555555555556,4,2,2,50.0,18,12,6,66.66666666666666,6,0,6,0.0,21.0153729806,2,0,2,0.0,0,0,1,0,0,0,0,Sevilla,1,Spain - La Liga
117,David García Santana,981,781,200,79.61264016309887,101,48,53,47.524752475247524,516,479,37,92.82945736434108,111,35,76,31.53153153153153,19.86201949192881,8,5,3,62.5,7,1,6,3,0,0,17,Las Palmas,19,Spain - La Liga
118,David Goldar Gómez,30,12,18,40.0,9,1,8,11.11111111111111,7,7,0,100.0,13,3,10,23.076923076923077,32.14694358,0,0,0,0.0,0,0,0,0,0,0,2,Celta Vigo,1,Spain - La Liga
119,David Juncà Reñé,1281,859,422,67.05698672911787,224,104,120,46.42857142857143,513,432,81,84.21052631578947,211,64,147,30.33175355450237,20.521630876798877,73,22,51,30.136986301369863,16,4,44,24,20,8,37,Eibar,31,Spain - La Liga
120,David Navarro Pedrós,681,550,131,80.76358296622614,96,47,49,48.95833333333333,337,332,5,98.51632047477746,116,45,71,38.793103448275865,23.290595141668017,0,0,0,0.0,0,0,7,5,0,0,10,Levante UD,20,Spain - La Liga
121,David Rodríguez Lombán,983,774,209,78.73855544252288,109,45,64,41.284403669724774,436,417,19,95.64220183486239,198,89,109,44.94949494949495,24.78869973959658,3,0,3,0.0,2,0,3,3,0,0,9,Granada,30,Spain - La Liga
122,David Simón Rodríguez Santana,1411,1107,304,78.4549964564139,111,67,44,60.36036036036037,781,703,78,90.01280409731113,104,45,59,43.269230769230774,16.051941661799912,48,15,33,31.25,19,2,46,20,25,8,25,Las Palmas,27,Spain - La Liga
123,David Zurutuza Veillet,583,451,132,77.35849056603774,72,48,24,66.66666666666666,361,325,36,90.02770083102493,36,13,23,36.11111111111111,14.904162622382572,18,5,13,27.77777777777778,10,3,43,22,22,12,37,Real Sociedad,16,Spain - La Liga
124,Dejan Dražić,25,20,5,80.0,2,1,1,50.0,19,18,1,94.73684210526315,2,1,1,50.0,11.640498665615999,0,0,0,0.0,0,0,6,3,4,1,1,Celta Vigo,6,Spain - La Liga
125,Denis Cheryshev,232,158,74,68.10344827586206,26,15,11,57.692307692307686,148,123,25,83.1081081081081,12,2,10,16.666666666666664,15.443415438464482,10,2,8,20.0,3,1,19,11,7,4,15,Valencia,9,Spain - La Liga
126,Denis Suárez Fernández,1114,756,358,67.86355475763017,120,67,53,55.833333333333336,692,556,136,80.34682080924856,116,44,72,37.93103448275862,16.992172460104417,60,19,41,31.666666666666664,41,4,101,50,63,31,48,Villarreal,33,Spain - La Liga
127,Deyverson Brum Silva Acosta,640,360,280,56.25,106,29,77,27.358490566037734,231,187,44,80.95238095238095,36,12,24,33.33333333333333,14.5324157508711,20,7,13,35.0,20,1,43,17,21,7,76,Levante UD,33,Spain - La Liga
128,Didier Digard,165,123,42,74.54545454545455,31,9,22,29.03225806451613,93,84,9,90.32258064516128,21,4,17,19.047619047619047,20.07878368976727,0,0,0,0.0,0,0,5,2,0,0,5,Real Betis,8,Spain - La Liga
129,Diego Alende López,6,6,0,100.0,0,0,0,0.0,6,6,0,100.0,0,0,0,0.0,16.9418634492,0,0,0,0.0,0,0,0,0,0,0,0,Celta Vigo,1,Spain - La Liga
130,Diego Alves Carreira,400,261,139,65.25,32,8,24,25.0,98,98,0,100.0,257,123,134,47.85992217898833,42.933073263298205,0,0,0,0.0,0,0,1,1,0,0,0,Valencia,13,Spain - La Liga
131,Diego Antonio Reyes Rosales,1079,885,194,82.02038924930491,111,67,44,60.36036036036037,586,561,25,95.73378839590444,132,67,65,50.75757575757576,21.72805074569327,5,4,1,80.0,5,0,18,15,2,1,16,Real Sociedad,27,Spain - La Liga
132,Diego González Polanco,48,43,5,89.58333333333334,4,2,2,50.0,31,31,0,100.0,6,2,4,33.33333333333333,22.3999239072,0,0,0,0.0,0,0,0,0,0,0,1,Sevilla,2,Spain - La Liga
133,Diego Javier Llorente Ríos,1474,1206,268,81.81818181818183,173,98,75,56.64739884393064,846,795,51,93.97163120567376,170,70,100,41.17647058823529,21.05380733130464,6,2,4,33.33333333333333,7,1,40,29,4,3,34,Rayo Vallecano,33,Spain - La Liga
134,Diego Mainz García,132,104,28,78.78787878787878,18,6,12,33.33333333333333,66,65,1,98.48484848484848,23,6,17,26.08695652173913,22.848550674987273,0,0,0,0.0,0,0,0,0,0,0,5,Granada,5,Spain - La Liga
135,Diego Mariño Villar,829,580,249,69.96381182147165,60,24,36,40.0,262,261,1,99.61832061068702,451,212,239,47.006651884700666,40.4597444143171,0,0,0,0.0,2,0,1,1,0,0,6,Levante UD,23,Spain - La Liga
136,Diego Roberto Godín Leal,1152,912,240,79.16666666666666,113,52,61,46.017699115044245,629,603,26,95.86645468998411,142,54,88,38.028169014084504,20.46326195582375,0,0,0,0.0,2,1,14,9,1,0,33,Atlético Madrid,31,Spain - La Liga
137,Dimitri Foulquier,698,534,164,76.50429799426934,76,44,32,57.89473684210527,320,280,40,87.5,43,13,30,30.23255813953488,15.657837455562293,20,7,13,35.0,10,1,41,19,23,8,11,Granada,21,Spain - La Liga
138,Diogo José Rosário Gomes Figueiras,130,91,39,70.0,10,5,5,50.0,63,53,10,84.12698412698413,18,8,10,44.44444444444444,16.909182875730462,11,4,7,36.36363636363637,3,0,7,5,3,3,6,Sevilla,4,Spain - La Liga
139,Douglas Pereira dos Santos,3,2,1,66.66666666666666,0,0,0,0.0,2,1,1,50.0,0,0,0,0.0,11.7992150604,0,0,0,0.0,0,0,0,0,0,0,1,Barcelona,1,Spain - La Liga
140,Duje Čop,690,467,223,67.68115942028986,62,24,38,38.70967741935484,400,310,90,77.5,34,15,19,44.11764705882353,12.733470777996521,24,10,14,41.66666666666667,15,3,48,16,24,7,24,Málaga,31,Spain - La Liga
141,Eddy Silvestre Pascual İsrafilov,79,54,25,68.35443037974683,13,5,8,38.46153846153847,41,34,7,82.92682926829268,3,1,2,33.33333333333333,16.909001958832405,0,0,0,0.0,1,0,0,0,0,0,7,Eibar,6,Spain - La Liga
142,Edgar Antonio Méndez Ortega,236,151,85,63.983050847457626,30,12,18,40.0,115,98,17,85.21739130434783,35,8,27,22.857142857142858,18.666493820487457,20,5,15,25.0,5,0,15,7,10,4,13,Granada,15,Spain - La Liga
143,Egor Filipenko,179,132,47,73.74301675977654,29,16,13,55.172413793103445,87,76,11,87.35632183908046,29,12,17,41.37931034482759,21.109004038606926,0,0,0,0.0,0,0,0,0,0,0,5,Málaga,8,Spain - La Liga
144,Emiliano Buendía,366,302,64,82.5136612021858,44,32,12,72.72727272727273,235,211,24,89.7872340425532,24,12,12,50.0,16.882751139554756,7,2,5,28.57142857142857,5,0,18,9,6,4,20,Getafe,17,Spain - La Liga
145,Emiliano Daniel Velázquez Maldonado,384,254,130,66.14583333333334,74,24,50,32.432432432432435,165,156,9,94.54545454545455,94,23,71,24.46808510638298,24.691005712108126,1,1,0,100.0,3,1,9,6,1,0,3,Getafe,11,Spain - La Liga
146,Eneko Bóveda Altube,956,725,231,75.83682008368201,129,65,64,50.3875968992248,492,464,28,94.3089430894309,138,55,83,39.85507246376812,19.676692478910876,29,13,16,44.827586206896555,10,0,18,12,7,2,8,Athletic Club,23,Spain - La Liga
147,Eneko Capilla González,5,3,2,60.0,0,0,0,0.0,5,3,2,60.0,0,0,0,0.0,14.790950059392,0,0,0,0.0,0,0,1,1,1,1,0,Real Sociedad,1,Spain - La Liga
148,Enrique Sola Clemente,17,10,7,58.82352941176471,0,0,0,0.0,6,5,1,83.33333333333334,0,0,0,0.0,12.113781230710588,0,0,0,0.0,0,0,0,0,0,0,5,Athletic Club,5,Spain - La Liga
149,Enzo Nicolás Pérez,692,607,85,87.71676300578035,82,57,25,69.51219512195121,469,441,28,94.02985074626866,47,29,18,61.702127659574465,18.697343182906476,2,0,2,0.0,6,0,29,16,9,5,40,Valencia,20,Spain - La Liga
150,Enzo Pablo Roco Roco,984,792,192,80.48780487804879,98,41,57,41.83673469387755,461,442,19,95.87852494577007,170,72,98,42.35294117647059,24.11342484626795,6,1,5,16.666666666666664,2,0,8,6,1,0,10,Espanyol,33,Spain - La Liga
151,Eric Bertrand Bailly,838,650,188,77.56563245823389,75,34,41,45.33333333333333,461,418,43,90.67245119305856,97,39,58,40.20618556701031,20.71897648226377,0,0,0,0.0,3,0,14,11,4,2,28,Villarreal,25,Spain - La Liga
152,Esteban Félix Granero Molina,527,413,114,78.36812144212524,70,46,24,65.71428571428571,323,298,25,92.26006191950464,78,36,42,46.15384615384615,18.546799624890625,13,3,10,23.076923076923077,12,0,16,5,4,0,27,Real Sociedad,15,Spain - La Liga
153,Fabián Ariel Orellana Valenzuela,1651,1230,421,74.50030284675954,185,115,70,62.16216216216216,1058,901,157,85.16068052930056,138,64,74,46.3768115942029,17.419922890089232,69,14,55,20.28985507246377,45,7,209,109,98,50,100,Celta Vigo,34,Spain - La Liga
154,Fabián Ruiz Peña,236,189,47,80.08474576271186,21,13,8,61.904761904761905,172,155,17,90.11627906976744,7,6,1,85.71428571428571,12.570788865918813,3,2,1,66.66666666666666,5,1,14,6,9,3,3,Real Betis,12,Spain - La Liga
155,Fayçal Fajr,1638,1230,408,75.0915750915751,230,146,84,63.47826086956522,889,820,69,92.2384701912261,294,117,177,39.795918367346935,19.247339090341978,86,21,65,24.418604651162788,52,3,49,24,22,10,37,RC Deportivo La Coruña,38,Spain - La Liga
156,Federico Julián Fazio,119,83,36,69.74789915966386,21,10,11,47.61904761904761,50,49,1,98.0,34,16,18,47.05882352941176,26.816488151451427,0,0,0,0.0,1,0,2,2,0,0,1,Sevilla,4,Spain - La Liga
157,Federico Nicolás Cartabia,657,489,168,74.42922374429224,56,33,23,58.92857142857143,398,351,47,88.19095477386935,89,32,57,35.95505617977528,18.21356347481863,41,11,30,26.82926829268293,20,3,65,44,38,25,62,RC Deportivo La Coruña,26,Spain - La Liga
158,Federico Ricca Rostagnol,353,245,108,69.40509915014165,35,11,24,31.428571428571427,131,110,21,83.96946564885496,34,12,22,35.294117647058826,16.798195227059487,16,8,8,50.0,5,1,2,2,0,0,10,Málaga,8,Spain - La Liga
159,Felipe Salvador Caicedo Corozo,520,383,137,73.65384615384616,49,24,25,48.97959183673469,320,273,47,85.3125,13,4,9,30.76923076923077,12.667304681381076,10,2,8,20.0,14,0,67,38,35,15,40,Espanyol,31,Spain - La Liga
160,Fernando Damián Tissone,559,428,131,76.56529516994634,104,54,50,51.92307692307693,299,267,32,89.29765886287625,67,28,39,41.7910447761194,20.20750534862984,7,1,6,14.285714285714285,12,0,15,11,7,5,8,Málaga,12,Spain - La Liga
161,Fernando José Torres Sanz,389,255,134,65.55269922879178,31,15,16,48.38709677419355,225,177,48,78.66666666666666,3,2,1,66.66666666666666,11.380653235495526,9,3,6,33.33333333333333,14,2,72,32,50,22,42,Atlético Madrid,30,Spain - La Liga
162,Fernando Llorente Torres,389,250,139,64.26735218508998,36,12,24,33.33333333333333,146,118,28,80.82191780821918,10,5,5,50.0,12.621865146192924,8,4,4,50.0,14,3,20,10,17,8,8,Sevilla,23,Spain - La Liga
163,Fernando Navarro i Corbacho,1627,1212,415,74.49293177627536,266,149,117,56.015037593984964,772,710,62,91.96891191709845,189,61,128,32.27513227513227,19.14262280779796,34,6,28,17.647058823529413,10,2,32,20,12,7,41,RC Deportivo La Coruña,35,Spain - La Liga
164,Filipe Luís Kasmirski,2214,1753,461,79.17795844625113,261,184,77,70.49808429118774,1264,1148,116,90.82278481012658,191,59,132,30.89005235602094,15.800884941364552,88,17,71,19.318181818181817,25,4,129,74,64,35,46,Atlético Madrid,32,Spain - La Liga
165,Foued Kadir,287,215,72,74.91289198606272,20,14,6,70.0,188,167,21,88.82978723404256,25,10,15,40.0,15.026290429446691,20,4,16,20.0,7,0,18,13,8,6,8,Real Betis,8,Spain - La Liga
166,Francisco Alcácer García,480,349,131,72.70833333333333,43,19,24,44.18604651162791,298,246,52,82.5503355704698,18,7,11,38.88888888888889,13.89298979419725,10,1,9,10.0,24,5,27,11,14,5,24,Valencia,34,Spain - La Liga
167,Francisco Casilla Cortés,87,58,29,66.66666666666666,4,0,4,0.0,34,34,0,100.0,40,14,26,35.0,36.22622999718621,0,0,0,0.0,0,0,0,0,0,0,0,Real Madrid,4,Spain - La Liga
168,Francisco Guillermo Ochoa Magaña,294,167,127,56.80272108843537,49,7,42,14.285714285714285,63,63,0,100.0,199,74,125,37.185929648241206,45.88955128572245,0,0,0,0.0,0,0,0,0,0,0,0,Málaga,11,Spain - La Liga
169,Francisco Javier García Noblejas Hernanz,68,49,19,72.05882352941177,15,8,7,53.333333333333336,25,21,4,84.0,10,5,5,50.0,19.48925641458706,4,1,3,25.0,0,0,1,0,1,0,1,Getafe,1,Spain - La Liga
170,Francisco José Molinero Calderón,612,463,149,75.65359477124183,78,45,33,57.692307692307686,298,261,37,87.58389261744966,56,19,37,33.92857142857143,16.089424775321177,14,5,9,35.714285714285715,5,1,28,5,12,2,6,Real Betis,20,Spain - La Liga
171,Francisco José Perdomo Borges,124,91,33,73.38709677419355,8,4,4,50.0,84,75,9,89.28571428571429,8,2,6,25.0,15.434793940546452,9,1,8,11.11111111111111,6,0,16,10,7,5,3,Las Palmas,8,Spain - La Liga
172,Francisco José Sánchez Rodríguez,128,83,45,64.84375,17,8,9,47.05882352941176,70,63,7,90.0,6,1,5,16.666666666666664,15.53193286752375,5,1,4,20.0,3,1,10,3,2,0,7,Sevilla,4,Spain - La Liga
173,Francisco José Villalba Rodrigo,4,3,1,75.0,1,0,1,0.0,2,2,0,100.0,0,0,0,0.0,19.180335756599998,0,0,0,0.0,0,0,0,0,0,0,0,Valencia,1,Spain - La Liga
174,Francisco Manuel Rico Castro,896,690,206,77.00892857142857,138,86,52,62.31884057971014,481,431,50,89.6049896049896,130,68,62,52.307692307692314,18.929509010134552,23,9,14,39.130434782608695,32,0,18,11,5,4,22,Granada,28,Spain - La Liga
175,Francisco Medina Luna,306,176,130,57.51633986928104,61,21,40,34.42622950819672,157,125,32,79.61783439490446,69,20,49,28.985507246376812,20.01264262191765,14,3,11,21.428571428571427,12,2,26,20,13,10,12,Rayo Vallecano,16,Spain - La Liga
176,Francisco Miguel Varela Martín,542,395,147,72.87822878228782,76,43,33,56.57894736842105,239,218,21,91.21338912133892,89,26,63,29.213483146067414,18.89814463143011,23,8,15,34.78260869565217,9,0,8,3,4,1,4,Real Betis,14,Spain - La Liga
177,Francisco Montañés Claverías,84,56,28,66.66666666666666,5,2,3,40.0,54,44,10,81.48148148148148,7,1,6,14.285714285714285,14.930165141605714,5,1,4,20.0,2,0,10,5,5,4,10,Espanyol,7,Spain - La Liga
178,Francisco Portillo Soler,558,459,99,82.25806451612904,65,44,21,67.6923076923077,366,331,35,90.43715846994536,43,26,17,60.46511627906976,14.99511849692516,6,3,3,50.0,16,0,46,35,13,9,18,Real Betis,19,Spain - La Liga
179,Francisco Román Alarcón Suárez,1283,1095,188,85.34684333593141,118,90,28,76.27118644067797,990,920,70,92.92929292929293,84,50,34,59.523809523809526,15.403298412051443,57,24,33,42.10526315789473,35,7,137,87,68,41,61,Real Madrid,31,Spain - La Liga
180,Fábio Ricardo Gomes Fonseca,55,45,10,81.81818181818183,5,4,1,80.0,45,42,3,93.33333333333333,3,1,2,33.33333333333333,12.517241420866908,2,1,1,50.0,1,0,4,1,2,1,1,Málaga,2,Spain - La Liga
181,Gabriel Fernández Arenas,2224,1790,434,80.48561151079137,413,261,152,63.19612590799032,1393,1277,116,91.67264895908112,320,157,163,49.0625,18.454202374015683,25,8,17,32.0,21,2,45,28,12,9,48,Atlético Madrid,35,Spain - La Liga
182,Gareth Frank Bale,791,590,201,74.58912768647282,76,51,25,67.10526315789474,489,431,58,88.13905930470347,82,39,43,47.5609756097561,16.42831981193446,81,26,55,32.098765432098766,39,10,69,35,38,18,31,Real Madrid,23,Spain - La Liga
183,Gaël Kakuta,15,8,7,53.333333333333336,1,1,0,100.0,5,5,0,100.0,2,0,2,0.0,18.105395618447996,1,0,1,0.0,0,0,1,1,1,1,0,Sevilla,2,Spain - La Liga
184,Gerard Gumbau Garriga,20,17,3,85.0,2,2,0,100.0,13,12,1,92.3076923076923,1,0,1,0.0,20.33774660916,0,0,0,0.0,0,0,0,0,0,0,0,Barcelona,3,Spain - La Liga
185,Gerard Moreno Balaguero,665,474,191,71.2781954887218,66,34,32,51.515151515151516,379,309,70,81.53034300791556,37,22,15,59.45945945945946,15.407307666888903,20,8,12,40.0,13,3,103,57,66,31,26,Espanyol,32,Spain - La Liga
186,Gerard Piqué Bernabéu,2032,1863,169,91.68307086614173,193,149,44,77.2020725388601,1369,1350,19,98.61212563915267,174,97,77,55.74712643678161,20.995675229609997,3,1,2,33.33333333333333,4,1,11,10,2,2,12,Barcelona,30,Spain - La Liga
187,Germán Alejandro Pezzella,809,597,212,73.79480840543881,87,27,60,31.03448275862069,383,367,16,95.822454308094,140,41,99,29.28571428571429,22.747631625805884,3,2,1,66.66666666666666,0,1,2,2,0,0,14,Real Betis,25,Spain - La Liga
188,Germán Darío Lux,1024,539,485,52.63671875,160,42,118,26.25,125,125,0,100.0,768,301,467,39.19270833333333,50.88585438073406,0,0,0,0.0,1,0,1,1,0,0,7,RC Deportivo La Coruña,29,Spain - La Liga
189,Gerónimo Rulli,1250,776,474,62.08,177,43,134,24.293785310734464,330,330,0,100.0,749,291,458,38.851802403204275,44.04662966547533,1,0,1,0.0,1,0,2,2,0,0,6,Real Sociedad,36,Spain - La Liga
190,Giedrius Arlauskis,71,30,41,42.25352112676056,7,1,6,14.285714285714285,12,11,1,91.66666666666666,53,14,39,26.41509433962264,47.66151412130704,0,0,0,0.0,0,0,0,0,0,0,0,Espanyol,3,Spain - La Liga
191,Giuseppe Rossi,331,262,69,79.15407854984893,38,28,10,73.68421052631578,213,185,28,86.85446009389672,23,20,3,86.95652173913044,14.335389872305013,5,3,2,60.0,20,2,49,30,31,17,21,Levante UD,17,Spain - La Liga
192,Gonzalo Castro Irizábal,667,414,253,62.06896551724138,85,39,46,45.88235294117647,323,260,63,80.4953560371517,136,51,85,37.5,18.92079075998051,77,28,49,36.36363636363637,33,3,62,37,33,17,28,Málaga,24,Spain - La Liga
193,Gonzalo Escalante,1294,944,350,72.95208655332303,208,100,108,48.07692307692308,673,590,83,87.66716196136701,124,54,70,43.54838709677419,17.689494472414776,17,6,11,35.294117647058826,14,1,63,38,19,13,35,Eibar,34,Spain - La Liga
194,Gorka Elustondo Urkola,244,199,45,81.55737704918032,36,20,16,55.55555555555556,156,151,5,96.7948717948718,26,5,21,19.230769230769234,18.152573436549442,2,0,2,0.0,2,0,5,5,1,1,1,Athletic Club,11,Spain - La Liga
195,Gorka Iraizoz Moreno,1359,818,541,60.191317144959534,279,105,174,37.634408602150536,300,300,0,100.0,934,401,533,42.933618843683085,45.43033280957775,0,0,0,0.0,3,0,0,0,0,0,3,Athletic Club,37,Spain - La Liga
196,Grzegorz Krychowiak,1230,1021,209,83.0081300813008,126,73,53,57.936507936507944,715,679,36,94.96503496503496,87,42,45,48.275862068965516,19.779749421111802,6,3,3,50.0,5,0,16,12,6,6,62,Sevilla,26,Spain - La Liga
197,Guilherme Magdalena Siqueira,687,549,138,79.91266375545851,74,55,19,74.32432432432432,381,354,27,92.91338582677166,63,20,43,31.746031746031743,16.05563702520419,25,6,19,24.0,3,0,36,14,10,3,16,Valencia,15,Spain - La Liga
198,Gustavo Daniel Cabral Cáceres,1798,1590,208,88.43159065628477,90,39,51,43.333333333333336,1157,1139,18,98.44425237683664,161,64,97,39.75155279503105,20.94062349703535,2,0,2,0.0,3,0,12,10,1,1,23,Celta Vigo,31,Spain - La Liga
199,Hachim Mastour,2,1,1,50.0,0,0,0,0.0,0,0,0,0.0,0,0,0,0.0,11.719996656480001,0,0,0,0.0,0,0,0,0,0,0,0,Málaga,1,Spain - La Liga
200,Heiko Westermann,647,499,148,77.12519319938175,71,26,45,36.61971830985916,325,315,10,96.92307692307692,85,20,65,23.52941176470588,21.409035331652177,1,0,1,0.0,2,0,7,5,0,0,14,Real Betis,20,Spain - La Liga
201,Henok Goitom,33,21,12,63.63636363636363,5,2,3,40.0,18,12,6,66.66666666666666,0,0,0,0.0,10.759128267185455,0,0,0,0.0,2,0,1,0,0,0,2,Getafe,2,Spain - La Liga
202,Hernán Arsenio Pérez González,1019,688,331,67.5171736997056,91,45,46,49.45054945054945,547,468,79,85.55758683729434,100,35,65,35.0,15.989063332710737,86,23,63,26.744186046511626,25,1,169,96,82,40,62,Espanyol,32,Spain - La Liga
203,Hernán Daniel Santana Trujillo,562,474,88,84.34163701067615,38,22,16,57.89473684210527,419,380,39,90.69212410501193,15,5,10,33.33333333333333,16.485935904327842,1,0,1,0.0,1,0,12,6,2,2,17,Las Palmas,18,Spain - La Liga
204,Hugo Fraile Martín,33,21,12,63.63636363636363,1,1,0,100.0,19,16,3,84.21052631578947,5,2,3,40.0,17.06519582866909,4,2,2,50.0,2,0,3,0,2,0,1,Sporting Gijón,3,Spain - La Liga
205,Hugo Mallo Novegil,1768,1394,374,78.84615384615384,231,121,110,52.38095238095239,939,885,54,94.24920127795528,202,55,147,27.22772277227723,19.595664008172488,44,10,34,22.727272727272727,10,4,22,14,12,6,19,Celta Vigo,34,Spain - La Liga
206,Hugo Miguel Almeida Costa Lopes,1048,784,264,74.80916030534351,116,76,40,65.51724137931035,464,397,67,85.5603448275862,95,32,63,33.68421052631579,16.666639935693322,42,5,37,11.904761904761903,12,1,44,30,16,10,20,Granada,26,Spain - La Liga
207,Héctor Hernández Ortega,244,171,73,70.08196721311475,16,9,7,56.25,115,99,16,86.08695652173914,28,7,21,25.0,17.677021573354427,18,3,15,16.666666666666664,0,1,10,3,7,1,7,Real Sociedad,13,Spain - La Liga
208,Iago Aspas Juncal,976,744,232,76.22950819672131,80,49,31,61.25000000000001,618,520,98,84.14239482200647,56,29,27,51.78571428571429,14.628919349695941,39,16,23,41.02564102564102,41,5,66,34,39,18,49,Celta Vigo,35,Spain - La Liga
209,Iago Herrerín Buisán,81,43,38,53.086419753086425,20,3,17,15.0,6,6,0,100.0,66,31,35,46.96969696969697,54.22979810186666,0,0,0,0.0,0,0,0,0,0,0,0,Athletic Club,2,Spain - La Liga
210,Ian González Nieto,11,9,2,81.81818181818183,0,0,0,0.0,10,8,2,80.0,0,0,0,0.0,10.145681657934546,0,0,0,0.0,0,0,0,0,0,0,0,Getafe,1,Spain - La Liga
211,Ibai Gómez Pérez,53,32,21,60.37735849056604,5,3,2,60.0,26,22,4,84.61538461538461,9,2,7,22.22222222222222,17.328706453698114,8,1,7,12.5,1,0,5,4,2,2,0,Athletic Club,5,Spain - La Liga
212,Idriss Carlos Kameni,782,516,266,65.98465473145781,67,22,45,32.83582089552239,185,184,1,99.45945945945947,469,217,252,46.26865671641791,42.66224456675663,0,0,0,0.0,0,1,2,2,0,0,1,Málaga,28,Spain - La Liga
213,Ignacio Camacho Barnola,1167,864,303,74.03598971722364,203,108,95,53.20197044334976,619,543,76,87.7221324717286,118,52,66,44.06779661016949,17.362805516932443,8,3,5,37.5,10,1,18,15,2,0,47,Málaga,23,Spain - La Liga
214,Ignacio Cases Mora,963,786,177,81.61993769470405,116,81,35,69.82758620689656,614,557,57,90.71661237785015,69,34,35,49.275362318840585,17.16187752878953,11,2,9,18.181818181818183,6,0,25,17,10,5,38,Sporting Gijón,24,Spain - La Liga
215,Ignacio Monsalve Vicente,32,26,6,81.25,1,0,1,0.0,16,14,2,87.5,3,1,2,33.33333333333333,20.8335379667625,0,0,0,0.0,1,0,0,0,0,0,0,Atlético Madrid,1,Spain - La Liga
216,Igor Lichnovsky Osorio,26,17,9,65.38461538461539,3,1,2,33.33333333333333,12,12,0,100.0,7,1,6,14.285714285714285,22.470570910744616,0,0,0,0.0,0,0,1,1,0,0,2,Sporting Gijón,2,Spain - La Liga
217,Igor Zubeldia Elorza,5,4,1,80.0,2,2,0,100.0,3,3,0,100.0,0,0,0,0.0,18.143527652928,0,0,0,0.0,0,0,0,0,0,0,0,Real Sociedad,1,Spain - La Liga
218,Ikechukwu Uche,27,22,5,81.48148148148148,3,2,1,66.66666666666666,17,14,3,82.35294117647058,2,1,1,50.0,11.703091347813334,0,0,0,0.0,1,0,2,1,0,0,3,Málaga,3,Spain - La Liga
219,Iker Muniain Goñi,554,465,89,83.93501805054152,56,35,21,62.5,397,358,39,90.17632241813602,31,17,14,54.83870967741935,15.41173979113083,10,6,4,60.0,17,0,35,23,19,13,45,Athletic Club,20,Spain - La Liga
220,Imanol Agirretxe Arruti,330,226,104,68.48484848484848,33,13,20,39.39393939393939,175,143,32,81.71428571428572,18,3,15,16.666666666666664,13.469156322713673,11,0,11,0.0,3,0,21,6,13,3,28,Real Sociedad,16,Spain - La Liga
221,Isaac Ajayi Success,704,434,270,61.64772727272727,62,24,38,38.70967741935484,434,293,141,67.51152073732719,50,17,33,34.0,16.106969928692045,73,19,54,26.027397260273972,23,2,140,57,103,37,97,Granada,30,Spain - La Liga
222,Ismael López Blanco,1275,910,365,71.37254901960785,212,110,102,51.886792452830186,595,510,85,85.71428571428571,176,59,117,33.52272727272727,18.53553437931953,51,16,35,31.372549019607842,19,0,48,26,19,8,24,Sporting Gijón,31,Spain - La Liga
223,Ivan Rakitić,1899,1636,263,86.1506055818852,206,161,45,78.15533980582524,1258,1179,79,93.72019077901432,183,114,69,62.295081967213115,16.940516032696493,24,9,15,37.5,30,2,37,18,18,6,57,Barcelona,36,Spain - La Liga
224,Iván Cuéllar Sacristán,1019,440,579,43.179587831207066,245,53,192,21.63265306122449,142,141,1,99.29577464788733,790,223,567,28.227848101265824,51.97415492897947,0,0,0,0.0,1,2,0,0,0,0,8,Sporting Gijón,32,Spain - La Liga
225,Iván López Mendoza,443,311,132,70.20316027088036,60,32,28,53.333333333333336,170,148,22,87.05882352941177,97,39,58,40.20618556701031,21.89210298135115,17,2,15,11.76470588235294,4,0,24,17,6,4,8,Levante UD,13,Spain - La Liga
226,Iván Ramis Barrios,751,582,169,77.49667110519307,87,40,47,45.97701149425287,330,312,18,94.54545454545455,131,60,71,45.80152671755725,23.424797052044102,3,2,1,66.66666666666666,3,1,8,5,0,0,11,Eibar,23,Spain - La Liga
227,Izet Hajrović,79,54,25,68.35443037974683,7,5,2,71.42857142857143,44,40,4,90.9090909090909,18,3,15,16.666666666666664,18.804013751957466,3,0,3,0.0,3,0,6,0,3,0,2,Eibar,7,Spain - La Liga
228,Iñaki Williams Arthuer,485,300,185,61.855670103092784,38,21,17,55.26315789473685,315,223,92,70.7936507936508,26,10,16,38.46153846153847,14.880969796456874,44,12,32,27.27272727272727,10,3,57,32,32,19,47,Athletic Club,25,Spain - La Liga
229,Iñigo Barrenetxea García,7,6,1,85.71428571428571,2,2,0,100.0,3,3,0,100.0,0,0,0,0.0,20.330745512091426,0,0,0,0.0,1,0,0,0,0,0,0,Eibar,2,Spain - La Liga
230,Jackson Arley Martínez Valencia,196,140,56,71.42857142857143,31,15,16,48.38709677419355,103,87,16,84.46601941747572,9,5,4,55.55555555555556,14.040887736853469,7,4,3,57.14285714285714,8,2,17,11,14,10,16,Atlético Madrid,15,Spain - La Liga
231,James David Rodríguez Rubio,1214,988,226,81.38385502471169,120,96,24,80.0,801,734,67,91.6354556803995,156,81,75,51.92307692307693,17.687223421199466,70,26,44,37.142857142857146,53,8,49,26,30,14,26,Real Madrid,26,Spain - La Liga
232,Jan Oblak,818,423,395,51.71149144254279,90,23,67,25.555555555555554,172,170,2,98.83720930232558,581,194,387,33.3907056798623,47.63315430936969,0,0,0,0.0,1,0,1,1,0,0,5,Atlético Madrid,38,Spain - La Liga
233,Jaume Doménech Sánchez,516,305,211,59.10852713178295,35,11,24,31.428571428571427,125,124,1,99.2,340,135,205,39.705882352941174,43.38844957902418,0,0,0,0.0,1,0,0,0,0,0,5,Valencia,17,Spain - La Liga
234,Jaume Vicent Costa Jordá,843,665,178,78.88493475682088,94,52,42,55.319148936170215,405,379,26,93.58024691358024,93,40,53,43.01075268817204,18.402373194954023,15,2,13,13.333333333333334,3,1,5,4,4,3,22,Villarreal,18,Spain - La Liga
235,Javi Castellano Betancor,41,33,8,80.48780487804879,2,1,1,50.0,19,19,0,100.0,3,1,2,33.33333333333333,18.23238979161366,0,0,0,0.0,0,0,0,0,0,0,3,Las Palmas,1,Spain - La Liga
236,Javier Alejandro Mascherano,2111,1933,178,91.56797726196115,288,211,77,73.26388888888889,1293,1266,27,97.91183294663574,254,173,81,68.11023622047244,22.9771269395045,2,1,1,50.0,10,0,13,11,4,2,22,Barcelona,32,Spain - La Liga
237,Javier Eraso Goñi,260,192,68,73.84615384615385,25,14,11,56.00000000000001,169,150,19,88.75739644970415,9,2,7,22.22222222222222,13.763747817401539,1,1,0,100.0,9,1,14,5,8,4,19,Athletic Club,16,Spain - La Liga
238,Javier Fuego Martínez,1268,1073,195,84.62145110410094,150,92,58,61.33333333333333,813,764,49,93.9729397293973,114,63,51,55.26315789473685,18.501393035103785,2,1,1,50.0,9,0,16,11,3,2,39,Valencia,26,Spain - La Liga
239,Javier Garrido Behovide,994,838,156,84.30583501006036,81,51,30,62.96296296296296,612,583,29,95.26143790849673,89,32,57,35.95505617977528,18.832778668736257,22,7,15,31.818181818181817,5,1,2,2,0,0,4,Las Palmas,18,Spain - La Liga
240,Javier Guerra Rodríguez,663,477,186,71.94570135746606,63,24,39,38.095238095238095,385,334,51,86.75324675324674,22,10,12,45.45454545454545,12.970746414695023,13,4,9,30.76923076923077,24,0,47,22,26,12,65,Rayo Vallecano,30,Spain - La Liga
241,Javier López Rodríguez,1231,883,348,71.73030056864337,196,95,101,48.46938775510204,554,498,56,89.89169675090253,171,44,127,25.730994152046783,18.59130496080351,41,15,26,36.58536585365854,7,2,37,21,11,3,35,Espanyol,31,Spain - La Liga
242,Javier Márquez Moreno,605,428,177,70.74380165289256,164,92,72,56.09756097560976,301,270,31,89.70099667774086,143,61,82,42.65734265734265,22.288877157202514,13,0,13,0.0,11,1,12,9,0,0,30,Granada,19,Spain - La Liga
243,Javier Ontiveros Parra,43,33,10,76.74418604651163,4,2,2,50.0,33,27,6,81.81818181818183,3,1,2,33.33333333333333,14.445863635212838,2,0,2,0.0,2,0,2,2,1,1,1,Málaga,4,Spain - La Liga
244,Javier Varas Herrera,1221,762,459,62.40786240786241,96,22,74,22.916666666666664,361,357,4,98.89196675900277,704,262,442,37.215909090909086,39.74419805291971,0,0,0,0.0,0,0,3,3,0,0,8,Las Palmas,31,Spain - La Liga
245,Jean-Sylvain Claude Babin,852,699,153,82.04225352112677,82,32,50,39.02439024390244,493,475,18,96.34888438133873,121,58,63,47.93388429752066,21.172018452796056,1,0,1,0.0,2,0,1,1,0,0,7,Granada,25,Spain - La Liga
246,Jefferson Andrés Lerma Solís,1211,896,315,73.98843930635837,179,100,79,55.865921787709496,619,550,69,88.8529886914378,143,65,78,45.45454545454545,18.461732295132087,37,9,28,24.324324324324326,24,2,34,17,11,3,28,Levante UD,33,Spain - La Liga
247,Jerónimo Figueroa Cabrera,874,715,159,81.80778032036613,82,57,25,69.51219512195121,587,536,51,91.31175468483816,93,47,46,50.53763440860215,17.25774050691185,31,8,23,25.806451612903224,24,3,58,41,20,13,32,Las Palmas,23,Spain - La Liga
248,Jesé Rodríguez Ruiz,399,307,92,76.94235588972431,15,12,3,80.0,301,252,49,83.72093023255815,21,7,14,33.33333333333333,14.284373514916691,41,12,29,29.268292682926827,20,6,33,20,21,16,14,Real Madrid,28,Spain - La Liga
249,Jesús Fernández Collado,43,18,25,41.86046511627907,4,2,2,50.0,2,2,0,100.0,40,16,24,40.0,53.835602538809304,0,0,0,0.0,1,0,0,0,0,0,0,Granada,1,Spain - La Liga
250,Jesús Gámez Duarte,394,269,125,68.2741116751269,45,20,25,44.44444444444444,156,136,20,87.17948717948718,76,30,46,39.473684210526315,19.718404411619694,26,5,21,19.230769230769234,4,0,9,4,3,2,9,Atlético Madrid,10,Spain - La Liga
251,Joan Jordán Moreno,376,322,54,85.63829787234043,55,40,15,72.72727272727273,248,225,23,90.7258064516129,40,25,15,62.5,18.627649359556596,3,1,2,33.33333333333333,10,0,14,9,3,1,6,Espanyol,9,Spain - La Liga
252,Joan Verdú Fernández,510,427,83,83.72549019607844,52,32,20,61.53846153846154,343,313,30,91.25364431486881,41,21,20,51.21951219512195,16.23608608569741,11,6,5,54.54545454545454,17,1,19,13,4,2,14,Levante UD,13,Spain - La Liga
253,Joaquín José Marín Ruiz,1106,747,359,67.54068716094032,135,46,89,34.074074074074076,440,370,70,84.0909090909091,130,33,97,25.384615384615383,18.475722690344593,54,7,47,12.962962962962962,9,1,34,22,18,10,20,Rayo Vallecano,27,Spain - La Liga
254,Joaquín Sánchez Rodríguez,961,699,262,72.73673257023934,92,49,43,53.2608695652174,573,506,67,88.30715532286213,164,60,104,36.58536585365854,17.735933047647034,49,21,28,42.857142857142854,48,5,88,50,57,34,48,Real Betis,30,Spain - La Liga
255,John Guidetti,316,229,87,72.46835443037975,17,9,8,52.94117647058824,212,180,32,84.90566037735849,7,4,3,57.14285714285714,11.25322118381848,8,2,6,25.0,16,0,27,16,17,9,31,Celta Vigo,35,Spain - La Liga
256,Jon Ansotegi Gorostola,179,123,56,68.71508379888269,25,6,19,24.0,64,63,1,98.4375,39,13,26,33.33333333333333,24.790538431532514,0,0,0,0.0,2,0,0,0,0,0,3,Eibar,8,Spain - La Liga
257,Jon Bautista Orgilles,35,22,13,62.857142857142854,3,1,2,33.33333333333333,19,15,4,78.94736842105263,1,1,0,100.0,10.400771981026285,2,1,1,50.0,2,0,3,1,2,1,4,Real Sociedad,4,Spain - La Liga
258,Jonathan Castro Otto,1895,1547,348,81.6358839050132,228,149,79,65.35087719298247,1125,1026,99,91.2,126,46,80,36.507936507936506,16.911714664052646,29,13,16,44.827586206896555,18,4,43,22,26,13,27,Celta Vigo,36,Spain - La Liga
259,Jonathan Javier Rodríguez Portillo,97,65,32,67.0103092783505,9,7,2,77.77777777777779,59,46,13,77.96610169491525,0,0,0,0.0,11.918013717978557,3,1,2,33.33333333333333,3,0,11,7,8,4,5,RC Deportivo La Coruña,13,Spain - La Liga
260,Jonathan Rodríguez Menéndez,1122,662,460,59.001782531194294,121,57,64,47.107438016528924,575,450,125,78.26086956521739,213,46,167,21.5962441314554,19.831277488539463,152,32,120,21.052631578947366,36,7,140,59,74,28,64,Sporting Gijón,36,Spain - La Liga
261,Jonathan Viera Ramos,1956,1548,408,79.14110429447852,221,148,73,66.9683257918552,1337,1178,159,88.1077038145101,157,69,88,43.94904458598726,15.62673517695125,57,14,43,24.561403508771928,65,9,136,72,76,36,96,Las Palmas,36,Spain - La Liga
262,Jonathan dos Santos Ramírez,969,755,214,77.91537667698658,106,67,39,63.20754716981132,589,519,70,88.11544991511036,109,58,51,53.21100917431193,17.639800261526936,34,11,23,32.35294117647059,23,1,43,25,14,6,25,Villarreal,26,Spain - La Liga
263,Jonathas Cristian de Jesus,368,260,108,70.65217391304348,29,14,15,48.275862068965516,192,159,33,82.8125,10,7,3,70.0,13.125715421165216,14,3,11,21.428571428571427,13,2,54,28,42,21,38,Real Sociedad,27,Spain - La Liga
264,Jonhatan Montiel Caballero,79,55,24,69.62025316455697,10,3,7,30.0,52,41,11,78.84615384615384,9,2,7,22.22222222222222,17.165712109124048,7,3,4,42.857142857142854,2,0,9,3,4,1,4,Rayo Vallecano,8,Spain - La Liga
265,Jonás Manuel Gutiérrez,170,103,67,60.588235294117645,25,8,17,32.0,92,80,12,86.95652173913044,16,5,11,31.25,17.628689675299764,13,1,12,7.6923076923076925,2,1,20,10,11,5,6,RC Deportivo La Coruña,15,Spain - La Liga
266,Jordi Alba Ramos,2332,2005,327,85.97770154373929,174,134,40,77.01149425287356,1597,1489,108,93.23731997495304,95,38,57,40.0,15.117709749820241,67,19,48,28.35820895522388,16,6,16,7,8,1,17,Barcelona,31,Spain - La Liga
267,Jordi Figueras Montel,71,51,20,71.83098591549296,15,6,9,40.0,39,37,2,94.87179487179486,15,4,11,26.666666666666668,23.970250861879435,0,0,0,0.0,0,0,1,1,0,0,0,Real Betis,3,Spain - La Liga
268,Jordi Xumetra Feliu,147,100,47,68.02721088435374,16,6,10,37.5,76,62,14,81.57894736842105,7,0,7,0.0,15.319757012267754,11,1,10,9.090909090909092,4,0,9,2,4,1,8,Levante UD,13,Spain - La Liga
269,Jorge Andújar Moreno,866,627,239,72.40184757505773,127,70,57,55.118110236220474,395,346,49,87.59493670886076,99,36,63,36.36363636363637,18.142487618887206,34,5,29,14.705882352941178,7,1,34,18,18,8,32,Sevilla,22,Spain - La Liga
270,Jorge Franco Alviz,430,295,135,68.6046511627907,27,18,9,66.66666666666666,260,209,51,80.38461538461539,46,18,28,39.130434782608695,16.180506199177117,37,11,26,29.72972972972973,16,3,50,23,37,16,21,Espanyol,26,Spain - La Liga
271,Jorge Meré Pérez,789,621,168,78.70722433460075,71,19,52,26.76056338028169,422,399,23,94.54976303317537,90,23,67,25.555555555555554,22.159482196340075,0,0,0,0.0,1,0,9,8,0,0,12,Sporting Gijón,25,Spain - La Liga
272,Jorge Molina Vidal,300,185,115,61.66666666666667,44,21,23,47.72727272727273,155,122,33,78.70967741935485,12,3,9,25.0,12.5341021405848,4,0,4,0.0,8,1,9,6,4,3,24,Real Betis,23,Spain - La Liga
273,Jorge Resurrección Merodio,2272,1743,529,76.71654929577466,274,161,113,58.75912408759124,1450,1322,128,91.17241379310344,293,100,193,34.129692832764505,16.401959491947466,81,15,66,18.51851851851852,64,14,53,27,21,9,63,Atlético Madrid,35,Spain - La Liga
274,Joseba Zaldúa Bengoetxea,501,345,156,68.8622754491018,91,50,41,54.94505494505495,171,152,19,88.88888888888889,79,29,50,36.708860759493675,18.98379246409437,29,9,20,31.03448275862069,5,0,13,4,13,4,24,Real Sociedad,13,Spain - La Liga
275,Josep Señé Escudero,112,81,31,72.32142857142857,17,8,9,47.05882352941176,73,62,11,84.93150684931507,7,3,4,42.857142857142854,15.559317719794285,1,0,1,0.0,1,1,14,8,5,3,17,Celta Vigo,9,Spain - La Liga
276,Josip Radošević,194,143,51,73.71134020618557,30,18,12,60.0,96,84,12,87.5,19,10,9,52.63157894736842,18.678103233628452,3,3,0,100.0,1,0,3,2,1,0,7,Eibar,8,Spain - La Liga
277,José Alberto Cañas Ruiz Herrera,397,321,76,80.85642317380352,57,38,19,66.66666666666666,241,217,24,90.04149377593362,47,29,18,61.702127659574465,19.666401595569972,1,0,1,0.0,3,0,4,4,2,2,16,Espanyol,13,Spain - La Liga
278,José Antonio Dorado Ramírez,271,220,51,81.18081180811808,30,12,18,40.0,166,154,12,92.7710843373494,35,11,24,31.428571428571427,20.346430442589963,0,0,0,0.0,3,0,3,2,1,1,0,Rayo Vallecano,10,Spain - La Liga
279,José Antonio García Rabasco,1362,1049,313,77.01908957415566,206,114,92,55.33980582524271,747,694,53,92.904953145917,252,110,142,43.65079365079365,21.1972313272985,37,9,28,24.324324324324326,41,3,19,13,3,2,32,Levante UD,29,Spain - La Liga
280,José Antonio Reyes Calderón,607,378,229,62.27347611202636,88,53,35,60.22727272727273,336,261,75,77.67857142857143,100,34,66,34.0,18.145757428114003,50,15,35,30.0,31,1,38,16,21,9,43,Sevilla,24,Spain - La Liga
281,José Eduardo Rosa Vale de Castro,1159,871,288,75.15099223468508,215,85,130,39.53488372093023,567,543,24,95.76719576719577,262,92,170,35.11450381679389,25.007200798433683,2,0,2,0.0,5,0,12,10,0,0,6,Rayo Vallecano,22,Spain - La Liga
282,José Ignacio Fernández Iglesias,578,518,60,89.61937716262976,32,28,4,87.5,406,391,15,96.30541871921181,26,10,16,38.46153846153847,17.265410979970795,5,1,4,20.0,2,0,5,4,2,2,15,Real Madrid,16,Spain - La Liga
283,José Ignacio Martínez García,1109,809,300,72.94860234445446,169,86,83,50.887573964497044,477,423,54,88.67924528301887,151,50,101,33.11258278145696,19.17263856327906,37,5,32,13.513513513513514,10,0,17,8,8,5,17,Rayo Vallecano,22,Spain - La Liga
284,José Ignacio Peleteiro Ramallo,260,181,79,69.61538461538461,22,13,9,59.09090909090909,149,126,23,84.56375838926175,42,17,25,40.476190476190474,18.69621777987785,18,3,15,16.666666666666664,14,0,50,33,28,17,5,Eibar,13,Spain - La Liga
285,José Joaquín Matos García,53,39,14,73.58490566037736,6,5,1,83.33333333333334,30,23,7,76.66666666666667,2,0,2,0.0,16.082444792024152,5,0,5,0.0,0,0,2,1,1,1,1,Sevilla,1,Spain - La Liga
286,José Luis García del Pozo,1483,1174,309,79.16385704652731,209,129,80,61.72248803827751,965,881,84,91.29533678756476,167,66,101,39.52095808383233,17.981438123310262,22,4,18,18.181818181818183,30,4,60,36,32,17,47,Málaga,33,Spain - La Liga
287,José Luis Gayà Peña,851,665,186,78.1433607520564,64,42,22,65.625,448,418,30,93.30357142857143,99,39,60,39.39393939393939,17.27659133795422,42,10,32,23.809523809523807,14,0,34,18,22,8,20,Valencia,20,Spain - La Liga
288,José Luis Morales Nogales,1002,674,328,67.26546906187625,100,53,47,53.0,565,449,116,79.46902654867256,132,57,75,43.18181818181818,17.472026256007187,105,31,74,29.523809523809526,51,4,169,88,107,61,40,Levante UD,35,Spain - La Liga
289,José María Giménez de Vargas,882,659,223,74.71655328798185,144,61,83,42.36111111111111,393,377,16,95.92875318066157,202,76,126,37.62376237623762,24.57908936426939,2,1,1,50.0,6,1,11,8,0,0,12,Atlético Madrid,27,Spain - La Liga
290,José María Martín-Bejarano Serrano,418,322,96,77.03349282296651,59,28,31,47.45762711864407,214,196,18,91.58878504672897,52,25,27,48.07692307692308,20.297905823587175,3,0,3,0.0,3,0,9,5,3,2,18,Levante UD,12,Spain - La Liga
291,José Raúl Baena Urdiales,848,681,167,80.30660377358491,114,57,57,50.0,502,467,35,93.02788844621513,88,36,52,40.909090909090914,18.56157420889019,5,1,4,20.0,8,1,22,16,11,7,43,Rayo Vallecano,24,Spain - La Liga
292,José Vicente Gómez Umpiérrez,1038,908,130,87.47591522157995,64,48,16,75.0,718,688,30,95.82172701949861,35,16,19,45.714285714285715,16.030212256286706,7,2,5,28.57142857142857,6,1,28,16,5,3,45,Las Palmas,21,Spain - La Liga
293,José Ángel Crespo Rincón,411,340,71,82.7250608272506,34,18,16,52.94117647058824,246,234,12,95.1219512195122,53,18,35,33.9622641509434,20.3662112160508,0,0,0,0.0,0,0,2,1,0,0,7,Rayo Vallecano,9,Spain - La Liga
294,Jozabed Sánchez Ruiz,1079,885,194,82.02038924930491,137,92,45,67.15328467153284,680,617,63,90.73529411764706,84,38,46,45.23809523809524,17.01052064907394,16,3,13,18.75,27,2,38,23,9,2,33,Rayo Vallecano,27,Spain - La Liga
295,João Pedro Cavaco Cancelo,1210,909,301,75.12396694214875,142,82,60,57.74647887323944,594,528,66,88.88888888888889,161,59,102,36.64596273291926,18.964144735911074,74,14,60,18.91891891891892,12,4,109,59,54,24,43,Valencia,28,Spain - La Liga
296,Juan Antonio Rodríguez Villamuela,1147,901,246,78.55274629468177,161,82,79,50.931677018633536,606,572,34,94.38943894389439,148,68,80,45.94594594594595,19.88631238829524,7,2,5,28.57142857142857,6,1,16,11,3,3,31,Getafe,32,Spain - La Liga
297,Juan Carlos Martín Corral,759,539,220,71.01449275362319,81,16,65,19.753086419753085,299,297,2,99.33110367892976,320,118,202,36.875,37.00245974152031,0,0,0,0.0,1,0,1,1,0,0,3,Rayo Vallecano,21,Spain - La Liga
298,Juan Carlos Pérez López,535,384,151,71.77570093457943,54,34,20,62.96296296296296,322,283,39,87.88819875776397,45,11,34,24.444444444444443,16.324572591683125,32,8,24,25.0,14,2,25,14,9,5,22,Málaga,19,Spain - La Liga
299,Juan Carlos Valerón Santana,388,344,44,88.65979381443299,65,50,15,76.92307692307693,281,260,21,92.52669039145907,23,14,9,60.86956521739131,16.745149985407423,2,0,2,0.0,6,0,15,6,4,1,17,Las Palmas,13,Spain - La Liga
300,Juan Domínguez Lamas,60,46,14,76.66666666666667,9,5,4,55.55555555555556,40,37,3,92.5,1,0,1,0.0,16.014498153312,0,0,0,0.0,4,0,1,1,0,0,1,RC Deportivo La Coruña,5,Spain - La Liga
301,Juan Emmanuel Culio,364,303,61,83.24175824175825,44,31,13,70.45454545454545,262,239,23,91.22137404580153,31,20,11,64.51612903225806,16.90440229877934,4,1,3,25.0,8,1,28,17,6,4,32,Las Palmas,12,Spain - La Liga
302,Juan Francisco García García,765,495,270,64.70588235294117,186,85,101,45.69892473118279,298,256,42,85.90604026845638,219,83,136,37.89954337899543,25.141810231392,26,6,20,23.076923076923077,4,1,21,11,2,0,18,Levante UD,21,Spain - La Liga
303,Juan Francisco Moreno Fuertes,1515,1060,455,69.96699669966998,178,93,85,52.24719101123596,700,610,90,87.14285714285714,200,62,138,31.0,18.58932384677608,94,16,78,17.02127659574468,18,0,56,30,27,14,32,RC Deportivo La Coruña,35,Spain - La Liga
304,Juan Francisco Torres Belén,1723,1303,420,75.62391178177597,121,69,52,57.02479338842975,860,742,118,86.27906976744187,158,47,111,29.746835443037973,15.557245928013186,99,36,63,36.36363636363637,25,1,60,36,42,23,21,Atlético Madrid,35,Spain - La Liga
305,Juan Isaac Cuenca López,228,185,43,81.14035087719299,31,20,11,64.51612903225806,168,151,17,89.88095238095238,8,2,6,25.0,14.265458579302104,10,3,7,30.0,3,2,27,15,10,5,15,Granada,12,Spain - La Liga
306,Juan Manuel Vargas Risco,921,641,280,69.59826275787188,103,62,41,60.19417475728155,391,366,25,93.60613810741688,175,60,115,34.285714285714285,19.10629146835075,64,17,47,26.5625,23,2,22,16,7,5,9,Real Betis,20,Spain - La Liga
307,Juan Muñiz Gallego,28,19,9,67.85714285714286,3,2,1,66.66666666666666,18,17,1,94.44444444444444,5,2,3,40.0,18.85040529595714,1,0,1,0.0,4,0,2,2,0,0,5,Sporting Gijón,4,Spain - La Liga
308,Juan Muñoz Muñoz,38,25,13,65.78947368421053,6,2,4,33.33333333333333,19,18,1,94.73684210526315,6,3,3,50.0,17.868307155176844,2,1,1,50.0,0,0,2,1,0,0,1,Sevilla,8,Spain - La Liga
309,Juan Pablo Añor Acosta,684,505,179,73.83040935672514,73,37,36,50.68493150684932,467,392,75,83.94004282655246,59,22,37,37.28813559322034,15.440074055220526,17,5,12,29.411764705882355,27,1,93,41,50,23,48,Málaga,29,Spain - La Liga
310,Juan Rafael Fuentes Hernández,349,272,77,77.93696275071633,34,21,13,61.76470588235294,180,164,16,91.11111111111111,31,7,24,22.58064516129032,16.91302026912963,12,0,12,0.0,2,0,6,3,4,2,8,Espanyol,10,Spain - La Liga
311,Juan Torres Ruiz,783,587,196,74.96807151979566,122,46,76,37.704918032786885,340,328,12,96.47058823529412,194,73,121,37.628865979381445,27.30324166701563,1,0,1,0.0,3,1,9,6,1,0,26,Getafe,22,Spain - La Liga
312,Jérémy Mathieu,832,735,97,88.34134615384616,63,44,19,69.84126984126983,587,562,25,95.74105621805792,35,15,20,42.857142857142854,18.73236886718798,7,2,5,28.57142857142857,2,2,5,5,2,2,6,Barcelona,21,Spain - La Liga
313,Karim Benzema,687,535,152,77.87481804949053,61,44,17,72.1311475409836,498,427,71,85.7429718875502,21,11,10,52.38095238095239,13.607648103852576,31,2,29,6.451612903225806,32,5,49,27,32,18,27,Real Madrid,27,Spain - La Liga
314,Kevin Gameiro,439,316,123,71.98177676537586,24,17,7,70.83333333333334,299,230,69,76.92307692307693,8,1,7,12.5,12.666178268067936,20,8,12,40.0,21,3,49,21,37,18,23,Sevilla,31,Spain - La Liga
315,Keylor Navas Gamboa,905,627,278,69.28176795580112,63,7,56,11.11111111111111,322,322,0,100.0,418,152,266,36.36363636363637,38.29044256648548,0,0,0,0.0,1,0,0,0,0,0,6,Real Madrid,34,Spain - La Liga
316,Kléper Laveran Lima Ferreira,1177,1018,159,86.4910790144435,100,57,43,56.99999999999999,800,775,25,96.875,101,39,62,38.613861386138616,19.0774827988174,5,2,3,40.0,6,1,15,12,2,2,25,Real Madrid,21,Spain - La Liga
317,Laureano Sanabria Ruiz,805,599,206,74.40993788819877,82,42,40,51.21951219512195,373,342,31,91.68900804289544,84,21,63,25.0,17.498374840705193,27,9,18,33.33333333333333,8,0,20,10,9,5,14,RC Deportivo La Coruña,23,Spain - La Liga
318,Leandro Damião da Silva dos Santos,28,18,10,64.28571428571429,6,4,2,66.66666666666666,14,14,0,100.0,0,0,0,0.0,11.802240751217143,1,0,1,0.0,4,0,2,0,1,0,3,Real Betis,3,Spain - La Liga
319,Leonardo Carrilho Baptistão,385,249,136,64.67532467532467,35,21,14,60.0,237,176,61,74.26160337552743,21,11,10,52.38095238095239,14.258336510139241,28,7,21,25.0,7,1,49,20,31,11,45,Villarreal,26,Spain - La Liga
320,Lionel Andrés Messi Cuccittini,1926,1544,382,80.16614745586709,284,189,95,66.54929577464789,1305,1159,146,88.81226053639847,219,124,95,56.62100456621004,16.786830197904635,36,5,31,13.88888888888889,59,15,241,179,155,109,80,Barcelona,33,Spain - La Liga
321,Lucas Alfonso Orbán Alegre,392,303,89,77.29591836734694,46,26,20,56.52173913043478,198,187,11,94.44444444444444,49,14,35,28.57142857142857,18.922573723463266,14,1,13,7.142857142857142,0,0,14,7,4,2,19,Levante UD,10,Spain - La Liga
322,Lucas Hernández Pi,325,237,88,72.92307692307692,37,12,25,32.432432432432435,164,155,9,94.51219512195121,50,11,39,22.0,20.429088774127756,3,2,1,66.66666666666666,3,0,3,2,0,0,11,Atlético Madrid,10,Spain - La Liga
323,Lucas Pérez Martínez,1023,749,274,73.21603128054741,67,44,23,65.67164179104478,665,559,106,84.06015037593984,92,34,58,36.95652173913043,15.826380716329618,49,20,29,40.816326530612244,60,7,74,41,57,28,61,RC Deportivo La Coruña,36,Spain - La Liga
324,Lucas Vázquez Iglesias,704,565,139,80.25568181818183,36,26,10,72.22222222222221,510,455,55,89.2156862745098,49,22,27,44.89795918367347,15.022514169573752,51,16,35,31.372549019607842,23,6,40,27,22,14,41,Real Madrid,25,Spain - La Liga
325,Luciano Vietto,375,294,81,78.4,15,6,9,40.0,257,218,39,84.8249027237354,10,4,6,40.0,12.44849949346176,11,3,8,27.27272727272727,9,3,31,20,17,10,23,Atlético Madrid,19,Spain - La Liga
326,Luis Alberto Romero Alconchel,794,515,279,64.86146095717883,84,41,43,48.80952380952381,489,376,113,76.89161554192229,63,25,38,39.682539682539684,15.491477276478589,45,8,37,17.77777777777778,27,6,72,37,52,28,25,RC Deportivo La Coruña,29,Spain - La Liga
327,Luis Alberto Suárez Díaz,973,707,266,72.66187050359713,68,37,31,54.41176470588235,571,455,116,79.6847635726795,47,25,22,53.191489361702125,14.053406163860497,52,21,31,40.38461538461539,45,15,134,50,102,36,77,Barcelona,35,Spain - La Liga
328,Luis Carlos Correia Pinto,504,342,162,67.85714285714286,41,18,23,43.90243902439025,248,219,29,88.30645161290323,56,9,47,16.071428571428573,17.893809307015715,33,3,30,9.090909090909092,4,0,31,20,20,13,33,RC Deportivo La Coruña,20,Spain - La Liga
329,Luis Carlos Fariña Olivera,19,17,2,89.47368421052632,1,1,0,100.0,14,14,0,100.0,1,0,1,0.0,11.746090167385264,0,0,0,0.0,0,0,3,0,2,0,1,Rayo Vallecano,3,Spain - La Liga
330,Luis Hernández Rodríguez,1630,1270,360,77.91411042944786,154,80,74,51.94805194805194,846,786,60,92.90780141843972,249,84,165,33.734939759036145,21.207069089431947,39,8,31,20.51282051282051,14,0,11,10,1,1,18,Sporting Gijón,36,Spain - La Liga
331,Luka Modrić,2270,2026,244,89.2511013215859,329,260,69,79.0273556231003,1620,1541,79,95.12345679012346,215,137,78,63.72093023255814,17.946313559998256,24,7,17,29.166666666666668,59,4,65,47,22,13,70,Real Madrid,32,Spain - La Liga
332,Lévy Clément Madinda,2,2,0,100.0,1,1,0,100.0,2,2,0,100.0,0,0,0,0.0,11.771872214399998,0,0,0,0.0,0,0,0,0,0,0,0,Celta Vigo,1,Spain - La Liga
333,Mamadou Sylla Diallo,68,46,22,67.64705882352942,4,3,1,75.0,38,29,9,76.31578947368422,3,1,2,33.33333333333333,14.995777919304706,5,2,3,40.0,3,0,12,6,9,5,10,Espanyol,13,Spain - La Liga
334,Manuel Agudo Durán,1283,821,462,63.99064692127825,161,76,85,47.20496894409938,714,540,174,75.63025210084034,215,77,138,35.81395348837209,19.157867223320345,65,16,49,24.615384615384617,54,7,163,76,122,54,77,Celta Vigo,29,Spain - La Liga
335,Manuel Castellano Castro,341,246,95,72.14076246334311,49,31,18,63.26530612244898,144,136,8,94.44444444444444,60,23,37,38.333333333333336,21.13590928744399,10,2,8,20.0,2,0,2,1,1,0,6,Eibar,10,Spain - La Liga
336,Manuel Fernández Muñíz,245,114,131,46.53061224489796,52,17,35,32.69230769230769,19,18,1,94.73684210526315,205,78,127,38.048780487804876,54.05709566594938,0,0,0,0.0,1,0,0,0,0,0,3,RC Deportivo La Coruña,9,Spain - La Liga
337,Manuel Pablo García Díaz,104,87,17,83.65384615384616,7,6,1,85.71428571428571,58,56,2,96.55172413793103,8,1,7,12.5,17.421049079404614,1,0,1,0.0,1,0,0,0,0,0,1,RC Deportivo La Coruña,3,Spain - La Liga
338,Manuel Rolando Iturra Urrutia,174,144,30,82.75862068965517,8,0,8,0.0,120,113,7,94.16666666666667,5,0,5,0.0,17.525496700051033,0,0,0,0.0,2,0,4,1,1,0,5,Rayo Vallecano,6,Spain - La Liga
339,Manuel Trigueros Muñoz,1216,981,235,80.67434210526315,183,108,75,59.01639344262295,732,678,54,92.62295081967213,120,66,54,55.00000000000001,19.534375450165854,2,0,2,0.0,14,1,19,13,6,3,31,Villarreal,31,Spain - La Liga
340,Marc Bartra Aregall,392,346,46,88.26530612244898,31,24,7,77.41935483870968,259,256,3,98.84169884169884,39,17,22,43.58974358974359,21.51875164770918,0,0,0,0.0,0,1,4,3,1,1,9,Barcelona,13,Spain - La Liga
341,Marc-André ter Stegen,187,165,22,88.23529411764706,1,1,0,100.0,102,102,0,100.0,54,32,22,59.25925925925925,29.153420641289838,0,0,0,0.0,1,0,0,0,0,0,0,Barcelona,7,Spain - La Liga
342,Marcelo Alfonso Díaz Rojas,758,676,82,89.18205804749341,91,75,16,82.41758241758241,504,482,22,95.63492063492063,70,49,21,70.0,19.40122683381372,3,0,3,0.0,3,1,7,4,2,1,14,Celta Vigo,14,Spain - La Liga
343,Marcelo Vieira da Silva Júnior,2087,1708,379,81.83996166746526,253,170,83,67.19367588932806,1272,1162,110,91.35220125786164,237,115,122,48.52320675105485,18.080061391841227,97,25,72,25.773195876288657,45,3,100,60,57,31,42,Real Madrid,30,Spain - La Liga
344,Marco Andreolli,206,173,33,83.98058252427184,21,6,15,28.57142857142857,108,105,3,97.22222222222221,23,6,17,26.08695652173913,22.766810124971183,0,0,0,0.0,2,0,0,0,0,0,4,Sevilla,7,Spain - La Liga
345,Marco Asensio Willemsen,1315,945,370,71.86311787072243,145,97,48,66.89655172413794,811,698,113,86.06658446362515,182,64,118,35.16483516483517,17.88750553609697,73,24,49,32.87671232876712,57,9,112,61,45,27,71,Espanyol,34,Spain - La Liga
346,Marcos Alberto Angeleri,384,297,87,77.34375,60,29,31,48.333333333333336,190,180,10,94.73684210526315,64,23,41,35.9375,22.1335211929275,0,0,0,0.0,2,0,1,0,0,0,8,Málaga,13,Spain - La Liga
347,Marcos Llorente Moreno,19,19,0,100.0,1,1,0,100.0,18,18,0,100.0,0,0,0,0.0,15.312036775301053,0,0,0,0.0,1,0,0,0,0,0,0,Real Madrid,2,Spain - La Liga
348,Mariano Damián Barbosa,43,33,10,76.74418604651163,0,0,0,0.0,23,23,0,100.0,15,5,10,33.33333333333333,29.433456087220467,0,0,0,0.0,0,0,1,1,0,0,0,Villarreal,2,Spain - La Liga
349,Mariano Ferreira Filho,892,620,272,69.50672645739911,76,35,41,46.05263157894737,385,319,66,82.85714285714286,122,47,75,38.52459016393443,19.11440263101821,96,27,69,28.125,20,2,34,20,20,9,17,Sevilla,23,Spain - La Liga
350,Mario Gaspar Pérez Martínez,1684,1255,429,74.5249406175772,250,135,115,54.0,805,739,66,91.80124223602485,196,50,146,25.510204081632654,18.50724913456582,29,5,24,17.24137931034483,8,1,23,11,14,7,14,Villarreal,33,Spain - La Liga
351,Markel Bergara Larrañaga,593,473,120,79.76391231028668,78,43,35,55.12820512820513,343,319,24,93.00291545189503,41,17,24,41.46341463414634,17.584563368753724,1,0,1,0.0,1,0,13,10,3,2,28,Real Sociedad,20,Spain - La Liga
352,Markel Susaeta Laskurain,775,540,235,69.6774193548387,77,42,35,54.54545454545454,485,406,79,83.71134020618557,90,33,57,36.666666666666664,15.72764151638462,65,23,42,35.38461538461539,38,8,87,35,46,15,40,Athletic Club,28,Spain - La Liga
353,Martín Montoya Torralbo,740,586,154,79.1891891891892,72,44,28,61.111111111111114,388,351,37,90.4639175257732,40,17,23,42.5,14.926649509031352,9,2,7,22.22222222222222,3,1,25,14,8,2,21,Real Betis,13,Spain - La Liga
354,Mateo Kovačić,773,696,77,90.03880983182407,71,55,16,77.46478873239437,634,593,41,93.53312302839116,14,6,8,42.857142857142854,15.14550113606841,3,1,2,33.33333333333333,17,2,25,15,6,3,22,Real Madrid,25,Spain - La Liga
355,Mateo Pablo Musacchio,461,377,84,81.77874186550976,36,13,23,36.11111111111111,264,251,13,95.07575757575758,50,18,32,36.0,21.276544040757138,0,0,0,0.0,2,0,6,3,0,0,8,Villarreal,13,Spain - La Liga
356,Matheus Dória Macedo,169,113,56,66.86390532544378,33,11,22,33.33333333333333,66,61,5,92.42424242424242,44,13,31,29.545454545454547,26.104596902857278,0,0,0,0.0,0,0,0,0,0,0,0,Granada,8,Spain - La Liga
357,Mathew Ryan,279,179,100,64.15770609318996,36,8,28,22.22222222222222,70,69,1,98.57142857142858,181,87,94,48.06629834254144,43.72312697260645,0,0,0,0.0,0,0,0,0,0,0,1,Valencia,8,Spain - La Liga
358,Matías Nahuel Leiva Esquivel,377,258,119,68.43501326259947,25,11,14,44.0,239,197,42,82.42677824267783,38,8,30,21.052631578947366,16.131133686400425,16,2,14,12.5,12,1,42,20,22,9,17,Villarreal,20,Spain - La Liga
359,Mauricio Andrés Cuero Castillo,142,91,51,64.08450704225352,6,2,4,33.33333333333333,92,64,28,69.56521739130434,11,6,5,54.54545454545454,14.969225233333521,20,12,8,60.0,6,1,28,17,15,9,11,Levante UD,13,Spain - La Liga
360,Mauricio Lemos Merladet,353,294,59,83.28611898016997,33,14,19,42.42424242424242,207,205,2,99.03381642512076,64,28,36,43.75,23.739078330401814,0,0,0,0.0,0,0,7,6,2,2,1,Las Palmas,10,Spain - La Liga
361,Mauro Javier Dos Santos,981,658,323,67.07441386340469,173,53,120,30.63583815028902,328,301,27,91.76829268292683,248,82,166,33.064516129032256,25.006514362391194,5,1,4,20.0,2,1,11,5,0,0,17,Eibar,31,Spain - La Liga
362,Mehdi Lacen,1446,1175,271,81.25864453665284,207,131,76,63.28502415458937,905,831,74,91.8232044198895,141,77,64,54.60992907801418,18.497849653338175,6,2,4,33.33333333333333,11,0,23,16,0,0,43,Getafe,31,Spain - La Liga
363,Michael Krohn-Dehli,888,715,173,80.51801801801803,117,73,44,62.39316239316239,567,520,47,91.71075837742504,114,62,52,54.385964912280706,18.67444238337892,27,8,19,29.629629629629626,31,3,36,17,20,8,19,Sevilla,27,Spain - La Liga
364,Mickaël Ciani,96,72,24,75.0,15,6,9,40.0,52,50,2,96.15384615384616,18,6,12,33.33333333333333,21.502108451437497,0,0,0,0.0,0,0,0,0,0,0,1,Espanyol,2,Spain - La Liga
365,Miguel Filipe Nunes Cardoso,16,12,4,75.0,1,1,0,100.0,12,10,2,83.33333333333334,1,1,0,100.0,13.751272179899999,0,0,0,0.0,0,1,4,1,4,1,0,RC Deportivo La Coruña,3,Spain - La Liga
366,Miguel Torres Gómez,901,634,267,70.36625971143174,139,65,74,46.76258992805755,348,314,34,90.22988505747126,128,40,88,31.25,19.148075397049944,21,7,14,33.33333333333333,8,2,6,3,3,1,6,Málaga,23,Spain - La Liga
367,Miguel Ángel Guerrero Martín,277,209,68,75.45126353790613,20,7,13,35.0,171,145,26,84.7953216374269,6,4,2,66.66666666666666,13.311513456971264,7,4,3,57.14285714285714,12,1,26,18,18,14,15,Sporting Gijón,23,Spain - La Liga
368,Miguel Ángel Muñoz Alonso,91,75,16,82.41758241758241,5,4,1,80.0,49,43,6,87.75510204081633,2,0,2,0.0,16.07010167736,0,0,0,0.0,1,0,1,1,0,0,2,Getafe,3,Spain - La Liga
369,Mikel Arruabarrena Aranbide,34,32,2,94.11764705882352,3,2,1,66.66666666666666,22,21,1,95.45454545454545,0,0,0,0.0,13.35781542479294,0,0,0,0.0,0,0,0,0,0,0,2,Eibar,6,Spain - La Liga
370,Mikel Balenziaga Oruesagasti,1508,1153,355,76.45888594164457,137,84,53,61.31386861313869,712,651,61,91.43258426966293,165,53,112,32.121212121212125,17.704353269874268,81,24,57,29.629629629629626,20,3,48,24,28,12,26,Athletic Club,34,Spain - La Liga
371,Mikel González de Martín Martínez,566,449,117,79.3286219081272,61,31,30,50.81967213114754,314,297,17,94.5859872611465,76,28,48,36.84210526315789,21.69193568710007,4,1,3,25.0,1,0,6,5,0,0,5,Real Sociedad,19,Spain - La Liga
372,Mikel Oyarzabal Ugarte,511,358,153,70.0587084148728,41,24,17,58.536585365853654,326,266,60,81.59509202453987,27,13,14,48.148148148148145,14.405641972655108,26,7,19,26.923076923076923,21,1,56,16,34,9,39,Real Sociedad,22,Spain - La Liga
373,Mikel Rico Moreno,377,283,94,75.06631299734748,57,32,25,56.14035087719298,221,196,25,88.68778280542986,36,15,21,41.66666666666667,17.347433257948012,5,1,4,20.0,3,1,12,5,3,0,9,Athletic Club,17,Spain - La Liga
374,Mikel San José Domínguez,1541,1220,321,79.16937053861129,208,134,74,64.42307692307693,887,813,74,91.65727170236752,134,62,72,46.26865671641791,18.468609534356496,11,5,6,45.45454545454545,11,3,28,15,9,4,32,Athletic Club,34,Spain - La Liga
375,Moisés Gómez Bordonado,430,350,80,81.3953488372093,48,38,10,79.16666666666666,305,274,31,89.8360655737705,32,16,16,50.0,16.342476986304,12,3,9,25.0,5,3,31,21,11,6,6,Getafe,22,Spain - La Liga
376,Mubarak Wakaso,497,394,103,79.27565392354124,59,34,25,57.6271186440678,336,300,36,89.28571428571429,52,24,28,46.15384615384615,18.6722688870268,17,5,12,29.411764705882355,8,0,37,21,10,5,34,Las Palmas,19,Spain - La Liga
377,Munir El Haddadi Mohamed,321,252,69,78.50467289719626,17,8,9,47.05882352941176,240,207,33,86.25,16,6,10,37.5,13.809702388539812,10,1,9,10.0,6,1,21,9,11,5,13,Barcelona,15,Spain - La Liga
378,Nabil El Zhar,632,492,140,77.84810126582279,36,25,11,69.44444444444444,447,394,53,88.14317673378076,37,16,21,43.24324324324324,14.349906197976987,34,10,24,29.411764705882355,14,4,74,30,36,17,36,Las Palmas,30,Spain - La Liga
379,Nabil Ghilas,235,146,89,62.12765957446808,26,10,16,38.46153846153847,109,91,18,83.4862385321101,9,4,5,44.44444444444444,13.17440055509617,7,3,4,42.857142857142854,9,1,37,18,24,12,11,Levante UD,20,Spain - La Liga
380,Nauzet Alemán Viera,150,111,39,74.0,10,6,4,60.0,92,79,13,85.86956521739131,20,9,11,45.0,16.521194372328,7,4,3,57.14285714285714,5,0,4,2,1,0,2,Las Palmas,10,Spain - La Liga
381,Nemanja Radoja,813,670,143,82.41082410824109,92,65,27,70.65217391304348,544,504,40,92.64705882352942,48,19,29,39.58333333333333,17.934890785297416,2,1,1,50.0,3,0,29,18,4,1,14,Celta Vigo,30,Spain - La Liga
382,Neymar da Silva Santos Junior,1970,1532,438,77.76649746192894,138,108,30,78.26086956521739,1381,1197,184,86.67632150615496,159,73,86,45.911949685534594,14.817353186505416,71,26,45,36.61971830985916,82,12,273,169,185,114,159,Barcelona,34,Spain - La Liga
383,Nicolás Federico López Alonso,60,35,25,58.333333333333336,8,2,6,25.0,27,21,6,77.77777777777779,15,2,13,13.333333333333334,19.308837655043998,5,1,4,20.0,3,0,10,7,7,5,5,Granada,8,Spain - La Liga
384,Nicolás Ladislao Fedor Flores,409,303,106,74.08312958435208,36,17,19,47.22222222222222,266,233,33,87.59398496240601,9,3,6,33.33333333333333,12.519259298816038,9,3,6,33.33333333333333,22,3,37,16,18,7,26,Rayo Vallecano,22,Spain - La Liga
385,Nicolás Martín Pareja,92,70,22,76.08695652173914,25,12,13,48.0,44,43,1,97.72727272727273,22,8,14,36.36363636363637,26.119612607110437,0,0,0,0.0,1,0,1,0,0,0,3,Sevilla,2,Spain - La Liga
386,Nikolaos Karabelas,60,35,25,58.333333333333336,9,5,4,55.55555555555556,15,13,2,86.66666666666667,13,4,9,30.76923076923077,20.310573349308,4,1,3,25.0,0,0,1,0,1,0,1,Levante UD,1,Spain - La Liga
387,Nordin Amrabat,313,197,116,62.939297124600635,25,8,17,32.0,190,146,44,76.84210526315789,31,8,23,25.806451612903224,16.632489347735465,47,12,35,25.53191489361702,15,1,38,24,29,18,37,Málaga,13,Spain - La Liga
388,Néstor Díaz García,2,2,0,100.0,0,0,0,0.0,0,0,0,0.0,2,2,0,100.0,42.932559042,0,0,0,0.0,0,0,0,0,0,0,0,Celta Vigo,1,Spain - La Liga
389,Ognjen Vranješ,384,267,117,69.53125,49,32,17,65.3061224489796,145,123,22,84.82758620689656,47,13,34,27.659574468085108,17.345074931955,10,2,8,20.0,1,0,6,4,1,1,18,Sporting Gijón,11,Spain - La Liga
390,Oier Olazábal Paredes,93,51,42,54.83870967741935,15,5,10,33.33333333333333,19,19,0,100.0,61,19,42,31.147540983606557,43.21429953663484,0,0,0,0.0,0,0,0,0,0,0,1,Real Sociedad,3,Spain - La Liga
391,Omar Mascarell González,851,621,230,72.97297297297297,136,70,66,51.470588235294116,421,380,41,90.26128266033254,135,56,79,41.48148148148148,20.87288635898183,6,2,4,33.33333333333333,8,1,12,9,1,0,14,Sporting Gijón,26,Spain - La Liga
392,Oriol Riera Magem,264,180,84,68.18181818181817,27,14,13,51.85185185185185,135,113,22,83.7037037037037,7,4,3,57.14285714285714,13.442282191281818,4,1,3,25.0,8,0,11,7,7,3,19,RC Deportivo La Coruña,22,Spain - La Liga
393,Pablo Daniel Piatti,320,214,106,66.875,20,12,8,60.0,198,162,36,81.81818181818183,47,13,34,27.659574468085108,16.39989571160475,30,8,22,26.666666666666668,13,0,36,13,18,6,40,Valencia,21,Spain - La Liga
394,Pablo Fornals Malla,738,564,174,76.42276422764228,103,51,52,49.51456310679612,483,437,46,90.47619047619048,75,20,55,26.666666666666668,17.299826391561464,4,0,4,0.0,14,0,33,16,13,3,16,Málaga,27,Spain - La Liga
395,Pablo Hernández Domínguez,1017,763,254,75.02458210422812,144,87,57,60.416666666666664,609,520,89,85.38587848932676,75,29,46,38.666666666666664,17.271808355696283,38,13,25,34.21052631578947,26,3,54,24,35,14,24,Rayo Vallecano,27,Spain - La Liga
396,Pablo Pérez Rodríguez,261,162,99,62.06896551724138,34,10,24,29.411764705882355,128,101,27,78.90625,8,2,6,25.0,14.021211369641378,7,1,6,14.285714285714285,3,1,14,5,8,2,10,Sporting Gijón,18,Spain - La Liga
397,Pablo Sarabia García,1208,766,442,63.41059602649006,134,69,65,51.49253731343284,732,563,169,76.91256830601093,216,72,144,33.33333333333333,17.834582058416284,112,30,82,26.785714285714285,65,6,112,45,69,24,66,Getafe,31,Spain - La Liga
398,Papa Kouly Diop,1206,931,275,77.19734660033167,226,116,110,51.32743362831859,674,628,46,93.17507418397626,148,68,80,45.94594594594595,19.82385213784,1,0,1,0.0,3,0,25,18,3,2,58,Espanyol,30,Spain - La Liga
399,Pape Cheikh Diop Gueye,24,22,2,91.66666666666666,1,1,0,100.0,16,16,0,100.0,0,0,0,0.0,13.9856067252,0,0,0,0.0,0,0,2,2,0,0,4,Celta Vigo,4,Spain - La Liga
400,Patrick Ebert,272,189,83,69.48529411764706,21,16,5,76.19047619047619,158,132,26,83.54430379746836,30,7,23,23.333333333333332,16.344024888271765,15,1,14,6.666666666666667,8,0,8,5,5,3,8,Rayo Vallecano,9,Spain - La Liga
401,Pau López Sabata,979,541,438,55.260469867211434,129,34,95,26.356589147286826,211,210,1,99.52606635071089,644,225,419,34.93788819875777,46.2950960872192,0,0,0,0.0,0,0,0,0,0,0,7,Espanyol,36,Spain - La Liga
402,Pedro Bigas Rigo,1284,1074,210,83.64485981308411,67,28,39,41.7910447761194,802,773,29,96.38403990024938,120,27,93,22.5,20.512547130708782,4,2,2,50.0,5,0,21,16,5,4,28,Las Palmas,27,Spain - La Liga
403,Pedro León Sánchez Gil,764,454,310,59.424083769633505,94,42,52,44.680851063829785,365,293,72,80.27397260273973,158,49,109,31.0126582278481,18.574250541004083,72,22,50,30.555555555555557,30,4,96,56,49,27,42,Getafe,31,Spain - La Liga
404,Pedro López Muñoz,707,550,157,77.7934936350778,91,46,45,50.54945054945055,309,274,35,88.67313915857605,73,28,45,38.35616438356164,18.813480818666818,28,6,22,21.428571428571427,3,0,31,19,13,8,22,Levante UD,17,Spain - La Liga
405,Pedro Mosquera Parada,1942,1593,349,82.02883625128733,308,193,115,62.66233766233766,1061,1002,59,94.43920829406221,246,137,109,55.6910569105691,20.55925811929013,6,1,5,16.666666666666664,19,2,23,14,4,3,56,RC Deportivo La Coruña,37,Spain - La Liga
406,Pedro Pablo Hernández,1495,1191,304,79.66555183946488,247,157,90,63.56275303643725,880,818,62,92.95454545454545,128,67,61,52.34375,18.269448498581394,8,1,7,12.5,10,3,48,33,9,6,118,Celta Vigo,33,Spain - La Liga
407,Pedro Taunausú Domínguez Placeres,1150,952,198,82.78260869565217,107,79,28,73.83177570093457,873,775,98,88.77434135166094,57,27,30,47.368421052631575,14.58867394764814,12,6,6,50.0,29,3,63,34,27,16,61,Las Palmas,27,Spain - La Liga
408,Petros Matheus dos Santos Araújo,1195,985,210,82.42677824267783,123,64,59,52.03252032520326,794,740,54,93.19899244332494,67,23,44,34.32835820895522,16.176155235642376,4,3,1,75.0,16,1,40,25,6,2,79,Real Betis,30,Spain - La Liga
409,Rachid Aït-Atmane,511,384,127,75.14677103718199,78,43,35,55.12820512820513,314,281,33,89.49044585987261,74,27,47,36.486486486486484,18.9119387885946,9,1,8,11.11111111111111,11,1,14,8,4,3,19,Sporting Gijón,18,Spain - La Liga
410,Rafael Alcântara do Nascimento,179,149,30,83.24022346368714,14,11,3,78.57142857142857,141,124,17,87.94326241134752,3,2,1,66.66666666666666,14.8331390454543,1,0,1,0.0,4,0,7,4,3,1,6,Barcelona,6,Spain - La Liga
411,Rafael van der Vaart,109,74,35,67.88990825688074,21,8,13,38.095238095238095,61,54,7,88.52459016393442,14,4,10,28.57142857142857,17.725908897485507,3,1,2,33.33333333333333,3,0,2,0,1,0,9,Real Betis,7,Spain - La Liga
412,Raphaël Varane,1258,1112,146,88.39427662957074,59,33,26,55.932203389830505,770,749,21,97.27272727272728,93,45,48,48.38709677419355,21.653254000749634,0,0,0,0.0,1,0,9,7,2,2,12,Real Madrid,26,Spain - La Liga
413,Raúl Albentosa Redal,1076,766,310,71.18959107806691,192,72,120,37.5,419,393,26,93.7947494033413,261,94,167,36.015325670498086,24.237324989650038,4,0,4,0.0,8,0,6,5,1,1,13,Málaga,29,Spain - La Liga
414,Raúl García Escudero,972,604,368,62.139917695473244,192,93,99,48.4375,493,394,99,79.91886409736308,59,17,42,28.8135593220339,15.869088782836295,28,4,24,14.285714285714285,17,6,45,21,20,6,87,Athletic Club,31,Spain - La Liga
415,Raúl Lizoáin Cruz,295,173,122,58.644067796610166,24,4,20,16.666666666666664,91,91,0,100.0,173,57,116,32.947976878612714,39.561839456136404,0,0,0,0.0,0,0,0,0,0,0,2,Las Palmas,8,Spain - La Liga
416,Rene Krhin,537,411,126,76.53631284916202,65,27,38,41.53846153846154,315,287,28,91.11111111111111,35,11,24,31.428571428571427,17.090182639848937,1,0,1,0.0,4,0,13,11,2,1,21,Granada,23,Spain - La Liga
417,Ricardo Jorge Luz Horta,299,231,68,77.25752508361204,27,19,8,70.37037037037037,200,174,26,87.0,23,8,15,34.78260869565217,15.501893965079597,9,4,5,44.44444444444444,7,0,29,16,19,8,8,Málaga,17,Spain - La Liga
418,Ricardo Miguel Moreira da Costa,453,369,84,81.45695364238411,43,15,28,34.883720930232556,215,209,6,97.20930232558139,70,28,42,40.0,23.871475542071522,0,0,0,0.0,1,0,1,1,1,1,3,Granada,14,Spain - La Liga
419,Ricky van Wolfswinkel,170,116,54,68.23529411764706,11,6,5,54.54545454545454,108,91,17,84.25925925925925,2,1,1,50.0,11.606745121236,5,3,2,60.0,4,2,5,4,4,3,13,Real Betis,17,Spain - La Liga
420,Robert Ibáñez Castro,200,159,41,79.5,7,4,3,57.14285714285714,141,126,15,89.36170212765957,11,3,8,27.27272727272727,12.7200184248348,11,1,10,9.090909090909092,7,1,21,11,13,6,27,Granada,18,Spain - La Liga
421,Roberto Antonio Correa Silva,283,223,60,78.79858657243817,30,17,13,56.666666666666664,161,141,20,87.5776397515528,21,7,14,33.33333333333333,16.08470345631689,3,0,3,0.0,1,0,5,1,2,0,4,Espanyol,7,Spain - La Liga
422,Roberto Canella Suárez,337,245,92,72.70029673590504,45,19,26,42.22222222222222,148,138,10,93.24324324324324,41,16,25,39.02439024390244,18.450984279127834,13,1,12,7.6923076923076925,2,0,5,3,2,1,9,Sporting Gijón,9,Spain - La Liga
423,Roberto José Rosales Altuve,1715,1238,477,72.1865889212828,247,149,98,60.32388663967612,750,655,95,87.33333333333333,271,114,157,42.066420664206646,19.70423325266169,101,17,84,16.831683168316832,16,3,53,27,20,8,40,Málaga,35,Spain - La Liga
424,Roberto Lago Soto,670,532,138,79.40298507462687,67,38,29,56.71641791044776,326,299,27,91.71779141104295,57,25,32,43.859649122807014,16.04409395430627,16,6,10,37.5,9,2,20,12,12,6,15,Getafe,17,Spain - La Liga
425,Roberto Román Triguero,1294,1009,285,77.97527047913447,124,68,56,54.83870967741935,633,592,41,93.52290679304897,122,34,88,27.86885245901639,18.020187013623023,33,11,22,33.33333333333333,14,3,25,13,18,8,39,Rayo Vallecano,29,Spain - La Liga
426,Roberto Soldado Rillo,818,548,270,66.99266503667481,98,44,54,44.89795918367347,497,385,112,77.46478873239437,32,13,19,40.625,14.744853586558825,19,5,14,26.31578947368421,18,10,46,23,25,11,70,Villarreal,28,Spain - La Liga
427,Roberto Suárez Pier,42,35,7,83.33333333333334,7,5,2,71.42857142857143,16,16,0,100.0,9,6,3,66.66666666666666,24.004181478822858,0,0,0,0.0,0,0,0,0,0,0,0,RC Deportivo La Coruña,2,Spain - La Liga
428,Roberto Trashorras Gayoso,2680,2190,490,81.71641791044776,409,259,150,63.325183374083124,1496,1397,99,93.38235294117648,451,229,222,50.77605321507761,21.414867330503284,59,18,41,30.508474576271187,57,7,59,34,26,11,84,Rayo Vallecano,36,Spain - La Liga
429,Rodrigo Hernández Cascante,75,66,9,88.0,9,5,4,55.55555555555556,54,52,2,96.29629629629629,5,1,4,20.0,18.2143708685184,0,0,0,0.0,1,0,1,0,0,0,1,Villarreal,3,Spain - La Liga
430,Rodrigo Javier De Paul,279,194,85,69.53405017921148,40,24,16,60.0,147,122,25,82.99319727891157,52,27,25,51.92307692307693,20.667473435181936,6,0,6,0.0,18,0,29,14,12,5,14,Valencia,9,Spain - La Liga
431,Rodrigo Moreno Machado,523,367,156,70.17208413001912,39,20,19,51.28205128205128,345,281,64,81.44927536231884,35,8,27,22.857142857142858,15.402760093021492,39,11,28,28.205128205128204,18,3,46,20,25,12,27,Valencia,25,Spain - La Liga
432,Roger Martí Salvador,130,78,52,60.0,14,7,7,50.0,81,59,22,72.8395061728395,2,0,2,0.0,13.306002179798769,3,2,1,66.66666666666666,6,0,9,6,4,2,11,Levante UD,16,Spain - La Liga
433,Roque Luis Santa Cruz Cantero,174,138,36,79.3103448275862,12,7,5,58.333333333333336,101,94,7,93.06930693069307,3,0,3,0.0,12.911127829957241,1,0,1,0.0,6,1,11,4,3,1,8,Málaga,17,Spain - La Liga
434,Roque Mesa Quevedo,2074,1802,272,86.88524590163934,200,148,52,74.0,1533,1428,105,93.15068493150685,105,51,54,48.57142857142857,16.79693103501813,9,2,7,22.22222222222222,14,2,67,39,20,7,65,Las Palmas,34,Spain - La Liga
435,Rubén Blanco Veiga,228,131,97,57.45614035087719,30,3,27,10.0,76,76,0,100.0,128,33,95,25.78125,42.36087913460211,0,0,0,0.0,0,0,0,0,0,0,2,Celta Vigo,8,Spain - La Liga
436,Rubén Castro Martín,1022,735,287,71.91780821917808,79,35,44,44.303797468354425,632,534,98,84.49367088607595,60,26,34,43.333333333333336,13.428368456343287,44,11,33,25.0,26,4,57,25,39,16,68,Real Betis,38,Spain - La Liga
437,Rubén Duarte Sánchez,871,628,243,72.10103329506315,95,45,50,47.368421052631575,371,336,35,90.56603773584906,121,42,79,34.710743801652896,18.588597695244456,44,12,32,27.27272727272727,9,1,10,4,7,2,22,Espanyol,22,Spain - La Liga
438,Rubén García Santos,464,309,155,66.59482758620689,37,21,16,56.75675675675676,256,204,52,79.6875,61,25,36,40.98360655737705,16.984160564775518,25,6,19,24.0,21,0,50,28,28,13,29,Levante UD,22,Spain - La Liga
439,Rubén Gracia Calmache,417,298,119,71.46282973621103,50,24,26,48.0,258,211,47,81.78294573643412,40,16,24,40.0,16.88106519121036,11,2,9,18.181818181818183,8,0,31,14,18,10,11,RC Deportivo La Coruña,18,Spain - La Liga
440,Rubén Iván Martínez Andrade,413,228,185,55.205811138014525,53,17,36,32.075471698113205,76,76,0,100.0,283,104,179,36.74911660777385,46.3839776509354,0,0,0,0.0,0,0,0,0,0,0,1,Levante UD,15,Spain - La Liga
441,Rubén Pardo Gutiérrez,1185,900,285,75.9493670886076,186,116,70,62.365591397849464,636,598,38,94.0251572327044,248,108,140,43.54838709677419,21.448410425580757,56,19,37,33.92857142857143,39,7,22,8,9,4,9,Real Sociedad,28,Spain - La Liga
442,Rubén Rochina Naixes,1327,882,445,66.46571213262999,311,168,143,54.019292604501615,641,548,93,85.49141965678628,307,122,185,39.73941368078176,22.123503180167113,38,6,32,15.789473684210526,39,6,107,71,33,19,96,Granada,35,Spain - La Liga
443,Rubén Salvador Pérez Del Mármol,1404,1062,342,75.64102564102564,239,137,102,57.32217573221757,721,659,62,91.40083217753121,204,86,118,42.15686274509804,21.465693016633846,11,4,7,36.36363636363637,22,2,34,24,7,4,40,Granada,31,Spain - La Liga
444,Rúben Miguel Nunes Vezo,506,371,135,73.3201581027668,56,29,27,51.78571428571429,246,217,29,88.21138211382113,60,28,32,46.666666666666664,21.582663221926957,6,2,4,33.33333333333333,3,0,10,5,4,1,10,Valencia,15,Spain - La Liga
445,Răzvan Dincă Raț,572,403,169,70.45454545454545,94,44,50,46.808510638297875,219,197,22,89.95433789954338,104,39,65,37.5,20.435880064478603,36,13,23,36.11111111111111,13,0,8,5,3,2,3,Rayo Vallecano,10,Spain - La Liga
446,Sabin Merino Zuloaga,323,210,113,65.01547987616098,27,7,20,25.925925925925924,181,151,30,83.42541436464089,18,7,11,38.88888888888889,14.020948517904891,26,6,20,23.076923076923077,10,0,40,16,23,10,10,Athletic Club,22,Spain - La Liga
447,Salvador Ruiz Rodríguez,41,35,6,85.36585365853658,5,3,2,60.0,22,22,0,100.0,3,0,3,0.0,15.934466876487804,0,0,0,0.0,0,0,2,0,0,0,1,Granada,2,Spain - La Liga
448,Salvador Sevilla López,332,276,56,83.13253012048193,36,27,9,75.0,243,221,22,90.94650205761316,31,13,18,41.935483870967744,17.03967660448265,5,2,3,40.0,11,0,4,4,3,3,11,Espanyol,15,Spain - La Liga
449,Samuel Castillejo Azuaga,690,452,238,65.5072463768116,57,27,30,47.368421052631575,417,339,78,81.29496402877699,81,19,62,23.456790123456788,17.239881865607998,49,12,37,24.489795918367346,22,1,84,35,46,21,52,Villarreal,28,Spain - La Liga
450,Samuel García Sánchez,364,246,118,67.58241758241759,35,18,17,51.42857142857142,223,187,36,83.85650224215246,23,4,19,17.391304347826086,14.503982435007034,20,3,17,15.0,11,1,21,15,13,9,15,Villarreal,16,Spain - La Liga
451,Sandro Ramírez Castillo,91,72,19,79.12087912087912,8,7,1,87.5,63,56,7,88.88888888888889,4,1,3,25.0,13.110999530138903,6,0,6,0.0,4,1,8,2,5,1,7,Barcelona,10,Spain - La Liga
452,Santiago Mina Lorenzo,558,406,152,72.75985663082437,47,23,24,48.93617021276596,353,303,50,85.8356940509915,26,8,18,30.76923076923077,14.462433763137419,25,7,18,28.000000000000004,9,1,61,18,35,9,55,Valencia,26,Spain - La Liga
453,Santiago Vergini,927,770,157,83.06364617044228,89,38,51,42.69662921348314,514,497,17,96.69260700389106,146,62,84,42.465753424657535,22.22230833309825,0,0,0,0.0,1,0,15,10,2,1,7,Getafe,26,Spain - La Liga
454,Saúl Berjón Pérez,684,392,292,57.30994152046783,76,33,43,43.42105263157895,283,201,82,71.02473498233216,149,58,91,38.92617449664429,20.66523916607684,53,11,42,20.754716981132077,34,4,60,17,42,11,12,Eibar,29,Spain - La Liga
455,Saúl Ñíguez Esclapez,1144,878,266,76.74825174825175,150,101,49,67.33333333333333,702,625,77,89.03133903133903,65,25,40,38.46153846153847,14.733755633867474,27,7,20,25.925925925925924,18,2,61,27,20,6,32,Atlético Madrid,31,Spain - La Liga
456,Sebastián Carlos Cristóforo Pepe,812,698,114,85.96059113300493,90,62,28,68.88888888888889,565,529,36,93.6283185840708,55,28,27,50.90909090909091,17.055827109194187,4,1,3,25.0,3,1,19,14,5,3,55,Sevilla,21,Spain - La Liga
457,Sergi Darder Moll,40,34,6,85.0,11,9,2,81.81818181818183,26,23,3,88.46153846153845,6,4,2,66.66666666666666,19.41744165399,1,1,0,100.0,1,0,3,3,1,1,1,Málaga,1,Spain - La Liga
458,Sergi Gómez Solà,1542,1320,222,85.60311284046692,106,35,71,33.0188679245283,1036,1013,23,97.77992277992279,157,36,121,22.929936305732486,21.436471667145995,0,0,0,0.0,3,1,5,4,0,0,9,Celta Vigo,31,Spain - La Liga
459,Sergi Roberto Carnicer,1372,1196,176,87.17201166180757,105,80,25,76.19047619047619,978,919,59,93.96728016359918,49,24,25,48.97959183673469,15.035492355363498,33,9,24,27.27272727272727,12,5,45,31,23,15,26,Barcelona,31,Spain - La Liga
460,Sergi Samper Montaña,26,22,4,84.61538461538461,0,0,0,0.0,19,19,0,100.0,0,0,0,0.0,15.824785981126153,0,0,0,0.0,0,0,0,0,0,0,0,Barcelona,1,Spain - La Liga
461,Sergio Asenjo Andrés,105,60,45,57.14285714285714,9,2,7,22.22222222222222,19,19,0,100.0,80,37,43,46.25,47.259696276891425,0,0,0,0.0,0,0,0,0,0,0,0,Villarreal,4,Spain - La Liga
462,Sergio Busquets i Burgos,2406,2182,224,90.68994181213633,293,237,56,80.88737201365188,1637,1581,56,96.5791081246182,182,154,28,84.61538461538461,17.619963111482992,4,3,1,75.0,13,5,30,21,9,4,82,Barcelona,35,Spain - La Liga
463,Sergio Canales Madrazo,511,391,120,76.51663405088063,38,24,14,63.1578947368421,337,298,39,88.4272997032641,39,14,25,35.8974358974359,15.601901571157104,33,8,25,24.242424242424242,10,0,10,1,6,0,17,Real Sociedad,16,Spain - La Liga
464,Sergio Enrich Ametller,857,582,275,67.91131855309219,91,29,62,31.868131868131865,388,324,64,83.50515463917526,22,12,10,54.54545454545454,12.664088254711112,18,7,11,38.88888888888889,21,7,44,22,28,14,60,Eibar,38,Spain - La Liga
465,Sergio Escudero Palomo,658,476,182,72.3404255319149,72,40,32,55.55555555555556,333,292,41,87.68768768768768,75,30,45,40.0,17.495398798318174,43,13,30,30.23255813953488,16,0,22,14,13,8,23,Sevilla,15,Spain - La Liga
466,Sergio Ezequiel Araújo,524,380,144,72.51908396946564,50,21,29,42.0,306,259,47,84.640522875817,15,6,9,40.0,12.900757553188626,6,3,3,50.0,16,3,52,26,30,13,24,Las Palmas,30,Spain - La Liga
467,Sergio Gontán Gallardo,920,597,323,64.89130434782608,87,46,41,52.87356321839081,504,397,107,78.76984126984127,95,36,59,37.89473684210527,17.095856050767914,104,34,70,32.69230769230769,38,3,82,40,43,20,69,Eibar,29,Spain - La Liga
468,Sergio Mendigutxia Iglesias,8,5,3,62.5,1,0,1,0.0,1,1,0,100.0,0,0,0,0.0,9.91882565253,0,0,0,0.0,0,0,1,0,0,0,2,Sporting Gijón,1,Spain - La Liga
469,Sergio Ramos García,1299,1160,139,89.2994611239415,139,95,44,68.34532374100719,860,838,22,97.44186046511628,134,71,63,52.98507462686567,20.14589268738402,4,2,2,50.0,6,1,4,3,1,0,30,Real Madrid,23,Spain - La Liga
470,Sergio Rico González,1020,678,342,66.47058823529412,61,17,44,27.86885245901639,371,369,2,99.46091644204851,553,219,334,39.602169981916816,39.16493022358447,0,0,0,0.0,0,0,0,0,0,0,8,Sevilla,34,Spain - La Liga
471,Sergio Álvarez Conde,1001,584,417,58.341658341658345,101,24,77,23.762376237623762,300,299,1,99.66666666666667,610,202,408,33.114754098360656,42.619140043222295,0,0,0,0.0,0,0,0,0,0,0,1,Celta Vigo,31,Spain - La Liga
472,Sergio Álvarez Díaz,1100,832,268,75.63636363636364,143,75,68,52.44755244755245,646,587,59,90.86687306501547,96,33,63,34.375,18.19872637216527,9,3,6,33.33333333333333,13,2,33,25,6,3,39,Sporting Gijón,27,Spain - La Liga
473,Shkodran Mustafi,1489,1206,283,80.99395567494963,156,87,69,55.769230769230774,771,726,45,94.16342412451361,215,95,120,44.18604651162791,23.24317571693238,1,0,1,0.0,3,0,14,7,2,0,22,Valencia,30,Spain - La Liga
474,Sidnei Rechel da Silva Júnior,1272,986,286,77.51572327044025,194,88,106,45.36082474226804,589,547,42,92.86926994906621,219,83,136,37.89954337899543,24.271466699300376,3,0,3,0.0,5,0,23,15,2,1,23,RC Deportivo La Coruña,33,Spain - La Liga
475,Simone Verdi,84,66,18,78.57142857142857,13,10,3,76.92307692307693,43,37,6,86.04651162790698,9,4,5,44.44444444444444,15.484587498486857,4,0,4,0.0,5,0,11,5,7,2,10,Eibar,9,Spain - La Liga
476,Simão Mate,998,762,236,76.35270541082164,128,62,66,48.4375,508,482,26,94.88188976377953,107,38,69,35.51401869158878,19.505944265688576,0,0,0,0.0,3,0,14,9,1,1,38,Levante UD,30,Spain - La Liga
477,Sofiane Feghouli,573,359,214,62.652705061082024,71,35,36,49.29577464788733,298,250,48,83.89261744966443,75,25,50,33.33333333333333,18.12535538395602,63,18,45,28.57142857142857,28,1,41,14,21,4,24,Valencia,21,Spain - La Liga
478,Stefan Savić,393,306,87,77.86259541984732,40,14,26,35.0,193,187,6,96.89119170984456,70,21,49,30.0,23.576500085377095,1,0,1,0.0,0,0,1,1,0,0,5,Atlético Madrid,12,Spain - La Liga
479,Stefan Šćepović,492,341,151,69.3089430894309,46,13,33,28.26086956521739,271,221,50,81.54981549815497,17,11,6,64.70588235294117,12.166493845346341,10,4,6,40.0,20,1,19,7,10,3,43,Getafe,34,Spain - La Liga
480,Steven N''Kemboanza Mike Christopher Nzonzi,969,760,209,78.43137254901961,128,69,59,53.90625,596,563,33,94.46308724832215,79,33,46,41.77215189873418,18.46826106394031,13,5,8,38.46153846153847,9,1,17,11,4,2,17,Sevilla,28,Spain - La Liga
481,Stipe Pletikosa,61,31,30,50.81967213114754,5,0,5,0.0,7,7,0,100.0,45,17,28,37.77777777777778,46.95197775314754,0,0,0,0.0,0,0,0,0,0,0,0,RC Deportivo La Coruña,2,Spain - La Liga
482,Sérgio Paulo Barbosa Valente,730,446,284,61.09589041095891,144,78,66,54.166666666666664,386,310,76,80.31088082901555,137,34,103,24.817518248175183,20.042839104849865,45,9,36,20.0,35,1,46,26,15,5,48,Málaga,27,Spain - La Liga
483,Takashi Inui,565,387,178,68.49557522123894,53,27,26,50.943396226415096,364,294,70,80.76923076923077,67,19,48,28.35820895522388,16.42159131985147,44,14,30,31.818181818181817,20,3,45,28,34,19,22,Eibar,27,Spain - La Liga
484,Thievy Guivane Bifouma Koulossa,70,52,18,74.28571428571429,5,3,2,60.0,45,35,10,77.77777777777779,3,1,2,33.33333333333333,13.562930294310858,1,0,1,0.0,2,0,13,6,12,5,5,Granada,7,Spain - La Liga
485,Thomas Teye Partey,216,166,50,76.85185185185185,21,10,11,47.61904761904761,152,128,24,84.21052631578947,7,4,3,57.14285714285714,14.34077947434,9,3,6,33.33333333333333,6,1,16,12,5,5,6,Atlético Madrid,13,Spain - La Liga
486,Thomas Vermaelen,347,318,29,91.64265129682997,13,10,3,76.92307692307693,234,232,2,99.14529914529915,19,5,14,26.31578947368421,21.04971528795458,0,0,0,0.0,0,0,0,0,0,0,7,Barcelona,10,Spain - La Liga
487,Théo Bongonda Mbul''Ofeko Batombo,335,243,92,72.53731343283583,31,18,13,58.06451612903226,244,207,37,84.8360655737705,18,8,10,44.44444444444444,13.978041615312716,17,4,13,23.52941176470588,10,1,56,21,25,7,36,Celta Vigo,22,Spain - La Liga
488,Tiago Cardoso Mendes,775,654,121,84.38709677419355,101,71,30,70.29702970297029,485,459,26,94.63917525773195,72,47,25,65.27777777777779,17.55654486222658,1,0,1,0.0,4,2,1,0,0,0,19,Atlético Madrid,14,Spain - La Liga
489,Tiago Manuel Dias Correia,842,525,317,62.35154394299287,60,32,28,53.333333333333336,402,330,72,82.08955223880598,123,38,85,30.89430894308943,18.1797113616663,111,32,79,28.82882882882883,24,6,111,60,56,31,25,Rayo Vallecano,34,Spain - La Liga
490,Timothée Kolodziejczak,1262,1033,229,81.8541996830428,159,78,81,49.056603773584904,753,714,39,94.82071713147411,168,72,96,42.857142857142854,22.034680870968685,8,4,4,50.0,4,0,8,5,3,0,10,Sevilla,29,Spain - La Liga
491,Tomás Pina Isla,761,598,163,78.580814717477,93,55,38,59.13978494623656,475,426,49,89.6842105263158,42,21,21,50.0,16.715336289242522,2,1,1,50.0,6,1,6,6,1,1,32,Villarreal,27,Spain - La Liga
492,Toni Kroos,2552,2330,222,91.30094043887146,299,257,42,85.95317725752508,1747,1689,58,96.68002289639381,330,226,104,68.48484848484848,20.073679045986584,32,9,23,28.125,46,9,28,19,9,7,58,Real Madrid,32,Spain - La Liga
493,Uche Henry Agbo,105,88,17,83.80952380952381,8,5,3,62.5,79,69,10,87.34177215189874,4,1,3,25.0,16.250337305712,0,0,0,0.0,0,0,1,1,0,0,4,Granada,6,Spain - La Liga
494,Vicente Guaita Panadero,1153,609,544,52.818733738074584,185,36,149,19.45945945945946,232,232,0,100.0,786,252,534,32.06106870229007,47.46903587530002,0,0,0,0.0,2,0,1,1,0,0,4,Getafe,38,Spain - La Liga
495,Vicente Iborra De La Fuente,650,442,208,68.0,86,34,52,39.53488372093023,303,262,41,86.46864686468648,35,18,17,51.42857142857142,15.887640760807017,13,4,9,30.76923076923077,11,2,11,6,2,1,28,Sevilla,29,Spain - La Liga
496,Vincenzo Renato Rennella,59,35,24,59.32203389830508,10,2,8,20.0,25,22,3,88.0,2,1,1,50.0,13.6942792866061,3,1,2,33.33333333333333,3,0,6,2,3,1,5,Real Betis,6,Spain - La Liga
497,Víctor Camarasa Ferrando,1098,917,181,83.51548269581056,118,86,32,72.88135593220339,730,686,44,93.97260273972603,76,44,32,57.89473684210527,16.70481148494164,13,5,8,38.46153846153847,18,3,48,25,22,10,32,Levante UD,34,Spain - La Liga
498,Víctor Casadesús Castaño,387,262,125,67.70025839793283,53,27,26,50.943396226415096,201,163,38,81.09452736318407,19,14,5,73.68421052631578,14.674516967250232,7,0,7,0.0,11,1,19,15,12,8,16,Levante UD,23,Spain - La Liga
499,Víctor Guillermo Álvarez Delgado,757,510,247,67.37120211360634,110,63,47,57.27272727272727,381,321,60,84.25196850393701,88,27,61,30.681818181818183,17.420246514048507,28,7,21,25.0,12,2,54,26,14,7,34,Espanyol,27,Spain - La Liga
500,Víctor Machín Pérez,816,592,224,72.54901960784314,54,33,21,61.111111111111114,582,465,117,79.89690721649485,28,10,18,35.714285714285715,14.036138159528912,43,14,29,32.55813953488372,33,4,82,40,49,24,70,Sevilla,28,Spain - La Liga
501,Víctor Rodríguez Romero,1042,863,179,82.82149712092131,74,56,18,75.67567567567568,742,672,70,90.56603773584906,39,13,26,33.33333333333333,14.36374455380361,25,8,17,32.0,21,1,67,34,45,23,43,Getafe,33,Spain - La Liga
502,Víctor Ruíz Torre,1570,1256,314,80.0,212,82,130,38.67924528301887,880,834,46,94.77272727272728,219,69,150,31.506849315068493,23.37523605111889,1,0,1,0.0,0,0,7,6,1,1,15,Villarreal,35,Spain - La Liga
503,Víctor Sánchez Mata,1034,788,246,76.20889748549324,140,68,72,48.57142857142857,635,565,70,88.9763779527559,110,41,69,37.27272727272727,17.33735032283002,18,4,14,22.22222222222222,17,5,34,27,15,9,45,Espanyol,29,Spain - La Liga
504,Wanderson Maciel Sousa Campos,262,193,69,73.66412213740458,18,12,6,66.66666666666666,180,161,19,89.44444444444444,21,5,16,23.809523809523807,15.080846555008856,20,5,15,25.0,7,0,47,31,20,13,22,Getafe,20,Spain - La Liga
505,Weligton Róbson Pena de Oliveira,1191,862,329,72.37615449202352,190,71,119,37.368421052631575,531,507,24,95.48022598870057,269,92,177,34.20074349442379,24.23470101608282,3,1,2,33.33333333333333,4,2,4,2,0,0,26,Málaga,30,Spain - La Liga
506,Wilfried Aimeric Zahibo,62,45,17,72.58064516129032,5,4,1,80.0,36,32,4,88.88888888888889,4,2,2,50.0,15.033489324015484,0,0,0,0.0,1,0,1,0,1,0,1,Valencia,2,Spain - La Liga
507,Willian José da Silva,550,406,144,73.81818181818181,51,24,27,47.05882352941176,324,279,45,86.11111111111111,39,21,18,53.84615384615385,15.23658149088349,14,3,11,21.428571428571427,20,1,39,26,18,11,36,Las Palmas,30,Spain - La Liga
508,Xabier Etxeita Gorritxategi,1193,944,249,79.12824811399832,121,45,76,37.1900826446281,659,617,42,93.62670713201821,180,66,114,36.666666666666664,21.824406654492673,1,0,1,0.0,4,1,6,6,0,0,7,Athletic Club,30,Spain - La Liga
509,Xabier Iruretagoiena Aranzamendi,112,53,59,47.32142857142857,29,7,22,24.137931034482758,9,9,0,100.0,89,31,58,34.831460674157306,53.09666982970714,0,0,0,0.0,0,0,0,0,0,0,0,Eibar,4,Spain - La Liga
510,Xabier Prieto Argarate,1284,969,315,75.46728971962617,156,102,54,65.38461538461539,711,628,83,88.32630098452883,88,45,43,51.13636363636363,15.243977811485607,62,21,41,33.87096774193548,32,3,40,21,20,6,66,Real Sociedad,36,Spain - La Liga
511,Xavier Torres Buigues,316,244,72,77.21518987341773,36,18,18,50.0,176,165,11,93.75,32,14,18,43.75,20.483092523410633,2,0,2,0.0,3,0,2,2,1,1,12,Real Betis,12,Spain - La Liga
512,Yannick Ferreira Carrasco,812,617,195,75.98522167487684,43,28,15,65.11627906976744,587,510,77,86.88245315161839,51,13,38,25.49019607843137,13.902372399676256,44,7,37,15.909090909090908,19,1,116,67,71,40,32,Atlético Madrid,29,Spain - La Liga
513,Yevhen Konoplyanka,725,483,242,66.62068965517241,39,26,13,66.66666666666666,386,332,54,86.01036269430051,121,42,79,34.710743801652896,17.110600848639557,106,27,79,25.471698113207548,35,4,75,42,48,27,30,Sevilla,32,Spain - La Liga
514,Yoel Rodríguez Oterino,354,227,127,64.12429378531074,31,7,24,22.58064516129032,119,118,1,99.15966386554622,176,57,119,32.38636363636363,40.72949602580949,0,0,0,0.0,1,0,0,0,0,0,2,Rayo Vallecano,10,Spain - La Liga
515,Youssef El-Arabi,643,432,211,67.18506998444789,93,43,50,46.236559139784944,342,279,63,81.57894736842105,41,19,22,46.34146341463415,15.388784343494818,19,9,10,47.368421052631575,21,1,64,37,32,18,54,Granada,35,Spain - La Liga
516,Yuri Berchiche Izeta,1189,889,300,74.76871320437343,147,103,44,70.06802721088435,554,476,78,85.92057761732852,98,34,64,34.69387755102041,16.799177044633232,73,15,58,20.54794520547945,13,4,28,13,12,4,26,Real Sociedad,21,Spain - La Liga
517,Zakaria Bakkali,228,160,68,70.17543859649122,13,8,5,61.53846153846154,131,113,18,86.25954198473282,32,9,23,28.125,16.69142429017263,30,8,22,26.666666666666668,9,3,31,19,17,11,19,Valencia,16,Spain - La Liga
518,Zouhair Feddal,1137,848,289,74.58223394898856,186,81,105,43.54838709677419,471,447,24,94.90445859872611,279,115,164,41.21863799283154,25.52894401588781,0,0,0,0.0,5,1,9,9,1,1,16,Levante UD,28,Spain - La Liga
519,Álvaro Arbeloa Coca,168,141,27,83.92857142857143,11,8,3,72.72727272727273,102,95,7,93.13725490196079,5,3,2,60.0,14.036854452814286,2,0,2,0.0,1,0,1,1,0,0,1,Real Madrid,6,Spain - La Liga
520,Álvaro Cejudo Carmona,784,526,258,67.09183673469387,83,36,47,43.373493975903614,426,356,70,83.56807511737088,121,35,86,28.92561983471074,17.433277846786837,49,11,38,22.448979591836736,21,2,78,38,32,15,49,Real Betis,30,Spain - La Liga
521,Álvaro Daniel Pereira Barragán,189,123,66,65.07936507936508,33,15,18,45.45454545454545,67,57,10,85.07462686567165,40,15,25,37.5,20.718673832838096,5,3,2,60.0,3,0,2,0,2,0,1,Getafe,6,Spain - La Liga
522,Álvaro González Soberón,1528,1139,389,74.54188481675392,284,131,153,46.12676056338028,706,667,39,94.47592067988668,328,122,206,37.19512195121951,24.285435082411098,12,4,8,33.33333333333333,10,1,11,9,0,0,35,Espanyol,36,Spain - La Liga
523,Álvaro Medrán Just,614,502,112,81.75895765472313,106,66,40,62.264150943396224,375,349,26,93.06666666666666,64,30,34,46.875,19.55349253805746,2,0,2,0.0,7,1,30,16,7,3,29,Getafe,20,Spain - La Liga
524,Álvaro Negredo Sánchez,357,233,124,65.26610644257703,49,21,28,42.857142857142854,142,110,32,77.46478873239437,16,11,5,68.75,13.91013558191395,4,1,3,25.0,12,2,23,13,13,7,17,Valencia,25,Spain - La Liga
525,Álvaro Vadillo Cifuentes,36,32,4,88.88888888888889,1,1,0,100.0,28,27,1,96.42857142857143,0,0,0,0.0,13.10555328084,2,1,1,50.0,2,0,4,2,3,1,3,Real Betis,3,Spain - La Liga
526,Álvaro Vázquez García,415,280,135,67.46987951807229,26,7,19,26.923076923076923,259,206,53,79.53667953667953,19,8,11,42.10526315789473,13.519911609109302,24,12,12,50.0,20,4,37,13,19,6,34,Getafe,34,Spain - La Liga
527,Ángel Domingo López Ruano,28,25,3,89.28571428571429,2,2,0,100.0,18,16,2,88.88888888888889,2,2,0,100.0,17.431858742657145,0,0,0,0.0,0,0,0,0,0,0,0,Las Palmas,3,Spain - La Liga
528,Ángel Lafita Castillo,276,177,99,64.13043478260869,38,21,17,55.26315789473685,151,124,27,82.11920529801324,25,7,18,28.000000000000004,14.44106198904,15,4,11,26.666666666666668,7,2,40,16,20,6,24,Getafe,14,Spain - La Liga
529,Ángel Martín Correa,354,236,118,66.66666666666666,37,16,21,43.24324324324324,233,177,56,75.9656652360515,24,11,13,45.83333333333333,15.17443109233627,14,4,10,28.57142857142857,14,3,65,32,48,23,31,Atlético Madrid,26,Spain - La Liga
530,Ángel Montoro Sánchez,325,274,51,84.3076923076923,33,22,11,66.66666666666666,216,198,18,91.66666666666666,38,24,14,63.1578947368421,19.369051629166524,6,2,4,33.33333333333333,6,0,4,2,1,1,7,Las Palmas,9,Spain - La Liga
531,Ángel Trujillo Canorea,190,146,44,76.84210526315789,24,8,16,33.33333333333333,107,105,2,98.13084112149532,24,7,17,29.166666666666668,21.120851842673684,0,0,0,0.0,0,0,1,1,1,1,2,Levante UD,8,Spain - La Liga
532,Éver Maximiliano David Banega,1258,964,294,76.6295707472178,222,142,80,63.96396396396396,737,664,73,90.09497964721845,194,82,112,42.2680412371134,20.600624737805724,44,11,33,25.0,38,2,100,69,42,25,63,Sevilla,25,Spain - La Liga
533,Íñigo Lekue Martínez,594,441,153,74.24242424242425,32,20,12,62.5,317,282,35,88.95899053627761,60,19,41,31.666666666666664,16.37367460320606,43,14,29,32.55813953488372,11,0,46,18,23,8,10,Athletic Club,20,Spain - La Liga
534,Íñigo Martínez Berridi,1453,1135,318,78.11424638678595,236,123,113,52.118644067796616,772,737,35,95.46632124352331,228,72,156,31.57894736842105,22.912042161159476,1,0,1,0.0,2,0,17,12,3,0,27,Real Sociedad,30,Spain - La Liga
535,Óliver Torres Muñoz,511,414,97,81.01761252446184,66,48,18,72.72727272727273,347,304,43,87.60806916426513,36,18,18,50.0,15.683617902039922,8,3,5,37.5,13,2,21,16,10,7,17,Atlético Madrid,21,Spain - La Liga
536,Óscar Esau Duarte Gaitán,468,349,119,74.57264957264957,66,30,36,45.45454545454545,215,209,6,97.20930232558139,90,36,54,40.0,21.988547578667692,1,0,1,0.0,1,1,2,2,0,0,5,Espanyol,14,Spain - La Liga
537,Óscar de Marcos Arana,1618,1180,438,72.92954264524104,185,98,87,52.972972972972975,714,592,122,82.91316526610645,173,63,110,36.41618497109826,17.81428423505776,80,26,54,32.5,16,3,64,27,36,14,23,Athletic Club,34,Spain - La Liga
