index,player,total_passes,total_completed,total_uncompleted,total_percentage%,f3_passes,f3_completed,f3_uncompleted,f3_percentage%,short_passes,short_completed,short_uncompleted,short_percentage%,long_passes,long_completed,long_uncompleted,long_percentage%,average_pass_length,crosses,crosses_completed,crosses_uncompleted,crosses_percentage%,total_shot_assists,total_goal_assists,dribbles,dribbles_completed,dribbles_f3,dribbles_f3_completed,fouls_won,team,MP,competition
0,Aaron Cresswell,1874,1402,472,74.81323372465314,318,173,145,54.40251572327044,882,797,85,90.36281179138322,287,111,176,38.67595818815331,20.253735302741173,93,28,65,30.107526881720432,41,4,34,16,23,9,35,West Ham United,37,England - Premier League
1,Aaron Lennon,516,402,114,77.90697674418605,49,33,16,67.3469387755102,370,316,54,85.4054054054054,18,6,12,33.33333333333333,14.838133792493023,26,8,18,30.76923076923077,21,0,39,19,29,15,26,Everton,25,England - Premier League
2,Aaron Ramsey,2197,1855,342,84.43331816112881,285,203,82,71.2280701754386,1590,1460,130,91.82389937106919,123,56,67,45.52845528455284,16.78014398320681,35,11,24,31.428571428571427,34,4,68,41,28,18,57,Arsenal,31,England - Premier League
3,Abdul Rahman Baba,651,524,127,80.4915514592934,48,32,16,66.66666666666666,402,366,36,91.04477611940298,33,10,23,30.303030303030305,15.429506533826542,23,5,18,21.73913043478261,2,1,13,9,7,6,6,Chelsea,15,England - Premier League
4,Adam David Lallana,1046,817,229,78.10707456978967,87,56,31,64.36781609195403,722,632,90,87.53462603878116,59,19,40,32.20338983050847,13.908006121696657,43,8,35,18.6046511627907,44,7,73,43,36,18,36,Liverpool,30,England - Premier League
5,Adam Federici,130,97,33,74.61538461538461,4,0,4,0.0,52,52,0,100.0,64,32,32,50.0,36.738468619709536,0,0,0,0.0,0,0,0,0,0,0,0,AFC Bournemouth,6,England - Premier League
6,Adam Johnson,600,443,157,73.83333333333333,128,78,50,60.9375,321,282,39,87.85046728971963,136,63,73,46.32352941176471,22.8431581993428,22,8,14,36.36363636363637,25,5,24,14,8,4,16,Sunderland,19,England - Premier League
7,Adam Matthews,19,16,3,84.21052631578947,3,3,0,100.0,7,6,1,85.71428571428571,4,4,0,100.0,24.076071499111578,1,1,0,100.0,0,0,2,0,1,0,0,Sunderland,1,England - Premier League
8,Adam Smith,1274,1045,229,82.02511773940346,98,62,36,63.26530612244898,698,651,47,93.26647564469914,88,40,48,45.45454545454545,15.64634026459102,43,12,31,27.906976744186046,14,0,56,35,22,10,55,AFC Bournemouth,31,England - Premier League
9,Adama Traoré Diarra,53,27,26,50.943396226415096,5,2,3,40.0,28,19,9,67.85714285714286,7,2,5,28.57142857142857,19.95387583109434,17,2,15,11.76470588235294,0,1,34,21,18,9,13,Aston Villa,10,England - Premier League
10,Adlène Guédioura,298,187,111,62.751677852349,54,21,33,38.88888888888889,139,120,19,86.33093525179856,65,18,47,27.692307692307693,20.678082134470067,19,1,18,5.263157894736842,10,2,25,15,10,6,7,Watford,15,England - Premier League
11,Adnan Januzaj,45,36,9,80.0,6,3,3,50.0,31,24,7,77.41935483870968,5,5,0,100.0,16.964883812608,0,0,0,0.0,0,0,10,5,8,3,6,Manchester United,5,England - Premier League
12,Adrian Mariappa,131,105,26,80.1526717557252,9,4,5,44.44444444444444,73,67,6,91.78082191780823,20,10,10,50.0,20.054296646596033,2,1,1,50.0,0,0,3,2,0,0,3,Crystal Palace,3,England - Premier League
13,Adrián San Miguel del Castillo,998,556,442,55.71142284569138,158,41,117,25.949367088607595,197,196,1,99.49238578680203,671,238,433,35.46944858420268,46.75985395913219,0,0,0,0.0,0,0,1,1,0,0,2,West Ham United,32,England - Premier League
14,Alan Hutton,1232,876,356,71.1038961038961,166,79,87,47.59036144578313,538,492,46,91.44981412639405,164,63,101,38.41463414634146,18.55826022327779,87,21,66,24.137931034482758,23,1,24,11,11,4,38,Aston Villa,28,England - Premier League
15,Alberto Moreno Pérez,1743,1364,379,78.25588066551921,179,108,71,60.33519553072626,857,801,56,93.46557759626604,223,95,128,42.600896860986545,18.800825500148985,107,31,76,28.971962616822427,54,4,44,23,25,13,23,Liverpool,32,England - Premier League
16,Alberto Paloschi,202,145,57,71.78217821782178,19,8,11,42.10526315789473,109,91,18,83.4862385321101,10,4,6,40.0,13.194933903563168,5,2,3,40.0,5,0,9,1,6,0,8,Swansea City,10,England - Premier League
17,Aleksandar Kolarov,1774,1339,435,75.47914317925591,213,123,90,57.74647887323944,1012,899,113,88.83399209486166,234,74,160,31.62393162393162,18.883090808809165,91,23,68,25.274725274725274,35,3,43,21,26,7,32,Manchester City,29,England - Premier League
18,Aleksandar Mitrović,714,519,195,72.68907563025209,49,20,29,40.816326530612244,368,318,50,86.41304347826086,13,6,7,46.15384615384615,11.686442666632233,6,1,5,16.666666666666664,22,4,35,18,26,13,59,Newcastle United,34,England - Premier League
19,Alessandro Diamanti,55,36,19,65.45454545454545,7,5,2,71.42857142857143,26,20,6,76.92307692307693,11,7,4,63.63636363636363,21.167270567214544,5,0,5,0.0,1,0,2,2,0,0,2,Watford,3,England - Premier League
20,Alex Iwobi,376,315,61,83.77659574468085,31,25,6,80.64516129032258,295,267,28,90.5084745762712,12,5,7,41.66666666666667,14.900225703815106,8,1,7,12.5,10,2,19,12,10,5,5,Arsenal,12,England - Premier League
21,Alex McCarthy,220,98,122,44.54545454545455,67,23,44,34.32835820895522,20,19,1,95.0,182,65,117,35.714285714285715,54.831251441487275,0,0,0,0.0,0,0,0,0,0,0,1,Crystal Palace,7,England - Premier League
22,Alex Oxlade-Chamberlain,495,378,117,76.36363636363637,48,33,15,68.75,299,262,37,87.62541806020067,43,23,20,53.48837209302325,17.941027139371634,31,9,22,29.03225806451613,17,0,50,36,25,17,16,Arsenal,22,England - Premier League
23,Alex Pritchard,32,24,8,75.0,4,3,1,75.0,17,16,1,94.11764705882352,1,0,1,0.0,13.962061811025,0,0,0,0.0,0,0,6,3,2,1,2,West Bromwich Albion,3,England - Premier League
24,Alexander Banor Tettey,1097,920,177,83.86508659981769,120,68,52,56.666666666666664,674,624,50,92.58160237388724,69,33,36,47.82608695652174,17.432891082853892,1,0,1,0.0,6,0,24,19,5,5,11,Norwich City,23,England - Premier League
25,Alexandre Dimitri Song-Billong,463,386,77,83.36933045356372,67,48,19,71.64179104477611,311,280,31,90.03215434083602,27,12,15,44.44444444444444,17.620280847716113,3,1,2,33.33333333333333,8,0,14,10,3,3,11,West Ham United,12,England - Premier League
26,Alexandre Rodrigues da Silva,26,23,3,88.46153846153845,2,2,0,100.0,18,18,0,100.0,1,1,0,100.0,15.714094287932308,0,0,0,0.0,0,0,2,0,1,0,4,Chelsea,2,England - Premier League
27,Alexis Alejandro Sánchez Sánchez,1488,1141,347,76.68010752688173,143,93,50,65.03496503496503,975,823,152,84.41025641025641,134,78,56,58.2089552238806,16.53709249964661,55,22,33,40.0,53,4,165,103,96,59,79,Arsenal,30,England - Premier League
28,Allan Romeo Nyom,1228,803,425,65.39087947882736,191,74,117,38.7434554973822,453,421,32,92.93598233995584,241,60,181,24.896265560165975,19.727895733777817,58,9,49,15.517241379310345,7,1,36,22,15,7,28,Watford,32,England - Premier League
29,Almen Abdi,1020,814,206,79.80392156862746,84,51,33,60.71428571428571,620,567,53,91.45161290322581,90,37,53,41.11111111111111,15.748118041001648,25,11,14,44.0,30,0,21,15,10,8,27,Watford,32,England - Premier League
30,Aly Cissokho,934,657,277,70.34261241970022,95,46,49,48.421052631578945,428,384,44,89.7196261682243,130,39,91,30.0,17.963633235716404,65,15,50,23.076923076923077,9,0,11,6,2,2,6,Aston Villa,18,England - Premier League
31,Ander Herrera Agüera,1122,919,203,81.90730837789661,122,79,43,64.75409836065575,757,692,65,91.41347424042272,66,25,41,37.878787878787875,16.42544690096214,22,8,14,36.36363636363637,20,2,35,21,15,10,29,Manchester United,27,England - Premier League
32,Andre Green,32,19,13,59.375,2,1,1,50.0,20,13,7,65.0,7,3,4,42.857142857142854,19.069760742165,6,2,4,33.33333333333333,2,0,6,3,2,1,0,Aston Villa,2,England - Premier League
33,Andre Wisdom,447,319,128,71.36465324384787,63,36,27,57.14285714285714,215,189,26,87.90697674418605,38,12,26,31.57894736842105,17.080137847504428,14,4,10,28.57142857142857,5,0,7,5,3,3,5,Norwich City,10,England - Premier League
34,Andreas Hoelgebaum Pereira,65,48,17,73.84615384615385,10,6,4,60.0,37,34,3,91.8918918918919,11,3,8,27.27272727272727,19.724244830363077,4,0,4,0.0,3,0,4,3,2,2,2,Manchester United,4,England - Premier League
35,Andrej Kramarić,15,11,4,73.33333333333333,0,0,0,0.0,11,9,2,81.81818181818183,0,0,0,0.0,13.259909587824,1,0,1,0.0,1,1,0,0,0,0,0,Leicester City,2,England - Premier League
36,Andrew Philip King,488,375,113,76.84426229508196,78,44,34,56.41025641025641,255,231,24,90.58823529411765,47,23,24,48.93617021276596,17.215867177477378,7,1,6,14.285714285714285,8,1,10,5,5,2,9,Leicester City,25,England - Premier League
37,Andrew Surman,2309,1970,339,85.31831961888263,325,226,99,69.53846153846153,1321,1245,76,94.24678274034822,216,123,93,56.94444444444444,19.7435758137072,7,3,4,42.857142857142854,42,3,26,17,7,4,22,AFC Bournemouth,38,England - Premier League
38,Andros Townsend,481,334,147,69.43866943866944,36,20,16,55.55555555555556,297,256,41,86.19528619528619,54,13,41,24.074074074074073,15.394840598171976,47,14,33,29.78723404255319,28,2,73,46,51,32,16,Tottenham Hotspur,16,England - Premier League
39,André Ayew Pelé,1098,882,216,80.32786885245902,104,54,50,51.92307692307693,701,648,53,92.43937232524965,39,16,23,41.02564102564102,14.237868738194754,15,2,13,13.333333333333334,17,2,83,41,36,16,81,Swansea City,34,England - Premier League
40,Andy Carroll,433,266,167,61.43187066974596,61,27,34,44.26229508196721,150,130,20,86.66666666666667,24,8,16,33.33333333333333,14.06194722163372,8,1,7,12.5,14,1,22,10,10,5,29,West Ham United,27,England - Premier League
41,Angelo Obinze Ogbonna,954,759,195,79.55974842767296,100,50,50,50.0,548,533,15,97.26277372262774,130,49,81,37.69230769230769,20.914057316443017,0,0,0,0.0,2,0,9,6,1,0,17,West Ham United,27,England - Premier League
42,Anthony Martial,938,713,225,76.01279317697228,55,30,25,54.54545454545454,692,586,106,84.6820809248555,16,8,8,50.0,13.310066513513858,47,18,29,38.297872340425535,32,3,136,73,97,52,64,Manchester United,31,England - Premier League
43,Arouna Koné,592,495,97,83.61486486486487,48,30,18,62.5,450,406,44,90.22222222222223,8,4,4,50.0,13.48127778060973,9,4,5,44.44444444444444,9,3,57,33,16,8,18,Everton,25,England - Premier League
44,Artur Boruc,913,576,337,63.088718510405265,115,28,87,24.347826086956523,286,285,1,99.65034965034964,483,154,329,31.88405797101449,41.34860619374168,0,0,0,0.0,2,0,1,1,0,0,2,AFC Bournemouth,32,England - Premier League
45,Ashley Westwood,1626,1302,324,80.07380073800738,247,171,76,69.23076923076923,960,887,73,92.39583333333333,234,108,126,46.15384615384615,20.848407597158083,28,4,24,14.285714285714285,40,2,27,16,10,6,16,Aston Villa,32,England - Premier League
46,Ashley Williams,1884,1600,284,84.92569002123143,189,106,83,56.08465608465608,1063,1020,43,95.95484477892757,213,91,122,42.72300469483568,22.998305511154012,2,0,2,0.0,10,1,6,5,2,2,15,Swansea City,36,England - Premier League
47,Ashley Young,776,571,205,73.58247422680412,90,51,39,56.666666666666664,363,317,46,87.32782369146005,90,30,60,33.33333333333333,18.244059534107627,60,12,48,20.0,8,2,38,14,27,8,20,Manchester United,18,England - Premier League
48,Asmir Begović,410,226,184,55.1219512195122,68,13,55,19.11764705882353,114,113,1,99.12280701754386,248,68,180,27.419354838709676,44.874002047277855,0,0,0,0.0,0,0,0,0,0,0,4,Chelsea,17,England - Premier League
49,Ayoze Pérez Gutiérrez,658,463,195,70.36474164133737,68,43,25,63.23529411764706,414,345,69,83.33333333333334,73,25,48,34.24657534246575,15.995096294869422,34,13,21,38.23529411764706,26,2,108,58,52,20,52,Newcastle United,34,England - Premier League
50,Bacary Sagna,1984,1624,360,81.85483870967742,249,160,89,64.2570281124498,1165,1094,71,93.90557939914163,123,50,73,40.65040650406504,15.717920350380604,57,22,35,38.59649122807017,27,3,17,9,8,4,16,Manchester City,28,England - Premier League
51,Bafétimbi Gomis,499,398,101,79.75951903807615,27,14,13,51.85185185185185,311,273,38,87.78135048231512,20,16,4,80.0,13.648470605285771,6,3,3,50.0,14,0,47,32,20,12,26,Swansea City,33,England - Premier League
52,Bakary Sako,423,293,130,69.26713947990544,36,21,15,58.333333333333336,225,195,30,86.66666666666667,59,16,43,27.11864406779661,18.762409953636595,29,6,23,20.689655172413794,8,1,41,21,24,14,11,Crystal Palace,19,England - Premier League
53,Bamidele Alli,1094,810,284,74.04021937842778,138,92,46,66.66666666666666,710,611,99,86.05633802816901,48,13,35,27.083333333333332,15.29671408924357,17,4,13,23.52941176470588,47,8,106,42,66,22,75,Tottenham Hotspur,33,England - Premier League
54,Bastian Schweinsteiger,1086,924,162,85.0828729281768,165,119,46,72.12121212121212,737,694,43,94.16553595658074,87,43,44,49.42528735632184,18.03084365291801,7,2,5,28.57142857142857,9,0,23,17,9,5,24,Manchester United,18,England - Premier League
55,Ben Davies,890,670,220,75.28089887640449,101,59,42,58.415841584158414,407,371,36,91.15479115479116,90,28,62,31.11111111111111,17.872941392961167,28,11,17,39.285714285714285,14,2,10,6,5,3,10,Tottenham Hotspur,17,England - Premier League
56,Ben Foster,408,202,206,49.50980392156863,107,36,71,33.64485981308411,41,41,0,100.0,342,136,206,39.76608187134503,55.044993998452945,0,0,0,0.0,0,0,0,0,0,0,0,West Bromwich Albion,15,England - Premier League
57,Ben Watson,1599,1186,413,74.17135709818636,246,122,124,49.59349593495935,802,752,50,93.76558603491272,284,104,180,36.61971830985916,20.48090927847931,31,7,24,22.58064516129032,35,0,17,12,3,2,17,Watford,35,England - Premier League
58,Benik Afobe,224,189,35,84.375,11,7,4,63.63636363636363,153,146,7,95.42483660130719,2,1,1,50.0,12.123101447668928,2,1,1,50.0,11,0,20,8,11,1,11,AFC Bournemouth,15,England - Premier League
59,Bersant Celina,15,13,2,86.66666666666667,1,1,0,100.0,10,10,0,100.0,2,2,0,100.0,15.894888074016,1,1,0,100.0,1,1,0,0,0,0,0,Manchester City,1,England - Premier League
60,Bertrand Isidore Traoré,137,115,22,83.94160583941606,11,9,2,81.81818181818183,95,88,7,92.63157894736842,3,0,3,0.0,14.77467757146219,4,1,3,25.0,4,1,13,10,12,9,5,Chelsea,10,England - Premier League
61,Billy Jones,847,588,259,69.42148760330579,111,49,62,44.14414414414414,303,265,38,87.45874587458746,92,27,65,29.347826086956523,17.357203351437448,18,4,14,22.22222222222222,10,0,17,12,10,7,15,Sunderland,24,England - Premier League
62,Bojan Krkíc Pérez,758,609,149,80.34300791556728,84,62,22,73.80952380952381,550,486,64,88.36363636363636,53,25,28,47.16981132075472,16.83265510786702,19,3,16,15.789473684210526,26,1,88,44,44,24,35,Stoke City,27,England - Premier League
63,Bradley Guzan,840,486,354,57.85714285714286,110,31,79,28.18181818181818,147,146,1,99.31972789115646,599,253,346,42.23706176961603,47.56934712099429,0,0,0,0.0,1,0,0,0,0,0,3,Aston Villa,28,England - Premier League
64,Bradley Johnson,77,55,22,71.42857142857143,12,6,6,50.0,40,34,6,85.0,5,2,3,40.0,16.293878485742336,2,1,1,50.0,3,1,5,3,2,1,3,Norwich City,4,England - Premier League
65,Bradley Shaun Smith,170,132,38,77.64705882352942,12,7,5,58.333333333333336,86,72,14,83.72093023255815,5,4,1,80.0,16.44281185641035,10,4,6,40.0,2,0,8,2,6,2,4,Liverpool,4,England - Premier League
66,Branislav Ivanović,1569,1276,293,81.32568514977693,152,83,69,54.60526315789473,866,807,59,93.18706697459585,152,61,91,40.131578947368425,18.644274553132544,38,13,25,34.21052631578947,12,2,18,9,11,4,24,Chelsea,33,England - Premier League
67,Brede Hangeland,265,217,48,81.88679245283019,27,9,18,33.33333333333333,141,139,2,98.58156028368793,26,11,15,42.30769230769231,21.120528389882264,0,0,0,0.0,0,0,3,3,0,0,3,Crystal Palace,7,England - Premier League
68,Brendan Joel Zibusiso Galloway,527,424,103,80.45540796963947,32,20,12,62.5,321,291,30,90.65420560747664,25,6,19,24.0,14.406258733254647,6,2,4,33.33333333333333,4,1,14,3,7,0,30,Everton,15,England - Premier League
69,Bryan Oviedo,571,437,134,76.5323992994746,46,30,16,65.21739130434783,320,287,33,89.6875,61,19,42,31.147540983606557,17.468524688080983,21,4,17,19.047619047619047,11,1,13,6,4,2,14,Everton,14,England - Premier League
70,Callum Connolly,13,9,4,69.23076923076923,0,0,0,0.0,8,7,1,87.5,0,0,0,0.0,18.241019429261538,2,0,2,0.0,0,0,0,0,0,0,0,Everton,1,England - Premier League
71,Callum McManaman,99,72,27,72.72727272727273,4,4,0,100.0,69,62,7,89.85507246376811,8,0,8,0.0,16.050149389003636,11,3,8,27.27272727272727,7,1,17,12,8,7,10,West Bromwich Albion,12,England - Premier League
72,Callum Wilson,143,104,39,72.72727272727273,8,3,5,37.5,98,75,23,76.53061224489795,1,0,1,0.0,12.039148782392726,4,2,2,50.0,8,0,33,11,20,5,18,AFC Bournemouth,13,England - Premier League
73,Calum Chambers,190,165,25,86.8421052631579,14,8,6,57.14285714285714,128,120,8,93.75,10,4,6,40.0,18.257693947434948,1,0,1,0.0,2,0,11,8,1,1,3,Arsenal,12,England - Premier League
74,Cameron Borthwick-Jackson,484,378,106,78.099173553719,49,35,14,71.42857142857143,263,234,29,88.97338403041825,37,14,23,37.83783783783784,16.700319462824627,20,5,15,25.0,6,1,7,5,6,4,3,Manchester United,10,England - Premier League
75,Cameron Brannagan,126,115,11,91.26984126984127,10,6,4,60.0,91,89,2,97.8021978021978,9,3,6,33.33333333333333,18.70583039624,4,1,3,25.0,1,0,4,2,4,2,0,Liverpool,3,England - Premier League
76,Cameron Jerome,434,269,165,61.9815668202765,38,13,25,34.21052631578947,190,160,30,84.21052631578947,12,5,7,41.66666666666667,12.387419364477235,13,3,10,23.076923076923077,6,2,39,15,28,10,11,Norwich City,34,England - Premier League
77,Carl Jenkinson,706,517,189,73.22946175637394,75,37,38,49.333333333333336,329,299,30,90.88145896656535,80,19,61,23.75,18.979007661997393,23,8,15,34.78260869565217,6,0,14,4,8,1,5,West Ham United,20,England - Premier League
78,Carles Gil de Pareja Vicent,809,655,154,80.96415327564895,65,50,15,76.92307692307693,558,502,56,89.96415770609319,71,24,47,33.80281690140845,16.86782196876638,33,8,25,24.242424242424242,22,1,63,37,26,14,31,Aston Villa,23,England - Premier League
79,Carlos Alberto Sánchez Moreno,795,646,149,81.25786163522012,97,59,38,60.824742268041234,442,409,33,92.53393665158372,87,53,34,60.91954022988506,19.50298107019834,2,1,1,50.0,3,0,30,22,6,3,9,Aston Villa,20,England - Premier League
80,Chancel Mbemba Mangulu,1162,909,253,78.22719449225474,143,77,66,53.84615384615385,613,574,39,93.6378466557912,170,64,106,37.64705882352941,22.95024219517632,4,1,3,25.0,4,0,26,20,7,2,12,Newcastle United,33,England - Premier League
81,"Charles N""Zogbia",12,9,3,75.0,0,0,0,0.0,9,9,0,100.0,0,0,0,0.0,10.48573164216,1,0,1,0.0,0,0,1,0,1,0,0,Aston Villa,2,England - Premier League
82,Charlie Adam,590,432,158,73.22033898305085,119,58,61,48.739495798319325,284,263,21,92.6056338028169,128,51,77,39.84375,24.27170914706034,16,5,11,31.25,9,1,19,10,8,5,29,Stoke City,22,England - Premier League
83,Charlie Austin,55,35,20,63.63636363636363,7,4,3,57.14285714285714,22,18,4,81.81818181818183,5,2,3,40.0,15.895319389291636,2,1,1,50.0,1,0,2,2,1,1,7,Southampton,7,England - Premier League
84,Charlie Daniels,2239,1765,474,78.8298347476552,237,136,101,57.383966244725734,1265,1148,117,90.75098814229248,233,87,146,37.33905579399141,17.66795447526113,93,28,65,30.107526881720432,31,5,67,47,27,15,20,AFC Bournemouth,37,England - Premier League
85,Cheik Ismaël Tioté,850,731,119,86.0,98,57,41,58.16326530612245,552,532,20,96.37681159420289,62,28,34,45.16129032258064,18.298301059921975,0,0,0,0.0,8,0,21,14,3,3,14,Newcastle United,20,England - Premier League
86,Cheikhou Kouyaté,1255,998,257,79.52191235059762,110,59,51,53.63636363636364,771,716,55,92.86640726329442,59,22,37,37.28813559322034,15.687911972552413,15,2,13,13.333333333333334,14,2,45,32,13,7,48,West Ham United,34,England - Premier League
87,Chris Brunt,851,563,288,66.15746180963572,177,90,87,50.847457627118644,303,274,29,90.42904290429043,210,72,138,34.285714285714285,23.289098744794714,45,16,29,35.55555555555556,16,3,17,11,5,1,7,West Bromwich Albion,22,England - Premier League
88,Chris Smalling,1522,1280,242,84.09986859395532,128,50,78,39.0625,839,813,26,96.9010727056019,136,32,104,23.52941176470588,21.774586926724652,1,0,1,0.0,5,1,8,7,0,0,15,Manchester United,35,England - Premier League
89,Christian Benteke Liolo,493,344,149,69.77687626774848,40,14,26,35.0,227,188,39,82.81938325991189,16,13,3,81.25,13.27543136475291,5,5,0,100.0,23,3,21,11,10,3,27,Liverpool,29,England - Premier League
90,Christian Dannemann Eriksen,2041,1559,482,76.38412542871141,253,180,73,71.14624505928853,1231,1112,119,90.33306255077173,231,85,146,36.79653679653679,17.8054840872762,74,22,52,29.72972972972973,95,12,76,39,52,23,24,Tottenham Hotspur,35,England - Premier League
91,Christian Fuchs,1665,1128,537,67.74774774774774,275,155,120,56.36363636363636,582,519,63,89.17525773195877,386,126,260,32.64248704663213,21.659748672699894,88,13,75,14.772727272727273,43,4,17,11,5,4,12,Leicester City,32,England - Premier League
92,Chung-Yong Lee,193,156,37,80.82901554404145,15,11,4,73.33333333333333,119,108,11,90.75630252100841,18,8,10,44.44444444444444,16.76051631019399,9,3,6,33.33333333333333,6,0,19,12,7,3,6,Crystal Palace,13,England - Premier League
93,Ciaran Clark,584,445,139,76.1986301369863,86,26,60,30.23255813953488,332,322,10,96.98795180722891,97,27,70,27.835051546391753,22.107484812328767,2,1,1,50.0,3,0,8,6,2,0,10,Aston Villa,17,England - Premier League
94,Claudio Ariel Yacob,1118,870,248,77.8175313059034,160,92,68,57.49999999999999,565,517,48,91.50442477876106,112,48,64,42.857142857142854,19.22080667910904,5,1,4,20.0,8,1,18,10,2,1,49,West Bromwich Albion,34,England - Premier League
95,Clinton Mua N''Jie,72,46,26,63.888888888888886,6,2,4,33.33333333333333,42,33,9,78.57142857142857,6,1,5,16.666666666666664,14.830494669659998,4,1,3,25.0,1,1,12,7,10,5,1,Tottenham Hotspur,8,England - Premier League
96,Connor Steven Randall,104,78,26,75.0,14,9,5,64.28571428571429,41,36,5,87.8048780487805,9,0,9,0.0,16.19827289324308,2,0,2,0.0,0,0,6,2,2,0,2,Liverpool,3,England - Premier League
97,Connor Wickham,409,266,143,65.03667481662592,55,27,28,49.09090909090909,155,126,29,81.29032258064515,28,12,16,42.857142857142854,15.463996953176334,18,4,14,22.22222222222222,10,3,24,17,12,10,23,Crystal Palace,21,England - Premier League
98,Costel Fane Pantilimon,560,281,279,50.17857142857143,105,22,83,20.952380952380953,100,100,0,100.0,412,141,271,34.22330097087379,48.56890600604829,0,0,0,0.0,1,0,0,0,0,0,3,Sunderland,17,England - Premier League
99,Craig Cathcart,1050,749,301,71.33333333333334,211,72,139,34.12322274881517,447,428,19,95.74944071588367,270,85,185,31.48148148148148,25.294580660431613,2,1,1,50.0,3,0,5,4,0,0,13,Watford,35,England - Premier League
100,Craig Dawson,1658,1049,609,63.268998793727384,308,129,179,41.883116883116884,471,404,67,85.77494692144374,295,92,203,31.186440677966104,20.547146366272617,77,24,53,31.16883116883117,23,0,30,15,18,7,32,West Bromwich Albion,38,England - Premier League
101,Craig Gardner,745,420,325,56.375838926174495,130,52,78,40.0,299,242,57,80.93645484949833,173,51,122,29.47976878612717,20.44988334146223,44,13,31,29.545454545454547,23,3,22,9,13,7,27,West Bromwich Albion,34,England - Premier League
102,Cristian Gamboa Luna,13,9,4,69.23076923076923,1,1,0,100.0,10,9,1,90.0,0,0,0,0.0,13.275629778184616,0,0,0,0.0,0,0,2,1,1,1,1,West Bromwich Albion,1,England - Premier League
103,Cédric Ricardo Alves Soares,1155,771,384,66.75324675324676,199,101,98,50.753768844221106,410,375,35,91.46341463414635,228,77,151,33.771929824561404,19.686080536715846,95,25,70,26.31578947368421,23,2,37,28,19,13,16,Southampton,24,England - Premier League
104,César Azpilicueta Tanco,2198,1782,416,81.07370336669699,249,156,93,62.65060240963856,1221,1138,83,93.2022932022932,193,78,115,40.41450777202073,17.278592141953375,51,16,35,31.372549019607842,17,4,26,8,13,4,22,Chelsea,37,England - Premier League
105,Daley Blind,2215,1786,429,80.63205417607223,301,182,119,60.46511627906976,1224,1160,64,94.77124183006535,360,136,224,37.77777777777778,22.6801666045912,25,5,20,20.0,27,1,17,13,4,3,17,Manchester United,35,England - Premier League
106,Dame N''Doye,194,130,64,67.0103092783505,20,9,11,45.0,101,87,14,86.13861386138613,15,6,9,40.0,16.168615162318762,4,1,3,25.0,3,0,15,5,7,3,20,Sunderland,11,England - Premier League
107,Damien Delaney,1072,785,287,73.22761194029852,194,70,124,36.08247422680412,459,439,20,95.64270152505446,277,97,180,35.018050541516246,26.023323462046122,2,2,0,100.0,5,3,4,4,0,0,15,Crystal Palace,32,England - Premier League
108,Dan Gosling,1230,1029,201,83.65853658536585,152,106,46,69.73684210526315,874,797,77,91.18993135011442,40,15,25,37.5,15.674821702648975,6,1,5,16.666666666666664,28,1,59,34,18,12,48,AFC Bournemouth,34,England - Premier League
109,Daniel Amartey,74,61,13,82.43243243243244,6,4,2,66.66666666666666,40,37,3,92.5,9,4,5,44.44444444444444,19.485107078215137,0,0,0,0.0,1,0,2,1,1,0,1,Leicester City,4,England - Premier League
110,Daniel Andre Sturridge,327,250,77,76.45259938837921,30,19,11,63.33333333333333,234,202,32,86.32478632478633,16,9,7,56.25,14.414142358483156,12,1,11,8.333333333333332,5,1,37,20,19,9,14,Liverpool,14,England - Premier League
111,Daniel Nii Tackie Mensah Welbeck,145,118,27,81.37931034482759,12,7,5,58.333333333333336,119,102,17,85.71428571428571,1,1,0,100.0,13.14311410761269,3,2,1,66.66666666666666,5,2,34,17,20,8,9,Arsenal,11,England - Premier League
112,Daniel William John Ings,81,59,22,72.8395061728395,11,7,4,63.63636363636363,46,36,10,78.26086956521739,8,4,4,50.0,15.635905029315555,1,1,0,100.0,5,0,7,3,7,3,7,Liverpool,6,England - Premier League
113,Danny Drinkwater,2033,1556,477,76.53713723561239,427,242,185,56.674473067915685,1117,1013,104,90.68934646374217,320,141,179,44.0625,19.190221174563952,37,10,27,27.027027027027028,34,7,46,28,9,6,28,Leicester City,35,England - Premier League
114,Danny Graham,86,50,36,58.139534883720934,8,4,4,50.0,40,33,7,82.5,6,3,3,50.0,15.087928710851163,3,1,2,33.33333333333333,0,0,2,0,2,0,7,Sunderland,10,England - Premier League
115,Danny Rose,1433,1077,356,75.15701325889742,184,93,91,50.54347826086957,756,669,87,88.4920634920635,158,62,96,39.24050632911392,18.682186353489698,56,14,42,25.0,20,3,52,27,23,11,50,Tottenham Hotspur,24,England - Premier League
116,Danny Simpson,1203,850,353,70.65669160432253,163,75,88,46.012269938650306,429,397,32,92.54079254079254,142,41,101,28.87323943661972,17.7440426949989,19,3,16,15.789473684210526,6,0,17,10,8,2,13,Leicester City,30,England - Premier League
117,Danny Ward,58,33,25,56.896551724137936,3,0,3,0.0,23,23,0,100.0,29,5,24,17.24137931034483,39.844909606965516,0,0,0,0.0,0,0,0,0,0,0,0,Liverpool,2,England - Premier League
118,Darren Fletcher,1516,1151,365,75.92348284960421,287,172,115,59.93031358885017,826,744,82,90.07263922518159,219,96,123,43.83561643835616,20.15872398303174,31,8,23,25.806451612903224,23,2,67,39,21,10,36,West Bromwich Albion,38,England - Premier League
119,Darren Randolph,192,104,88,54.166666666666664,76,24,52,31.57894736842105,30,30,0,100.0,136,54,82,39.705882352941174,53.238086238562495,0,0,0,0.0,0,0,0,0,0,0,0,West Ham United,6,England - Premier League
120,Darron Gibson,177,154,23,87.00564971751412,33,19,14,57.57575757575758,105,101,4,96.19047619047619,23,12,11,52.17391304347826,23.185028408977622,0,0,0,0.0,3,0,3,3,0,0,0,Everton,6,England - Premier League
121,Daryl Janmaat,1731,1264,467,73.0213749277874,200,115,85,57.49999999999999,737,651,86,88.33107191316147,216,74,142,34.25925925925926,18.26804781064721,116,28,88,24.137931034482758,22,4,67,46,41,26,8,Newcastle United,32,England - Premier League
122,David Josué Jiménez Silva,1488,1226,262,82.39247311827957,156,127,29,81.41025641025641,1090,986,104,90.45871559633028,115,62,53,53.91304347826087,15.711526545064356,42,10,32,23.809523809523807,50,10,50,31,30,18,39,Manchester City,24,England - Premier League
123,David Ospina Ramírez,127,74,53,58.26771653543307,21,6,15,28.57142857142857,21,21,0,100.0,87,35,52,40.229885057471265,46.6440548904,0,0,0,0.0,0,0,0,0,0,0,2,Arsenal,4,England - Premier League
124,David de Gea Quintana,956,596,360,62.34309623430963,72,18,54,25.0,240,236,4,98.33333333333333,585,232,353,39.65811965811966,44.42857193536193,0,0,0,0.0,0,0,0,0,0,0,0,Manchester United,34,England - Premier League
125,DeAndre Yedlin,797,522,275,65.49560853199499,122,53,69,43.44262295081967,293,267,26,91.12627986348123,142,46,96,32.3943661971831,19.665263599246977,27,7,20,25.925925925925924,11,1,41,23,26,12,13,Sunderland,23,England - Premier League
126,Declan Rudd,334,149,185,44.61077844311377,58,15,43,25.862068965517242,47,47,0,100.0,257,76,181,29.571984435797667,51.035976073153286,0,0,0,0.0,0,0,0,0,0,0,0,Norwich City,11,England - Premier League
127,Dejan Lovren,1078,917,161,85.06493506493507,104,59,45,56.730769230769226,641,617,24,96.25585023400937,112,47,65,41.964285714285715,21.350445952852986,3,1,2,33.33333333333333,8,0,3,2,0,0,13,Liverpool,24,England - Premier League
128,Demarai Gray,100,72,28,72.0,7,4,3,57.14285714285714,61,50,11,81.9672131147541,10,5,5,50.0,15.5035534075632,6,3,3,50.0,5,1,11,7,7,5,4,Leicester City,12,England - Premier League
129,Diafra Sakho,360,227,133,63.05555555555556,49,16,33,32.6530612244898,175,141,34,80.57142857142857,21,8,13,38.095238095238095,14.0133183186718,23,6,17,26.08695652173913,12,1,50,22,31,12,31,West Ham United,21,England - Premier League
130,Diego da Silva Costa,818,642,176,78.4841075794621,48,32,16,66.66666666666666,588,500,88,85.03401360544217,15,9,6,60.0,12.520538448828823,18,6,12,33.33333333333333,20,5,104,47,74,28,59,Chelsea,28,England - Premier League
131,Dieumerci Mbokani Bezua,472,329,143,69.70338983050848,60,29,31,48.333333333333336,244,215,29,88.11475409836066,11,3,8,27.27272727272727,12.705516106830459,9,3,6,33.33333333333333,21,1,39,25,23,11,51,Norwich City,29,England - Premier League
132,Dimitri Payet,1572,1103,469,70.16539440203562,187,102,85,54.54545454545454,861,731,130,84.90127758420442,314,133,181,42.35668789808918,19.66128754724565,125,38,87,30.4,100,12,110,75,59,42,45,West Ham United,30,England - Premier League
133,Dionatan do Nascimento Teixeira,7,2,5,28.57142857142857,2,0,2,0.0,0,0,0,0.0,4,1,3,25.0,37.431453752639996,0,0,0,0.0,0,0,0,0,0,0,0,Stoke City,1,England - Premier League
134,Divock Okoth Origi,173,120,53,69.36416184971098,9,2,7,22.22222222222222,125,100,25,80.0,2,1,1,50.0,11.314097235980116,16,5,11,31.25,9,1,17,12,14,10,17,Liverpool,16,England - Premier League
135,Donald Love,35,24,11,68.57142857142857,5,1,4,20.0,22,16,6,72.72727272727273,3,0,3,0.0,17.011194452886855,1,0,1,0.0,0,0,5,3,3,2,0,Manchester United,1,England - Premier League
136,Duncan Watmore,174,113,61,64.9425287356322,13,11,2,84.61538461538461,110,86,24,78.18181818181819,4,2,2,50.0,12.723274369206205,12,3,9,25.0,9,1,40,22,32,17,18,Sunderland,23,England - Premier League
137,Dušan Tadić,1104,712,392,64.4927536231884,105,55,50,52.38095238095239,537,441,96,82.12290502793296,175,65,110,37.142857142857146,17.47321842490826,134,45,89,33.582089552238806,66,11,60,38,45,26,40,Southampton,34,England - Premier League
138,Dwight Gayle,154,104,50,67.53246753246754,11,6,5,54.54545454545454,68,59,9,86.76470588235294,10,3,7,30.0,15.14499276666857,7,3,4,42.857142857142854,7,0,7,3,5,3,35,Crystal Palace,16,England - Premier League
139,Eden Hazard,1476,1248,228,84.5528455284553,149,115,34,77.18120805369128,1064,955,109,89.75563909774436,66,50,16,75.75757575757575,15.162048007307805,51,18,33,35.294117647058826,62,3,111,75,61,42,80,Chelsea,31,England - Premier League
140,El-Hadji Baye Oumar Niasse,46,36,10,78.26086956521739,2,1,1,50.0,30,24,6,80.0,3,3,0,100.0,15.066722625933915,2,2,0,100.0,2,0,6,2,4,2,3,Everton,5,England - Premier League
141,Eliaquim Mangala,1011,894,117,88.4272997032641,41,23,18,56.09756097560976,710,684,26,96.3380281690141,49,16,33,32.6530612244898,19.161290902881188,0,0,0,0.0,0,0,8,6,2,1,8,Manchester City,23,England - Premier League
142,Emmanuel Adebayor,240,181,59,75.41666666666667,19,10,9,52.63157894736842,151,133,18,88.0794701986755,4,3,1,75.0,13.290269253165,3,1,2,33.33333333333333,7,1,14,6,10,3,6,Crystal Palace,12,England - Premier League
143,Emmanuel Emenike,153,112,41,73.20261437908496,11,6,5,54.54545454545454,103,88,15,85.43689320388349,2,1,1,50.0,11.370715903952942,5,1,4,20.0,9,0,17,11,6,4,7,West Ham United,13,England - Premier League
144,Emmanuel Rivière,20,18,2,90.0,2,2,0,100.0,13,11,2,84.61538461538461,0,0,0,0.0,10.306725775128,1,1,0,100.0,1,0,2,1,0,0,2,Newcastle United,3,England - Premier League
145,Emre Can,1782,1456,326,81.70594837261504,232,135,97,58.189655172413794,1155,1067,88,92.38095238095238,156,72,84,46.15384615384615,18.37700043819374,12,3,9,25.0,26,0,57,40,17,11,36,Liverpool,30,England - Premier League
146,Enner Remberto Valencia Lastra,259,191,68,73.74517374517374,20,13,7,65.0,163,143,20,87.73006134969326,12,3,9,25.0,13.70222544380108,7,2,5,28.57142857142857,7,2,36,16,16,9,21,West Ham United,19,England - Premier League
147,Eric Dier,2111,1766,345,83.6570345807674,330,224,106,67.87878787878789,1307,1234,73,94.41469013006886,184,74,110,40.21739130434783,19.504565216038863,14,1,13,7.142857142857142,19,2,13,9,1,0,28,Tottenham Hotspur,37,England - Premier League
148,Erik Lamela,1117,827,290,74.03760071620412,84,55,29,65.47619047619048,729,633,96,86.83127572016461,114,47,67,41.228070175438596,15.862153940667715,36,7,29,19.444444444444446,64,8,76,36,43,20,46,Tottenham Hotspur,34,England - Premier League
149,Erik Pieters,1956,1465,491,74.89775051124744,272,160,112,58.82352941176471,960,875,85,91.14583333333334,208,62,146,29.807692307692307,19.029549931165768,69,14,55,20.28985507246377,18,1,25,12,9,4,49,Stoke City,35,England - Premier League
150,Etienne Capoue,1595,1245,350,78.0564263322884,256,149,107,58.203125,908,826,82,90.96916299559471,180,85,95,47.22222222222222,18.063705634958957,20,7,13,35.0,22,1,93,54,43,23,65,Watford,33,England - Premier League
151,Eunan O''Kane,383,296,87,77.28459530026109,66,46,20,69.6969696969697,232,202,30,87.06896551724138,36,19,17,52.77777777777778,18.015182705621516,2,1,1,50.0,4,1,15,10,6,3,13,AFC Bournemouth,16,England - Premier League
152,Fabian Delph,471,399,72,84.71337579617835,52,38,14,73.07692307692307,370,340,30,91.8918918918919,21,5,16,23.809523809523807,15.772978136415286,3,0,3,0.0,3,0,33,24,11,7,15,Manchester City,17,England - Premier League
153,Fabio Borini,600,398,202,66.33333333333333,67,24,43,35.82089552238806,321,274,47,85.35825545171339,56,16,40,28.57142857142857,17.5218533906148,26,7,19,26.923076923076923,15,2,40,17,27,10,52,Sunderland,26,England - Premier League
154,Fabricio Coloccini,856,722,134,84.34579439252336,74,39,35,52.702702702702695,479,465,14,97.07724425887265,108,46,62,42.592592592592595,22.22931022591458,3,0,3,0.0,3,0,8,7,0,0,8,Newcastle United,26,England - Premier League
155,Faustino Marcos Alberto Rojo,902,649,253,71.95121951219512,115,64,51,55.65217391304348,424,397,27,93.63207547169812,117,26,91,22.22222222222222,18.77600681855601,43,11,32,25.581395348837212,9,1,2,1,0,0,13,Manchester United,16,England - Premier League
156,Federico Fernández,1745,1473,272,84.41260744985674,142,73,69,51.40845070422535,1095,1039,56,94.88584474885845,131,41,90,31.297709923664126,20.619984895653868,2,0,2,0.0,8,1,5,4,1,1,23,Swansea City,32,England - Premier League
157,Fernando Francisco Reges,910,809,101,88.90109890109889,100,79,21,79.0,625,606,19,96.96000000000001,42,21,21,50.0,17.294291126851252,0,0,0,0.0,5,0,22,20,5,5,16,Manchester City,24,England - Premier League
158,Fernando Luiz Rosa,1894,1652,242,87.22280887011615,320,247,73,77.1875,1376,1293,83,93.96802325581395,87,47,40,54.02298850574713,16.834100804427877,9,1,8,11.11111111111111,25,2,40,26,8,5,41,Manchester City,33,England - Premier League
159,Fikayo Tomori,14,12,2,85.71428571428571,1,1,0,100.0,7,7,0,100.0,1,0,1,0.0,21.351889419942857,0,0,0,0.0,0,0,1,0,1,0,0,Chelsea,1,England - Premier League
160,Florian Thauvin,216,123,93,56.94444444444444,24,10,14,41.66666666666667,115,96,19,83.47826086956522,41,3,38,7.317073170731707,17.72106641708,21,4,17,19.047619047619047,4,0,26,10,10,3,17,Newcastle United,13,England - Premier League
161,Fraizer Campbell,83,57,26,68.67469879518072,6,4,2,66.66666666666666,44,38,6,86.36363636363636,1,1,0,100.0,12.008458095952772,1,0,1,0.0,1,0,8,2,5,1,4,Crystal Palace,11,England - Premier League
162,Francesc Fàbregas i Soler,2947,2406,541,81.64234815066169,517,335,182,64.79690522243715,1878,1710,168,91.05431309904152,356,172,184,48.31460674157304,18.78443622941668,45,12,33,26.666666666666668,62,7,42,24,17,8,51,Chelsea,37,England - Premier League
163,Francis Joseph Coquelin,1104,988,116,89.4927536231884,156,128,28,82.05128205128204,804,767,37,95.39800995024875,72,50,22,69.44444444444444,16.62895816337087,4,1,3,25.0,6,0,36,30,6,6,36,Arsenal,26,England - Premier League
164,Fraser Forster,487,256,231,52.56673511293635,118,40,78,33.89830508474576,64,64,0,100.0,379,156,223,41.16094986807388,52.7468521625623,0,0,0,0.0,0,0,1,1,0,0,0,Southampton,18,England - Premier League
165,Gabriel Antoine Obertan,107,83,24,77.57009345794393,3,2,1,66.66666666666666,67,58,9,86.56716417910447,5,3,2,60.0,13.453340542459065,8,2,6,25.0,2,1,7,2,5,2,3,Newcastle United,5,England - Premier League
166,Gabriel Armando de Abreu,1074,978,96,91.06145251396647,51,31,20,60.78431372549019,738,719,19,97.42547425474255,53,27,26,50.943396226415096,18.77354258236297,1,0,1,0.0,1,0,7,5,2,1,14,Arsenal,21,England - Premier League
167,Gabriel Imuetinyan Agbonlahor,233,160,73,68.6695278969957,16,6,10,37.5,134,124,10,92.53731343283582,10,2,8,20.0,13.67819884445655,10,3,7,30.0,11,2,13,6,4,2,17,Aston Villa,15,England - Premier League
168,Gareth Barry,2098,1710,388,81.50619637750238,359,234,125,65.18105849582173,1227,1152,75,93.8875305623472,258,133,125,51.55038759689923,20.190341873224863,20,10,10,50.0,33,0,25,19,4,3,29,Everton,33,England - Premier League
169,Gareth McAuley,847,588,259,69.42148760330579,214,79,135,36.915887850467286,316,300,16,94.9367088607595,256,89,167,34.765625,26.722115319249774,1,0,1,0.0,6,0,8,8,1,1,18,West Bromwich Albion,34,England - Premier League
170,Gary Cahill,743,643,100,86.54104979811575,28,10,18,35.714285714285715,464,452,12,97.41379310344827,53,18,35,33.9622641509434,18.681713752701803,0,0,0,0.0,2,0,4,4,1,1,20,Chelsea,23,England - Premier League
171,Gary Hooper,4,3,1,75.0,0,0,0,0.0,4,3,1,75.0,0,0,0,0.0,12.69309075804,0,0,0,0.0,0,0,0,0,0,0,1,Norwich City,2,England - Premier League
172,Gary O''Neil,977,734,243,75.1279426816786,163,85,78,52.14723926380368,506,466,40,92.09486166007905,153,58,95,37.908496732026144,20.635642161555293,16,4,12,25.0,8,0,33,22,5,3,19,Norwich City,27,England - Premier League
173,Gastón Exequiel Ramírez Pereyra,19,13,6,68.42105263157895,0,0,0,0.0,12,11,1,91.66666666666666,2,0,2,0.0,16.3473341328,2,0,2,0.0,0,0,5,3,1,0,0,Southampton,3,England - Premier League
174,Gaël Clichy,839,662,177,78.90345649582838,122,70,52,57.377049180327866,514,473,41,92.02334630350194,77,24,53,31.16883116883117,18.013577022429942,26,10,16,38.46153846153847,10,1,14,12,3,2,8,Manchester City,14,England - Premier League
175,Geoff Cameron,1187,905,282,76.24262847514743,172,82,90,47.674418604651166,667,619,48,92.80359820089956,144,44,100,30.555555555555557,20.039385410851086,9,2,7,22.22222222222222,9,0,31,21,2,1,14,Stoke City,30,England - Premier League
176,George Honeyman,6,5,1,83.33333333333334,0,0,0,0.0,4,4,0,100.0,0,0,0,0.0,14.144027805359999,0,0,0,0.0,1,0,0,0,0,0,1,Sunderland,1,England - Premier League
177,Georginio Wijnaldum,1264,1055,209,83.46518987341773,128,93,35,72.65625,858,784,74,91.37529137529138,60,32,28,53.333333333333336,14.994460633710647,20,5,15,25.0,38,4,117,81,32,23,63,Newcastle United,38,England - Premier League
178,Gerard Deulofeu Lázaro,691,428,263,61.93921852387844,77,42,35,54.54545454545454,364,279,85,76.64835164835165,92,24,68,26.08695652173913,18.914745253270713,88,22,66,25.0,28,9,66,36,46,29,17,Everton,26,England - Premier League
179,Giedrius Arlauskis,6,4,2,66.66666666666666,4,2,2,50.0,0,0,0,0.0,5,3,2,60.0,60.611319468,0,0,0,0.0,0,0,0,0,0,0,0,Watford,1,England - Premier League
180,Gilbert Gianelli Imbula Wanga,779,682,97,87.54813863928112,117,86,31,73.50427350427351,578,550,28,95.15570934256056,45,14,31,31.11111111111111,16.764637333435072,4,0,4,0.0,11,0,61,40,14,9,22,Stoke City,14,England - Premier League
181,Glen Johnson,1205,945,260,78.42323651452283,169,96,73,56.80473372781065,639,582,57,91.07981220657277,108,35,73,32.407407407407405,18.11183790256778,37,11,26,29.72972972972973,16,3,72,38,38,20,12,Stoke City,25,England - Premier League
182,Glenn Murray,202,134,68,66.33663366336634,12,6,6,50.0,103,86,17,83.49514563106796,8,3,5,37.5,12.660676453179802,5,2,3,40.0,6,0,16,8,9,5,21,AFC Bournemouth,21,England - Premier League
183,Glenn Whelan,2037,1755,282,86.15611192930781,266,171,95,64.28571428571429,1334,1282,52,96.10194902548726,170,77,93,45.294117647058826,19.20717279000311,8,1,7,12.5,21,1,23,18,2,0,25,Stoke City,37,England - Premier League
184,Glyn Oliver Myhill,661,310,351,46.89863842662632,183,56,127,30.601092896174865,75,75,0,100.0,540,202,338,37.407407407407405,54.12766825151347,0,0,0,0.0,0,0,0,0,0,0,3,West Bromwich Albion,23,England - Premier League
185,Gnégnéri Yaya Touré,1869,1596,273,85.39325842696628,253,163,90,64.42687747035573,1307,1216,91,93.03749043611323,111,55,56,49.549549549549546,17.77459031920372,11,6,5,54.54545454545454,40,3,62,44,37,23,37,Manchester City,32,England - Premier League
186,Graham Dorrans,761,647,114,85.0197109067017,113,79,34,69.91150442477876,482,453,29,93.98340248962656,61,29,32,47.540983606557376,18.56178976834994,5,1,4,20.0,15,1,18,13,11,8,7,Norwich City,21,England - Premier League
187,Graziano Pellè,889,574,315,64.56692913385827,126,58,68,46.03174603174603,343,282,61,82.21574344023324,71,29,42,40.845070422535215,14.503825029188572,12,3,9,25.0,26,6,29,14,19,8,34,Southampton,30,England - Premier League
188,Guangtai Jiang,131,105,26,80.1526717557252,9,7,2,77.77777777777779,67,63,4,94.02985074626866,13,4,9,30.76923076923077,16.990999352804884,3,0,3,0.0,2,0,1,0,0,0,2,Everton,5,England - Premier League
189,Guillermo Varela Olivera,197,154,43,78.1725888324873,16,8,8,50.0,87,85,2,97.70114942528735,29,7,22,24.137931034482758,18.29336058412995,6,1,5,16.666666666666664,1,0,6,3,1,0,9,Manchester United,4,England - Premier League
190,Gylfi Þór Sigurðsson,1346,969,377,71.99108469539375,150,77,73,51.33333333333333,866,736,130,84.98845265588915,157,47,110,29.936305732484076,16.011578213111715,57,10,47,17.543859649122805,57,3,54,29,32,17,33,Swansea City,36,England - Premier League
191,Gökhan İnler,122,97,25,79.50819672131148,24,16,8,66.66666666666666,66,58,8,87.87878787878788,14,7,7,50.0,16.99066637103541,0,0,0,0.0,1,0,3,2,1,0,4,Leicester City,5,England - Premier League
192,Harrison Reed,7,4,3,57.14285714285714,2,0,2,0.0,3,3,0,100.0,1,0,1,0.0,15.476488572342857,0,0,0,0.0,0,0,0,0,0,0,0,Southampton,1,England - Premier League
193,Harry Arter,1042,888,154,85.22072936660268,182,126,56,69.23076923076923,713,646,67,90.6030855539972,88,54,34,61.36363636363637,18.294433556932052,6,4,2,66.66666666666666,24,0,38,21,18,10,24,AFC Bournemouth,21,England - Premier League
194,Harry Kane,1005,720,285,71.64179104477611,136,74,62,54.41176470588235,564,477,87,84.57446808510637,66,34,32,51.515151515151516,15.671180940024,39,11,28,28.205128205128204,39,1,96,56,63,33,61,Tottenham Hotspur,38,England - Premier League
195,Henri Saivet,78,62,16,79.48717948717949,12,4,8,33.33333333333333,43,40,3,93.02325581395348,7,4,3,57.14285714285714,19.038173417686153,0,0,0,0.0,1,0,3,0,1,0,2,Newcastle United,4,England - Premier League
196,Heung-Min Son,455,359,96,78.9010989010989,30,16,14,53.333333333333336,315,278,37,88.25396825396825,14,5,9,35.714285714285715,12.854427565885715,7,1,6,14.285714285714285,17,1,49,24,24,17,15,Tottenham Hotspur,28,England - Premier League
197,Heurelho da Silva Gomes,1132,593,539,52.3851590106007,257,80,177,31.1284046692607,158,158,0,100.0,883,347,536,39.29784824462061,52.29015317465851,0,0,0,0.0,0,0,0,0,0,0,5,Watford,38,England - Premier League
198,Hiram Boateng,5,3,2,60.0,0,0,0,0.0,2,2,0,100.0,0,0,0,0.0,10.656704867904,0,0,0,0.0,0,0,0,0,0,0,0,Crystal Palace,1,England - Premier League
199,Hugo Lloris,1217,817,400,67.13229252259654,168,36,132,21.428571428571427,440,438,2,99.54545454545455,586,203,383,34.641638225255974,38.938391519489635,0,0,0,0.0,3,0,0,0,0,0,5,Tottenham Hotspur,37,England - Premier League
200,Héctor Bellerín Moruno,2094,1735,359,82.85577841451767,195,145,50,74.35897435897436,1303,1177,126,90.33000767459708,98,39,59,39.795918367346935,15.281192566537237,81,22,59,27.160493827160494,19,5,103,67,40,26,14,Arsenal,36,England - Premier League
201,Ibrahim Afellay,1331,1146,185,86.10067618332081,166,127,39,76.50602409638554,887,843,44,95.03945885005636,96,47,49,48.95833333333333,19.362865752893644,30,3,27,10.0,19,2,59,40,17,10,42,Stoke City,31,England - Premier League
202,Idrissa Gana Gueye,1906,1608,298,84.36516264428123,227,161,66,70.92511013215858,1318,1228,90,93.17147192716236,103,50,53,48.54368932038835,16.680100501715383,13,4,9,30.76923076923077,26,1,108,74,37,22,57,Aston Villa,35,England - Premier League
203,Ignacio Monreal Eraso,2259,1868,391,82.69145639663567,201,141,60,70.1492537313433,1377,1293,84,93.89978213507625,170,64,106,37.64705882352941,15.77828598763538,83,25,58,30.120481927710845,25,3,26,12,11,4,47,Arsenal,37,England - Premier League
204,Ikechi Anya,866,620,246,71.59353348729792,83,49,34,59.036144578313255,452,406,46,89.82300884955751,88,30,58,34.090909090909086,16.382877701234968,47,10,37,21.27659574468085,15,1,28,17,13,10,20,Watford,28,England - Premier League
205,Ivan Toney,2,1,1,50.0,0,0,0,0.0,1,1,0,100.0,0,0,0,0.0,16.0302375864,0,0,0,0.0,0,0,0,0,0,0,0,Newcastle United,2,England - Premier League
206,Ivo Daniel Ferreira Mendonca Pinto,486,353,133,72.63374485596708,57,27,30,47.368421052631575,187,170,17,90.9090909090909,53,20,33,37.735849056603776,17.573295804522964,24,8,16,33.33333333333333,2,0,19,11,10,6,6,Norwich City,10,England - Premier League
207,Jack Butland,1013,551,462,54.3928923988154,212,58,154,27.358490566037734,248,247,1,99.59677419354838,684,228,456,33.33333333333333,48.48878213422792,0,0,0,0.0,1,0,1,1,0,0,2,Stoke City,31,England - Premier League
208,Jack Colback,1175,965,210,82.12765957446808,144,97,47,67.36111111111111,702,668,34,95.15669515669516,135,61,74,45.18518518518518,18.829482763961874,24,10,14,41.66666666666667,17,1,20,14,4,2,48,Newcastle United,29,England - Premier League
209,Jack Frank Porteous Cork,1746,1459,287,83.56242840778924,198,129,69,65.15151515151516,1155,1088,67,94.1991341991342,111,53,58,47.74774774774775,16.910346002330307,14,4,10,28.57142857142857,27,1,61,41,17,11,53,Swansea City,35,England - Premier League
210,Jack Grealish,342,269,73,78.65497076023392,27,17,10,62.96296296296296,252,222,30,88.09523809523809,20,4,16,20.0,14.89283068484842,6,1,5,16.666666666666664,11,0,33,19,18,9,21,Aston Villa,16,England - Premier League
211,Jack Rodwell,462,347,115,75.10822510822511,74,38,36,51.35135135135135,252,238,14,94.44444444444444,46,20,26,43.47826086956522,17.766654405165195,2,0,2,0.0,14,0,12,8,3,0,9,Sunderland,22,England - Premier League
212,Jack Wilshere,77,68,9,88.31168831168831,4,4,0,100.0,66,60,6,90.9090909090909,3,1,2,33.33333333333333,12.978098945102337,0,0,0,0.0,0,0,11,5,7,3,7,Arsenal,3,England - Premier League
213,Jake-Liam Clarke-Salter,6,6,0,100.0,0,0,0,0.0,6,6,0,100.0,0,0,0,0.0,16.0547317716,0,0,0,0.0,0,0,0,0,0,0,0,Chelsea,1,England - Premier League
214,Jakob Haugaard,145,82,63,56.55172413793104,47,15,32,31.914893617021278,18,18,0,100.0,110,48,62,43.63636363636363,54.490564488562754,0,0,0,0.0,0,0,0,0,0,0,0,Stoke City,5,England - Premier League
215,Jamaal Lascelles,461,383,78,83.08026030368764,34,13,21,38.23529411764706,260,250,10,96.15384615384616,54,18,36,33.33333333333333,19.52544170365692,2,0,2,0.0,2,0,5,3,1,1,3,Newcastle United,18,England - Premier League
216,James Collins,555,435,120,78.37837837837837,81,33,48,40.74074074074074,289,278,11,96.19377162629758,102,38,64,37.254901960784316,23.557911548781405,1,0,1,0.0,1,0,4,3,0,0,7,West Ham United,19,England - Premier League
217,James Grant Chester,404,299,105,74.00990099009901,67,35,32,52.23880597014925,170,153,17,90.0,56,12,44,21.428571428571427,19.181944223998215,12,1,11,8.333333333333332,4,0,7,4,2,1,7,West Bromwich Albion,13,England - Premier League
218,James McArthur,1067,900,167,84.34864104967198,99,55,44,55.55555555555556,642,602,40,93.76947040498442,77,35,42,45.45454545454545,18.01940618353192,6,2,4,33.33333333333333,19,2,33,20,11,5,29,Crystal Palace,28,England - Premier League
219,James McCarthy,1389,1195,194,86.03311735061196,175,119,56,68.0,936,884,52,94.44444444444444,99,44,55,44.44444444444444,18.58897303462134,9,2,7,22.22222222222222,14,2,16,9,5,3,36,Everton,29,England - Premier League
220,James McClean,822,493,329,59.975669099756686,74,40,34,54.054054054054056,356,298,58,83.70786516853933,148,52,96,35.13513513513514,18.616784559878102,107,32,75,29.906542056074763,30,2,68,35,36,16,45,West Bromwich Albion,35,England - Premier League
221,James Morrison,615,496,119,80.65040650406505,73,43,30,58.9041095890411,388,347,41,89.43298969072166,58,35,23,60.3448275862069,17.39637934189112,7,2,5,28.57142857142857,16,2,36,20,16,7,13,West Bromwich Albion,18,England - Premier League
222,James Philip Milner,1610,1172,438,72.79503105590062,253,161,92,63.63636363636363,914,805,109,88.07439824945295,257,104,153,40.46692607003891,19.18094682666365,86,31,55,36.04651162790697,50,11,41,21,30,18,37,Liverpool,28,England - Premier League
223,James Tomkins,963,747,216,77.57009345794393,119,53,66,44.537815126050425,481,452,29,93.97089397089398,137,49,88,35.76642335766424,19.912415396983928,13,3,10,23.076923076923077,10,0,9,5,4,1,16,West Ham United,25,England - Premier League
224,James Ward-Prowse,807,615,192,76.2081784386617,121,91,30,75.20661157024794,430,399,31,92.79069767441861,153,57,96,37.254901960784316,19.97103578674974,39,12,27,30.76923076923077,27,4,14,10,3,3,9,Southampton,33,England - Premier League
225,James Wilson,6,6,0,100.0,0,0,0,0.0,5,5,0,100.0,0,0,0,0.0,15.9751705896,0,0,0,0.0,1,0,0,0,0,0,0,Manchester United,1,England - Premier League
226,Jamie Vardy,679,426,253,62.73932253313696,55,28,27,50.90909090909091,296,237,59,80.06756756756756,26,9,17,34.61538461538461,14.211758067849544,50,18,32,36.0,36,5,76,39,63,33,34,Leicester City,36,England - Premier League
227,Jan Kirchhoff,569,389,180,68.36555360281194,126,70,56,55.55555555555556,271,243,28,89.66789667896678,61,17,44,27.86885245901639,19.702127263925483,3,1,2,33.33333333333333,13,0,16,14,5,5,19,Sunderland,15,England - Premier League
228,Jan Vertonghen,1526,1335,191,87.48361730013107,129,69,60,53.48837209302325,956,938,18,98.11715481171548,124,47,77,37.903225806451616,21.226225021012215,1,1,0,100.0,5,0,10,10,2,2,24,Tottenham Hotspur,29,England - Premier League
229,Jason Puncheon,1408,1046,362,74.28977272727273,211,122,89,57.81990521327014,821,731,90,89.03775883069429,210,79,131,37.61904761904762,18.64787356602148,54,13,41,24.074074074074073,54,3,83,52,45,24,40,Crystal Palace,31,England - Premier League
230,Javier Hernández Balcázar,13,11,2,84.61538461538461,0,0,0,0.0,13,11,2,84.61538461538461,0,0,0,0.0,11.347362133975384,0,0,0,0.0,1,0,0,0,0,0,1,Manchester United,1,England - Premier League
231,Jay Fulton,9,9,0,100.0,1,1,0,100.0,8,8,0,100.0,0,0,0,0.0,14.307584288,0,0,0,0.0,0,0,0,0,0,0,0,Swansea City,2,England - Premier League
232,Jay Rodriguez,93,67,26,72.04301075268818,15,12,3,80.0,49,40,9,81.63265306122449,3,2,1,66.66666666666666,14.573231261682581,3,2,1,66.66666666666666,3,0,12,6,8,4,3,Southampton,12,England - Premier League
233,Jefferson Antonio Montero Vite,492,316,176,64.22764227642277,24,11,13,45.83333333333333,267,229,38,85.76779026217228,54,15,39,27.77777777777778,16.14982932272049,89,22,67,24.719101123595504,24,2,84,39,67,28,43,Swansea City,23,England - Premier League
234,Jeffrey Schlupp,557,390,167,70.01795332136446,70,38,32,54.285714285714285,285,255,30,89.47368421052632,78,27,51,34.61538461538461,18.46660840430245,34,13,21,38.23529411764706,15,2,49,31,38,23,25,Leicester City,24,England - Premier League
235,Jeremain Lens,474,277,197,58.438818565400844,72,26,46,36.11111111111111,220,173,47,78.63636363636364,83,26,57,31.32530120481928,21.036907475876962,49,7,42,14.285714285714285,14,3,64,34,43,22,34,Sunderland,20,England - Premier League
236,Jermain Defoe,439,319,120,72.66514806378133,40,20,20,50.0,277,228,49,82.31046931407943,19,10,9,52.63157894736842,14.67016693739721,6,1,5,16.666666666666664,18,1,43,20,31,15,39,Sunderland,33,England - Premier League
237,Jesse Lingard,771,635,136,82.36057068741893,56,32,24,57.14285714285714,563,507,56,90.05328596802842,28,6,22,21.428571428571427,13.803746062621633,22,3,19,13.636363636363635,14,1,35,12,16,4,23,Manchester United,25,England - Premier League
238,Jesús Navas González,1452,1103,349,75.9641873278237,83,54,29,65.06024096385542,996,863,133,86.64658634538152,104,35,69,33.65384615384615,15.71851974483967,115,29,86,25.217391304347824,48,7,68,45,39,25,29,Manchester City,34,England - Premier League
239,Joe Allen,413,347,66,84.01937046004842,49,34,15,69.38775510204081,295,273,22,92.54237288135593,21,12,9,57.14285714285714,17.255575254257433,9,4,5,44.44444444444444,12,1,16,9,7,5,24,Liverpool,19,England - Premier League
240,Joe Dodoo,6,3,3,50.0,2,0,2,0.0,2,2,0,100.0,1,0,1,0.0,15.279702028799997,0,0,0,0.0,0,0,0,0,0,0,1,Leicester City,1,England - Premier League
241,Joe Gomez,273,218,55,79.85347985347985,31,21,10,67.74193548387096,156,142,14,91.02564102564102,29,10,19,34.48275862068966,17.90905377354989,7,1,6,14.285714285714285,2,1,8,4,1,0,2,Liverpool,5,England - Premier League
242,Joe Hart,848,502,346,59.198113207547166,94,23,71,24.46808510638298,242,242,0,100.0,515,174,341,33.78640776699029,43.95235503490642,0,0,0,0.0,2,0,1,1,0,0,4,Manchester City,35,England - Premier League
243,Joe Ledley,396,322,74,81.31313131313132,39,20,19,51.28205128205128,240,221,19,92.08333333333333,29,6,23,20.689655172413794,16.38693091716182,1,0,1,0.0,3,0,6,4,2,2,5,Crystal Palace,19,England - Premier League
244,Joel Nathaniel Campbell Samuels,350,266,84,76.0,38,16,22,42.10526315789473,261,227,34,86.97318007662835,18,5,13,27.77777777777778,14.668505905891886,9,4,5,44.44444444444444,11,2,22,14,17,12,29,Arsenal,19,England - Premier League
245,Joel Robles Blázquez,475,250,225,52.63157894736842,71,13,58,18.30985915492958,116,116,0,100.0,307,89,218,28.990228013029316,47.32319071171705,0,0,0,0.0,0,0,1,1,0,0,2,Everton,13,England - Premier League
246,Joel Ward,1328,982,346,73.94578313253012,202,108,94,53.46534653465347,541,494,47,91.31238447319778,188,65,123,34.57446808510639,18.14024785253259,44,13,31,29.545454545454547,13,1,31,17,17,8,32,Crystal Palace,30,England - Premier League
247,John Michael Nchekwube Obinna,1226,1115,111,90.94616639477977,112,78,34,69.64285714285714,942,908,34,96.39065817409767,60,26,34,43.333333333333336,16.768794272839283,3,0,3,0.0,4,1,18,15,3,2,15,Chelsea,25,England - Premier League
248,John O''Shea,611,448,163,73.32242225859247,94,34,60,36.17021276595745,267,259,8,97.00374531835206,118,35,83,29.66101694915254,22.80386912205659,1,0,1,0.0,1,0,1,1,0,0,12,Sunderland,28,England - Premier League
249,John Ruddy,905,504,401,55.69060773480663,159,44,115,27.67295597484277,163,162,1,99.38650306748467,601,210,391,34.94176372712147,47.96000035111929,0,0,0,0.0,0,0,1,1,0,0,2,Norwich City,27,England - Premier League
250,John Stones,1596,1414,182,88.59649122807018,132,79,53,59.84848484848485,1092,1045,47,95.6959706959707,116,47,69,40.51724137931034,20.416731007979095,6,2,4,33.33333333333333,4,0,18,11,2,0,31,Everton,33,England - Premier League
251,John Terry,933,853,80,91.42550911039658,49,24,25,48.97959183673469,609,601,8,98.68637110016421,40,15,25,37.5,17.846998942256718,0,0,0,0.0,3,0,3,1,2,0,6,Chelsea,24,England - Premier League
252,Joleon Lescott,1043,828,215,79.38638542665389,123,59,64,47.96747967479675,532,501,31,94.17293233082707,163,71,92,43.558282208588956,20.8769989831483,4,2,2,50.0,4,0,10,9,2,2,8,Aston Villa,32,England - Premier League
253,Jon Flanagan,303,249,54,82.17821782178217,26,14,12,53.84615384615385,206,189,17,91.74757281553399,17,3,14,17.647058823529413,15.989852066233665,4,1,3,25.0,1,1,4,2,1,1,4,Liverpool,5,England - Premier League
254,Jonas Olsson,575,399,176,69.3913043478261,114,45,69,39.473684210526315,230,214,16,93.04347826086956,145,47,98,32.41379310344827,24.59062345871833,0,0,0,0.0,3,1,3,2,1,0,8,West Bromwich Albion,28,England - Premier League
255,Jonathan Grant Evans,1101,796,305,72.29791099000909,196,90,106,45.91836734693878,476,431,45,90.54621848739495,207,83,124,40.09661835748793,22.447576473909972,19,9,10,47.368421052631575,5,1,22,17,4,3,20,West Bromwich Albion,30,England - Premier League
256,Jonathan Howson,1338,999,339,74.66367713004485,197,101,96,51.26903553299492,801,707,94,88.26466916354558,111,34,77,30.630630630630627,17.241218584658206,27,8,19,29.629629629629626,27,4,53,33,19,8,24,Norwich City,36,England - Premier League
257,Jonathan Leko,55,40,15,72.72727272727273,5,2,3,40.0,44,39,5,88.63636363636364,3,0,3,0.0,16.904405529242183,3,1,2,33.33333333333333,1,1,21,12,15,7,4,West Bromwich Albion,5,England - Premier League
258,Jonathan Walters,537,343,194,63.87337057728119,52,27,25,51.92307692307693,258,225,33,87.20930232558139,27,9,18,33.33333333333333,14.60925459910257,27,5,22,18.51851851851852,19,2,34,16,17,7,26,Stoke City,27,England - Premier League
259,Jonathan Williams,5,5,0,100.0,0,0,0,0.0,4,4,0,100.0,0,0,0,0.0,14.336176163760001,0,0,0,0.0,0,0,0,0,0,0,0,Crystal Palace,1,England - Premier League
260,Jonjo Shelvey,1593,1231,362,77.27558066541117,302,179,123,59.27152317880795,797,739,58,92.72271016311167,312,137,175,43.91025641025641,23.672246540830738,41,10,31,24.390243902439025,39,4,52,37,17,11,12,Swansea City,30,England - Premier League
261,Jonjoe Kenny,32,23,9,71.875,2,1,1,50.0,13,11,2,84.61538461538461,3,0,3,0.0,16.639013359575,1,1,0,100.0,0,0,0,0,0,0,0,Everton,1,England - Premier League
262,Jordan Amavi,529,398,131,75.23629489603024,42,29,13,69.04761904761905,239,214,25,89.5397489539749,57,18,39,31.57894736842105,18.065904380431757,34,8,26,23.52941176470588,6,2,49,18,29,6,14,Aston Villa,10,England - Premier League
263,Jordan Ayew,824,647,177,78.51941747572816,55,33,22,60.0,574,507,67,88.32752613240417,26,9,17,34.61538461538461,14.163619289251544,42,9,33,21.428571428571427,14,0,158,85,85,45,49,Aston Villa,30,England - Premier League
264,Jordan Brian Henderson,1007,780,227,77.45779543197617,171,110,61,64.32748538011695,563,520,43,92.36234458259325,136,64,72,47.05882352941176,20.252588165488635,32,9,23,28.125,16,2,22,12,8,3,12,Liverpool,17,England - Premier League
265,Jordan Lyden,72,59,13,81.94444444444444,7,4,3,57.14285714285714,49,43,6,87.75510204081633,7,4,3,57.14285714285714,18.59015262023,2,0,2,0.0,1,0,1,1,0,0,2,Aston Villa,4,England - Premier League
266,Jordan Pickford,78,30,48,38.46153846153847,31,10,21,32.25806451612903,5,5,0,100.0,70,22,48,31.428571428571427,61.00369370132308,0,0,0,0.0,0,0,0,0,0,0,1,Sunderland,2,England - Premier League
267,Jordan Rossiter,6,4,2,66.66666666666666,0,0,0,0.0,4,4,0,100.0,0,0,0,0.0,10.06914601356,0,0,0,0.0,0,0,0,0,0,0,0,Liverpool,1,England - Premier League
268,Jordan Veretout,1090,854,236,78.34862385321101,150,107,43,71.33333333333334,703,635,68,90.3271692745377,122,42,80,34.42622950819672,18.543075076708842,40,13,27,32.5,35,5,14,11,3,2,28,Aston Villa,25,England - Premier League
269,Jordi Amat Maas,185,145,40,78.37837837837837,14,6,8,42.857142857142854,112,105,7,93.75,16,3,13,18.75,20.109251356645622,1,0,1,0.0,0,0,2,2,0,0,3,Swansea City,8,England - Premier League
270,Jordi Gómez García-Penche,173,143,30,82.65895953757226,29,16,13,55.172413793103445,96,92,4,95.83333333333334,16,5,11,31.25,17.45826730083468,3,1,2,33.33333333333333,3,0,2,2,1,1,5,Sunderland,5,England - Premier League
271,Jordon Ibe,559,442,117,79.06976744186046,40,35,5,87.5,394,348,46,88.3248730964467,35,11,24,31.428571428571427,15.335518622039356,31,8,23,25.806451612903224,18,1,77,44,44,27,17,Liverpool,27,England - Premier League
272,Jordon Mutch,357,253,104,70.86834733893558,35,18,17,51.42857142857142,190,173,17,91.05263157894737,50,15,35,30.0,17.893291173045377,21,4,17,19.047619047619047,7,0,16,12,6,4,11,Crystal Palace,20,England - Premier League
273,Jordy Clasie,828,665,163,80.31400966183575,121,67,54,55.371900826446286,479,445,34,92.90187891440502,107,56,51,52.336448598130836,19.405399465233042,9,2,7,22.22222222222222,10,0,11,6,2,2,9,Southampton,22,England - Premier League
274,Josh Onomah,49,32,17,65.3061224489796,4,4,0,100.0,35,29,6,82.85714285714286,5,2,3,40.0,14.379567612435919,7,1,6,14.285714285714285,0,0,4,2,4,2,1,Tottenham Hotspur,8,England - Premier League
275,Joshua King,457,338,119,73.96061269146608,29,14,15,48.275862068965516,303,247,56,81.51815181518151,8,3,5,37.5,12.500208803031597,23,8,15,34.78260869565217,21,2,103,57,64,35,31,AFC Bournemouth,31,England - Premier League
276,José Holebas,531,386,145,72.69303201506591,67,33,34,49.25373134328358,247,220,27,89.06882591093117,81,34,47,41.9753086419753,17.71399019500339,17,4,13,23.52941176470588,7,0,35,17,18,6,5,Watford,11,England - Premier League
277,José Leonardo Ulloa,396,280,116,70.70707070707071,37,19,18,51.35135135135135,208,177,31,85.09615384615384,11,3,8,27.27272727272727,12.221045035774546,7,2,5,28.57142857142857,9,1,30,17,17,12,19,Leicester City,29,England - Premier League
278,José Luis Sanmartín Mato,376,268,108,71.27659574468085,35,14,21,40.0,175,146,29,83.42857142857143,17,8,9,47.05882352941176,13.997651426708934,12,5,7,41.66666666666667,8,1,25,10,16,7,21,Stoke City,22,England - Premier League
279,José Manuel Jurado Marín,1035,831,204,80.28985507246377,98,70,28,71.42857142857143,719,643,76,89.4297635605007,73,29,44,39.726027397260275,15.383856462096,34,10,24,29.411764705882355,39,0,86,52,33,19,44,Watford,27,England - Premier League
280,José Miguel da Rocha Fonte,1642,1375,267,83.73934226552984,190,103,87,54.21052631578947,905,880,25,97.23756906077348,223,99,124,44.39461883408072,22.058136842782364,7,3,4,42.857142857142854,5,0,4,4,0,0,12,Southampton,37,England - Premier League
281,José Ramiro Funes Mori,1299,1085,214,83.52578906851424,133,75,58,56.390977443609025,785,756,29,96.30573248407643,179,78,101,43.575418994413404,21.45934470481829,3,0,3,0.0,5,0,11,5,2,0,12,Everton,28,England - Premier League
282,José Salomón Rondón Giménez,662,424,238,64.04833836858006,63,19,44,30.158730158730158,297,249,48,83.83838383838383,27,15,12,55.55555555555556,13.280380149127977,26,8,18,30.76923076923077,24,2,44,21,28,15,40,West Bromwich Albion,34,England - Premier League
283,José Ángel Crespo Rincón,30,27,3,90.0,2,2,0,100.0,14,14,0,100.0,5,5,0,100.0,19.380510910224,0,0,0,0.0,0,0,0,0,0,0,1,Aston Villa,1,England - Premier League
284,João Carlos Vilaça Teixeira,3,3,0,100.0,0,0,0,0.0,2,2,0,100.0,0,0,0,0.0,11.132932593120001,0,0,0,0.0,0,0,0,0,0,0,0,Liverpool,1,England - Premier League
285,Juan Carlos Paredes Reasco,380,256,124,67.36842105263158,59,29,30,49.152542372881356,153,129,24,84.31372549019608,57,22,35,38.59649122807017,18.872308202208632,23,6,17,26.08695652173913,3,0,14,7,7,3,9,Watford,17,England - Premier League
286,Juan Guillermo Cuadrado Bello,11,9,2,81.81818181818183,0,0,0,0.0,5,4,1,80.0,1,0,1,0.0,18.476908747265455,1,0,1,0.0,0,0,0,0,0,0,2,Chelsea,1,England - Premier League
287,Juan Manuel Iturbe Arévalo,27,19,8,70.37037037037037,4,4,0,100.0,18,14,4,77.77777777777779,1,1,0,100.0,14.592635185173334,0,0,0,0.0,1,0,4,3,3,2,1,AFC Bournemouth,2,England - Premier League
288,Juan Manuel Mata García,1914,1634,280,85.37095088819227,176,136,40,77.27272727272727,1325,1237,88,93.35849056603773,153,71,82,46.40522875816993,16.773184007412603,52,10,42,19.230769230769234,46,5,61,40,26,12,41,Manchester United,38,England - Premier League
289,Juan Miguel Jiménez López,51,40,11,78.43137254901961,2,0,2,0.0,33,30,3,90.9090909090909,1,0,1,0.0,14.85985058922353,2,0,2,0.0,3,0,4,3,2,2,5,Southampton,12,England - Premier League
290,Julián Speroni,68,41,27,60.29411764705882,7,3,4,42.857142857142854,15,15,0,100.0,49,23,26,46.93877551020408,45.56625340928823,0,0,0,0.0,0,0,0,0,0,0,0,Crystal Palace,2,England - Premier League
291,Junior Stanislas,776,547,229,70.4896907216495,59,37,22,62.71186440677966,523,426,97,81.45315487571702,83,24,59,28.915662650602407,16.15759877407268,43,15,28,34.883720930232556,31,2,62,34,25,15,16,AFC Bournemouth,21,England - Premier League
292,Karl Darlow,246,119,127,48.3739837398374,54,21,33,38.88888888888889,29,29,0,100.0,192,69,123,35.9375,51.140290710286834,0,0,0,0.0,0,0,0,0,0,0,1,Newcastle United,9,England - Premier League
293,Kasper Schmeichel,1220,477,743,39.09836065573771,497,103,394,20.72434607645875,76,76,0,100.0,1029,298,731,28.960155490767736,57.97589977988557,0,0,0,0.0,6,0,1,1,0,0,1,Leicester City,38,England - Premier League
294,Kelechi Promise Iheanacho,349,268,81,76.79083094555874,29,14,15,48.275862068965516,250,211,39,84.39999999999999,8,2,6,25.0,12.966660257165845,10,5,5,50.0,12,1,17,15,14,12,6,Manchester City,26,England - Premier League
295,Kelvin Davis,29,14,15,48.275862068965516,0,0,0,0.0,9,8,1,88.88888888888889,17,3,14,17.647058823529413,41.069626019255175,0,0,0,0.0,0,0,0,0,0,0,0,Southampton,1,England - Premier League
296,Kevin De Bruyne,1314,946,368,71.99391171993912,130,89,41,68.46153846153847,864,699,165,80.90277777777779,142,64,78,45.07042253521127,17.402063922717204,89,24,65,26.96629213483146,69,9,73,43,36,19,23,Manchester City,25,England - Premier League
297,Kevin Linford Stewart,466,408,58,87.55364806866953,46,27,19,58.69565217391305,335,320,15,95.52238805970148,36,18,18,50.0,17.733454355154592,0,0,0,0.0,3,0,10,7,3,2,18,Liverpool,7,England - Premier League
298,Kevin Mbabu,56,30,26,53.57142857142857,7,3,4,42.857142857142854,18,14,4,77.77777777777779,12,4,8,33.33333333333333,23.098442136235715,2,0,2,0.0,1,0,4,3,3,2,2,Newcastle United,3,England - Premier League
299,Kevin Mirallas,382,296,86,77.4869109947644,39,25,14,64.1025641025641,230,209,21,90.8695652173913,48,15,33,31.25,18.411250739645027,24,5,19,20.833333333333336,14,2,37,21,22,11,21,Everton,23,England - Premier League
300,Kevin Nolan,14,13,1,92.85714285714286,1,0,1,0.0,11,11,0,100.0,1,0,1,0.0,14.53623343554857,0,0,0,0.0,0,0,1,1,0,0,0,West Ham United,2,England - Premier League
301,Kevin Toner,125,92,33,73.6,21,8,13,38.095238095238095,58,54,4,93.10344827586206,17,4,13,23.52941176470588,19.84956044133312,2,1,1,50.0,0,1,1,0,1,0,4,Aston Villa,4,England - Premier League
302,Kevin Wimmer,543,487,56,89.68692449355433,45,29,16,64.44444444444444,345,334,11,96.81159420289856,52,26,26,50.0,21.495119391779006,0,0,0,0.0,1,0,0,0,0,0,3,Tottenham Hotspur,10,England - Premier League
303,Kieran Gibbs,219,163,56,74.42922374429224,24,15,9,62.5,132,122,10,92.42424242424242,20,4,16,20.0,16.928032565487122,5,1,4,20.0,1,0,11,4,7,3,5,Arsenal,15,England - Premier League
304,Kieran O''Neill Dowell,35,25,10,71.42857142857143,4,2,2,50.0,19,16,3,84.21052631578947,4,1,3,25.0,15.870125848566857,4,0,4,0.0,1,0,5,2,0,0,0,Everton,2,England - Premier League
305,Kieran Richardson,347,260,87,74.92795389048992,29,18,11,62.06896551724138,160,149,11,93.125,35,13,22,37.142857142857146,16.901221761088184,16,4,12,25.0,3,2,12,8,4,2,3,Aston Villa,11,England - Premier League
306,Kieran Trippier,355,252,103,70.98591549295776,40,21,19,52.5,155,142,13,91.61290322580645,50,15,35,30.0,18.976060747878083,28,7,21,25.0,5,1,7,2,3,0,11,Tottenham Hotspur,6,England - Premier League
307,Kolo Habib Touré,457,384,73,84.02625820568927,41,15,26,36.58536585365854,321,302,19,94.0809968847352,45,9,36,20.0,20.095691843535754,1,0,1,0.0,1,0,5,4,2,1,3,Liverpool,14,England - Premier League
308,Kristoffer Nordfeldt,29,23,6,79.3103448275862,2,1,1,50.0,8,8,0,100.0,16,10,6,62.5,43.1457812145931,0,0,0,0.0,0,0,0,0,0,0,0,Swansea City,1,England - Premier League
309,Kurt Happy Zouma,736,610,126,82.88043478260869,49,17,32,34.69387755102041,436,424,12,97.24770642201835,64,17,47,26.5625,20.83398118936337,4,1,3,25.0,0,0,8,4,1,1,9,Chelsea,23,England - Premier League
310,Kyle Bartley,139,108,31,77.6978417266187,11,3,8,27.27272727272727,75,70,5,93.33333333333333,16,5,11,31.25,21.713742627617265,0,0,0,0.0,0,0,1,1,0,0,5,Swansea City,5,England - Premier League
311,Kyle Lafferty,7,4,3,57.14285714285714,0,0,0,0.0,1,1,0,100.0,0,0,0,0.0,13.790224199314286,0,0,0,0.0,0,0,0,0,0,0,0,Norwich City,1,England - Premier League
312,Kyle Naughton,1388,1082,306,77.95389048991355,172,96,76,55.81395348837209,710,666,44,93.80281690140845,133,47,86,35.338345864661655,17.953716246332164,39,11,28,28.205128205128204,16,3,22,11,6,2,22,Swansea City,27,England - Premier League
313,Kyle Walker,1732,1315,417,75.92378752886836,215,129,86,60.0,802,722,80,90.02493765586036,256,111,145,43.359375,20.651584037775795,64,22,42,34.375,32,2,48,20,22,8,33,Tottenham Hotspur,33,England - Premier League
314,Lamine Koné,405,260,145,64.19753086419753,89,22,67,24.719101123595504,179,164,15,91.62011173184358,101,19,82,18.81188118811881,24.540436575224888,2,1,1,50.0,2,1,5,4,3,3,6,Sunderland,15,England - Premier League
315,Laurent Koscielny,1671,1458,213,87.25314183123878,169,99,70,58.57988165680473,1049,1008,41,96.09151572926596,130,51,79,39.23076923076923,20.468284149762443,2,0,2,0.0,9,0,8,5,1,0,26,Arsenal,33,England - Premier League
316,Leandro Bacuna,1389,1034,355,74.44204463642909,189,98,91,51.85185185185185,680,626,54,92.05882352941175,221,83,138,37.55656108597285,20.455987826218315,53,12,41,22.641509433962266,17,0,52,29,16,8,15,Aston Villa,31,England - Premier League
317,Lee Cattermole,970,729,241,75.15463917525773,180,89,91,49.44444444444444,509,454,55,89.19449901768172,137,58,79,42.33576642335766,20.276685603750433,8,3,5,37.5,20,0,19,14,6,4,20,Sunderland,31,England - Premier League
318,Lee Tomlin,122,84,38,68.85245901639344,13,4,9,30.76923076923077,82,67,15,81.70731707317073,8,2,6,25.0,14.655481389395408,0,0,0,0.0,7,0,9,4,6,2,9,AFC Bournemouth,6,England - Premier League
319,Leighton Baines,1023,793,230,77.51710654936461,118,79,39,66.94915254237289,541,502,39,92.79112754158965,146,55,91,37.67123287671233,19.46156942724739,55,12,43,21.818181818181817,20,1,16,8,6,1,20,Everton,18,England - Premier League
320,Leon Britton,1002,884,118,88.22355289421158,104,80,24,76.92307692307693,735,695,40,94.5578231292517,15,7,8,46.666666666666664,16.24148695234994,2,0,2,0.0,4,0,21,16,6,3,22,Swansea City,25,England - Premier League
321,Leon Osman,152,124,28,81.57894736842105,12,9,3,75.0,123,109,14,88.6178861788618,4,2,2,50.0,14.519547861906316,3,1,2,33.33333333333333,0,0,3,1,1,0,6,Everton,9,England - Premier League
322,Leroy Fer,435,369,66,84.82758620689656,69,43,26,62.31884057971014,280,264,16,94.28571428571428,23,12,11,52.17391304347826,18.33183370189738,0,0,0,0.0,6,2,19,12,6,4,18,Swansea City,11,England - Premier League
323,Lewis Grabban,327,274,53,83.79204892966361,24,17,7,70.83333333333334,247,219,28,88.66396761133603,10,4,6,40.0,13.72682906946275,9,3,6,33.33333333333333,7,0,25,13,13,6,5,AFC Bournemouth,21,England - Premier League
324,Libor Kozák,73,46,27,63.013698630136986,6,3,3,50.0,24,20,4,83.33333333333334,1,0,1,0.0,12.311459807217533,1,0,1,0.0,3,0,3,1,3,1,3,Aston Villa,4,England - Premier League
325,Loïc Rémy,103,87,16,84.46601941747572,6,6,0,100.0,74,68,6,91.8918918918919,3,2,1,66.66666666666666,12.54928453796272,5,1,4,20.0,3,0,9,8,5,4,6,Chelsea,13,England - Premier League
326,Lucas Pezzini Leiva,1478,1239,239,83.82949932341002,189,131,58,69.31216931216932,907,859,48,94.70782800441015,79,29,50,36.708860759493675,19.648773815211523,4,0,4,0.0,20,1,20,16,5,4,21,Liverpool,27,England - Premier League
327,Luis Antonio Valencia Mosquera,709,605,104,85.33145275035261,59,42,17,71.1864406779661,450,421,29,93.55555555555556,48,20,28,41.66666666666667,15.895700729807052,28,12,16,42.857142857142854,5,3,26,22,14,11,8,Manchester United,14,England - Premier League
328,Luke Shaw,351,291,60,82.90598290598291,36,24,12,66.66666666666666,202,185,17,91.58415841584159,19,11,8,57.89473684210527,16.795409728574356,10,5,5,50.0,3,1,7,6,2,1,3,Manchester United,5,England - Premier League
329,Maarten Stekelenburg,467,289,178,61.88436830835118,83,21,62,25.301204819277107,149,149,0,100.0,274,102,172,37.22627737226277,45.139218556673065,0,0,0,0.0,1,0,0,0,0,0,2,Southampton,17,England - Premier League
330,Mamadou Obbi Oularé,3,2,1,66.66666666666666,0,0,0,0.0,0,0,0,0.0,0,0,0,0.0,10.94407400208,0,0,0,0.0,0,0,0,0,0,0,0,Watford,2,England - Premier League
331,Mamadou Sakho,1244,1092,152,87.78135048231512,107,72,35,67.28971962616822,841,807,34,95.95719381688465,78,36,42,46.15384615384615,18.886132134553893,0,0,0,0.0,4,0,3,3,0,0,16,Liverpool,22,England - Premier League
332,Mame Biram Diouf,272,199,73,73.16176470588235,22,8,14,36.36363636363637,137,124,13,90.51094890510949,18,7,11,38.88888888888889,14.557122075521912,5,1,4,20.0,7,1,21,12,10,4,28,Stoke City,26,England - Premier League
333,Manuel García Alonso,19,19,0,100.0,1,1,0,100.0,14,14,0,100.0,1,1,0,100.0,17.79912678179368,0,0,0,0.0,0,0,0,0,0,0,0,Manchester City,1,England - Premier League
334,Manuel Lanzini,1119,969,150,86.59517426273459,102,74,28,72.54901960784314,829,768,61,92.64173703256937,56,27,29,48.214285714285715,15.570563815463164,24,10,14,41.66666666666667,32,2,86,51,40,22,39,West Ham United,26,England - Premier League
335,Marc Albrighton,1214,671,543,55.271828665568364,223,94,129,42.152466367713004,497,415,82,83.5010060362173,326,91,235,27.914110429447852,21.281698260517757,142,32,110,22.535211267605636,55,7,100,61,56,29,32,Leicester City,38,England - Premier League
336,Marc Muniesa Martínez,558,458,100,82.07885304659499,60,35,25,58.333333333333336,325,308,17,94.76923076923077,58,17,41,29.310344827586203,19.79582616424774,10,2,8,20.0,4,0,12,6,5,1,7,Stoke City,15,England - Premier League
337,Marc Pugh,555,407,148,73.33333333333333,39,32,7,82.05128205128204,372,322,50,86.55913978494624,44,21,23,47.72727272727273,15.041108077359569,32,10,22,31.25,12,2,60,28,34,16,28,AFC Bournemouth,26,England - Premier League
338,Marc Wilson,113,86,27,76.10619469026548,17,6,11,35.294117647058826,53,51,2,96.22641509433963,20,6,14,30.0,27.017814261268672,1,1,0,100.0,1,0,2,1,0,0,3,Stoke City,4,England - Premier League
339,Marcin Ryszard Wasilewski,79,58,21,73.41772151898735,11,4,7,36.36363636363637,38,38,0,100.0,14,5,9,35.714285714285715,19.635025740753417,0,0,0,0.0,0,0,0,0,0,0,0,Leicester City,4,England - Premier League
340,Marco van Ginkel,387,308,79,79.58656330749353,67,43,24,64.17910447761194,247,227,20,91.90283400809717,36,17,19,47.22222222222222,17.729346092057675,5,0,5,0.0,5,0,9,5,3,3,11,Stoke City,17,England - Premier League
341,Marcus Rashford,209,155,54,74.16267942583733,6,4,2,66.66666666666666,158,123,35,77.84810126582279,2,0,2,0.0,11.69192536837665,8,0,8,0.0,5,3,36,13,29,11,10,Manchester United,11,England - Premier League
342,Mario Suárez Mata,427,340,87,79.62529274004683,78,50,28,64.1025641025641,272,245,27,90.07352941176471,37,16,21,43.24324324324324,18.890090052786885,2,1,1,50.0,6,0,11,8,5,4,5,Watford,15,England - Premier League
343,Mark Bunn,270,131,139,48.51851851851852,58,19,39,32.758620689655174,30,30,0,100.0,220,84,136,38.18181818181819,50.865244679941334,0,0,0,0.0,0,0,0,0,0,0,0,Aston Villa,10,England - Premier League
344,Mark Noble,1943,1662,281,85.53782810087493,285,189,96,66.3157894736842,1183,1116,67,94.33643279797126,193,108,85,55.95854922279793,18.633486624911406,16,8,8,50.0,43,4,40,28,9,7,60,West Ham United,37,England - Premier League
345,Marko Arnautović,1161,895,266,77.08871662360033,93,50,43,53.76344086021505,819,697,122,85.1037851037851,66,28,38,42.42424242424242,15.960207888527751,47,16,31,34.04255319148936,44,6,134,77,65,34,33,Stoke City,34,England - Premier League
346,Marouane Chamakh,91,72,19,79.12087912087912,12,6,6,50.0,52,45,7,86.53846153846155,1,0,1,0.0,12.019890380645275,1,0,1,0.0,4,0,4,1,2,0,5,Crystal Palace,10,England - Premier League
347,Marouane Fellaini-Bakkioui,601,494,107,82.19633943427621,54,36,18,66.66666666666666,381,351,30,92.1259842519685,13,4,9,30.76923076923077,15.263691445865291,2,1,1,50.0,10,0,21,12,8,4,15,Manchester United,18,England - Premier League
348,Martin Kelly,540,393,147,72.77777777777777,67,35,32,52.23880597014925,236,208,28,88.13559322033898,73,18,55,24.65753424657534,18.027551869301334,13,2,11,15.384615384615385,3,0,6,4,1,1,3,Crystal Palace,13,England - Premier League
349,Martin Olsson,723,446,277,61.68741355463347,107,36,71,33.64485981308411,235,205,30,87.2340425531915,131,29,102,22.137404580152673,20.23363790999104,50,13,37,26.0,6,2,16,6,12,3,20,Norwich City,24,England - Premier League
350,Martin Škrtel,1146,1005,141,87.69633507853402,80,36,44,45.0,740,732,8,98.91891891891892,92,31,61,33.69565217391305,20.55132346709906,1,1,0,100.0,5,0,2,2,0,0,6,Liverpool,22,England - Premier League
351,Martín Gastón Demichelis,567,488,79,86.06701940035273,62,44,18,70.96774193548387,378,366,12,96.82539682539682,33,14,19,42.42424242424242,18.843633661803175,0,0,0,0.0,4,0,6,5,1,1,8,Manchester City,20,England - Premier League
352,Marvin Emnes,15,9,6,60.0,1,1,0,100.0,10,7,3,70.0,0,0,0,0.0,10.97418644376,1,0,1,0.0,0,0,4,2,1,0,0,Swansea City,2,England - Premier League
353,Massadio Haïdara,319,248,71,77.74294670846395,33,21,12,63.63636363636363,176,161,15,91.47727272727273,27,6,21,22.22222222222222,16.44586891023047,8,3,5,37.5,3,0,9,6,3,1,10,Newcastle United,7,England - Premier League
354,Mathieu Debuchy,101,74,27,73.26732673267327,22,18,4,81.81818181818183,41,39,2,95.1219512195122,10,1,9,10.0,16.870940223754456,3,0,3,0.0,1,0,3,1,2,0,1,Arsenal,2,England - Premier League
355,Mathieu Flamini,627,548,79,87.40031897926634,83,64,19,77.10843373493977,427,406,21,95.08196721311475,28,11,17,39.285714285714285,16.393847218754065,2,1,1,50.0,4,0,5,2,1,0,8,Arsenal,16,England - Premier League
356,Matt Grimes,46,34,12,73.91304347826086,7,4,3,57.14285714285714,33,30,3,90.9090909090909,5,1,4,20.0,18.94708748967652,1,0,1,0.0,1,0,0,0,0,0,1,Swansea City,1,England - Premier League
357,Matt Jarvis,367,237,130,64.57765667574932,21,12,9,57.14285714285714,187,157,30,83.9572192513369,50,16,34,32.0,16.62485143455368,51,12,39,23.52941176470588,14,1,15,9,11,5,8,Norwich City,22,England - Premier League
358,Matt Miazga,88,72,16,81.81818181818183,7,1,6,14.285714285714285,55,54,1,98.18181818181819,8,1,7,12.5,22.215581465023636,0,0,0,0.0,0,0,0,0,0,0,2,Chelsea,2,England - Premier League
359,Matt Ritchie,1675,1176,499,70.2089552238806,190,92,98,48.421052631578945,912,785,127,86.07456140350878,261,98,163,37.547892720306514,19.406863629726704,89,25,64,28.08988764044944,35,6,49,26,26,10,62,AFC Bournemouth,37,England - Premier League
360,Matt Targett,555,412,143,74.23423423423424,67,44,23,65.67164179104478,251,225,26,89.64143426294821,70,38,32,54.285714285714285,18.47795746572065,27,11,16,40.74074074074074,4,1,5,3,2,1,13,Southampton,14,England - Premier League
361,Matteo Darmian,1157,908,249,78.47882454624028,123,78,45,63.41463414634146,639,580,59,90.76682316118936,97,24,73,24.742268041237114,17.475426274716714,39,12,27,30.76923076923077,11,0,19,10,12,5,23,Manchester United,28,England - Premier League
362,Matthew Pennington,172,147,25,85.46511627906976,13,8,5,61.53846153846154,116,113,3,97.41379310344827,10,2,8,20.0,17.729268306802325,1,0,1,0.0,0,0,1,1,1,1,1,Everton,4,England - Premier League
363,Mauro Matías Zárate,336,249,87,74.10714285714286,21,16,5,76.19047619047619,191,167,24,87.43455497382199,46,16,30,34.78260869565217,16.887148393529998,22,7,15,31.818181818181817,17,0,47,26,27,14,23,West Ham United,15,England - Premier League
364,Max-Alain Gradel,339,224,115,66.07669616519173,18,5,13,27.77777777777778,214,177,37,82.71028037383178,46,16,30,34.78260869565217,16.6878479293954,27,6,21,22.22222222222222,8,2,45,20,34,15,26,AFC Bournemouth,14,England - Premier League
365,Maya Yoshida,567,441,126,77.77777777777779,71,29,42,40.845070422535215,281,269,12,95.72953736654804,88,31,57,35.22727272727273,21.816278518377143,4,1,3,25.0,2,0,8,6,1,0,7,Southampton,20,England - Premier League
366,Memphis Depay,751,547,204,72.83621837549934,47,27,20,57.446808510638306,478,409,69,85.56485355648536,71,23,48,32.3943661971831,15.640966492324154,63,11,52,17.46031746031746,12,0,66,33,53,26,39,Manchester United,29,England - Premier League
367,Mesut Özil,2511,2050,461,81.64078056551175,279,209,70,74.91039426523297,1746,1561,185,89.40435280641466,274,132,142,48.175182481751825,16.015137953136346,89,43,46,48.31460674157304,123,19,92,54,37,25,53,Arsenal,35,England - Premier League
368,Micah Richards,783,654,129,83.5249042145594,72,47,25,65.27777777777779,450,435,15,96.66666666666667,64,27,37,42.1875,18.464595592609655,2,1,1,50.0,6,1,30,22,8,3,31,Aston Villa,24,England - Premier League
369,Michael Carrick,1562,1353,209,86.61971830985915,287,215,72,74.91289198606272,1008,950,58,94.24603174603175,137,73,64,53.284671532846716,19.91047544509598,6,3,3,50.0,8,0,12,7,1,0,19,Manchester United,27,England - Premier League
370,Michail Antonio,708,460,248,64.97175141242938,69,32,37,46.3768115942029,312,252,60,80.76923076923077,125,51,74,40.8,19.04153159217051,56,17,39,30.357142857142854,19,3,94,59,56,32,37,West Ham United,26,England - Premier League
371,Michel Vorm,49,47,2,95.91836734693877,0,0,0,0.0,32,32,0,100.0,6,4,2,66.66666666666666,25.599275087289794,0,0,0,0.0,0,0,0,0,0,0,0,Tottenham Hotspur,1,England - Premier League
372,Miguel Arturo Layún Prado,60,45,15,75.0,1,1,0,100.0,42,37,5,88.09523809523809,4,1,3,25.0,14.605320623184001,6,1,5,16.666666666666664,2,0,4,4,1,1,1,Watford,3,England - Premier League
373,Miguel Ángel Britos Cabrera,772,529,243,68.52331606217616,144,50,94,34.72222222222222,303,294,9,97.02970297029702,221,76,145,34.38914027149321,25.384263659205388,1,1,0,100.0,0,0,8,7,0,0,18,Watford,24,England - Premier League
374,Mikel Arteta Amatriain,128,113,15,88.28125,16,11,5,68.75,79,78,1,98.73417721518987,6,3,3,50.0,17.551989127996876,0,0,0,0.0,1,0,2,1,1,0,7,Arsenal,9,England - Premier League
375,Mile Jedinak,828,604,224,72.94685990338165,130,66,64,50.76923076923077,344,317,27,92.15116279069767,85,32,53,37.64705882352941,18.808847368149564,8,3,5,37.5,9,0,6,5,0,0,19,Crystal Palace,27,England - Premier League
376,Modibo Maïga,12,5,7,41.66666666666667,0,0,0,0.0,5,3,2,60.0,0,0,0,0.0,12.1474445646,2,0,2,0.0,0,0,5,4,4,3,1,West Ham United,3,England - Premier League
377,Modou Barrow,235,172,63,73.19148936170212,9,4,5,44.44444444444444,162,138,24,85.18518518518519,17,3,14,17.647058823529413,14.743855094789106,25,8,17,32.0,12,3,51,30,38,21,27,Swansea City,22,England - Premier League
378,Mohamed Naser Elsayed Elneny,744,685,59,92.06989247311827,78,64,14,82.05128205128204,579,560,19,96.71848013816926,34,17,17,50.0,16.29038634363387,3,0,3,0.0,2,1,8,4,3,0,13,Arsenal,11,England - Premier League
379,Morgan Schneiderlin,1484,1321,163,89.01617250673854,175,132,43,75.42857142857143,1010,975,35,96.53465346534654,104,62,42,59.61538461538461,17.736787915017818,5,0,5,0.0,9,0,26,19,6,5,18,Manchester United,29,England - Premier League
380,Mousa Sidi Yaya Dembélé,1383,1238,145,89.51554591467824,137,110,27,80.2919708029197,1064,1006,58,94.54887218045113,20,5,15,25.0,15.796445353309847,5,1,4,20.0,25,1,101,81,36,26,48,Tottenham Hotspur,29,England - Premier League
381,Moussa Sissoko,1576,1142,434,72.46192893401016,167,95,72,56.886227544910184,966,802,164,83.02277432712215,110,54,56,49.09090909090909,15.403543195693704,114,45,69,39.473684210526315,50,7,148,78,60,31,38,Newcastle United,37,England - Premier League
382,Muhamed Bešić,352,300,52,85.22727272727273,26,18,8,69.23076923076923,254,227,27,89.37007874015748,20,13,7,65.0,17.719097261240453,3,1,2,33.33333333333333,4,0,16,11,5,4,3,Everton,12,England - Premier League
383,N''Golo Kanté,1476,1202,274,81.43631436314364,169,121,48,71.59763313609467,934,847,87,90.68522483940042,85,42,43,49.411764705882355,15.985876545501464,20,10,10,50.0,24,3,63,48,19,14,30,Leicester City,37,England - Premier League
384,Nabil Bentaleb,100,78,22,78.0,14,8,6,57.14285714285714,67,60,7,89.55223880597015,9,2,7,22.22222222222222,18.8559693708408,0,0,0,0.0,2,0,5,4,1,1,1,Tottenham Hotspur,5,England - Premier League
385,Nacer Chadli,388,315,73,81.18556701030928,30,23,7,76.66666666666667,260,239,21,91.92307692307692,17,9,8,52.94117647058824,14.516913043709073,11,4,7,36.36363636363637,19,2,34,13,25,9,8,Tottenham Hotspur,28,England - Premier League
386,Nathan Aké,905,615,290,67.95580110497238,116,62,54,53.44827586206896,349,313,36,89.68481375358166,93,30,63,32.25806451612903,17.327561909167372,22,5,17,22.727272727272727,7,0,12,7,4,2,12,Watford,24,England - Premier League
387,Nathan Dyer,90,67,23,74.44444444444444,12,5,7,41.66666666666667,61,50,11,81.9672131147541,4,1,3,25.0,12.50005988426,4,1,3,25.0,4,1,15,7,8,3,11,Leicester City,13,England - Premier League
388,Nathan Redmond,1084,761,323,70.20295202952029,92,54,38,58.69565217391305,686,574,112,83.6734693877551,97,25,72,25.773195876288657,16.594478672359486,73,12,61,16.43835616438356,37,3,96,61,46,27,42,Norwich City,35,England - Premier League
389,Nathaniel Edwin Clyne,1943,1520,423,78.22954194544519,260,165,95,63.46153846153846,1117,997,120,89.25693822739481,161,47,114,29.19254658385093,16.85691667869406,54,13,41,24.074074074074073,28,0,32,18,13,6,26,Liverpool,33,England - Premier League
390,Neil Taylor,1639,1292,347,78.82855399633924,196,117,79,59.693877551020414,859,788,71,91.73457508731082,162,60,102,37.03703703703704,17.211372801474507,55,16,39,29.09090909090909,15,1,29,12,10,3,29,Swansea City,34,England - Premier League
391,Nemanja Matić,1653,1429,224,86.44888082274652,166,111,55,66.86746987951807,1136,1071,65,94.27816901408451,66,36,30,54.54545454545454,17.280029588822025,15,7,8,46.666666666666664,14,2,33,27,13,11,22,Chelsea,33,England - Premier League
392,Nick Powell,2,1,1,50.0,0,0,0,0.0,1,1,0,100.0,0,0,0,0.0,13.738993045199999,0,0,0,0.0,0,0,0,0,0,0,0,Manchester United,1,England - Premier League
393,Nicolás Hernán Otamendi,1561,1344,217,86.09865470852019,164,95,69,57.92682926829268,1012,977,35,96.54150197628458,134,52,82,38.80597014925373,20.53538851988433,0,0,0,0.0,4,0,11,8,0,0,30,Manchester City,30,England - Premier League
394,Nikica Jelavić,78,51,27,65.38461538461539,6,3,3,50.0,31,28,3,90.32258064516128,1,0,1,0.0,11.97252331463077,4,2,2,50.0,6,1,5,4,4,3,4,West Ham United,13,England - Premier League
395,Nordin Amrabat,193,133,60,68.9119170984456,11,5,6,45.45454545454545,112,98,14,87.5,26,7,19,26.923076923076923,17.223743974823627,28,6,22,21.428571428571427,4,0,19,14,13,10,24,Watford,12,England - Premier League
396,Odion Jude Ighalo,707,532,175,75.24752475247524,38,15,23,39.473684210526315,452,380,72,84.070796460177,13,7,6,53.84615384615385,11.675980657874648,10,4,6,40.0,31,2,92,53,61,38,60,Watford,37,England - Premier League
397,Ola Toivonen,261,188,73,72.03065134099617,35,15,20,42.857142857142854,119,108,11,90.75630252100841,12,6,6,50.0,15.605206432750345,2,1,1,50.0,6,2,3,1,0,0,10,Sunderland,12,England - Premier League
398,Olivier Giroud,825,571,254,69.21212121212122,63,26,37,41.269841269841265,416,332,84,79.8076923076923,25,11,14,44.0,11.903555709682124,18,4,14,22.22222222222222,26,6,29,14,13,7,36,Arsenal,38,England - Premier League
399,Oluwaseyi Babajide Ojo,158,122,36,77.21518987341773,16,10,6,62.5,118,107,11,90.67796610169492,13,3,10,23.076923076923077,15.83761452823595,9,2,7,22.22222222222222,8,2,18,12,10,6,11,Liverpool,8,England - Premier League
400,Oriol Romeu Vidal,830,701,129,84.4578313253012,127,89,38,70.07874015748031,512,481,31,93.9453125,75,48,27,64.0,18.994649202010407,1,0,1,0.0,11,0,27,19,5,3,22,Southampton,29,England - Premier League
401,Osazemwinde Peter Odemwingie,54,45,9,83.33333333333334,3,3,0,100.0,34,33,1,97.05882352941177,4,0,4,0.0,16.6520720044,3,0,3,0.0,0,0,2,1,2,1,1,Stoke City,5,England - Premier League
402,Oscar dos Santos Emboaba Júnior,1096,882,214,80.47445255474453,136,99,37,72.79411764705883,703,623,80,88.62019914651493,97,57,40,58.76288659793815,16.8274536629515,38,13,25,34.21052631578947,27,3,74,39,48,23,42,Chelsea,27,England - Premier League
403,Pablo Javier Zabaleta Girod,722,604,118,83.65650969529086,82,58,24,70.73170731707317,425,403,22,94.82352941176471,37,10,27,27.027027027027028,14.564825205362327,10,2,8,20.0,0,1,9,4,5,4,9,Manchester City,13,England - Premier League
404,Paddy McNair,217,168,49,77.41935483870968,33,18,15,54.54545454545454,119,112,7,94.11764705882352,38,12,26,31.57894736842105,22.51568800374636,5,1,4,20.0,1,0,3,1,3,1,1,Manchester United,8,England - Premier League
405,Pape N''Diaye Souaré,1685,1195,490,70.91988130563797,227,103,124,45.37444933920705,735,665,70,90.47619047619048,266,72,194,27.06766917293233,19.606083133206553,93,20,73,21.50537634408602,26,1,45,29,20,15,35,Crystal Palace,34,England - Premier League
406,Papiss Demba Cissé,407,297,110,72.97297297297297,27,11,16,40.74074074074074,203,165,38,81.2807881773399,25,14,11,56.00000000000001,14.482551070649631,6,2,4,33.33333333333333,10,0,22,16,5,5,10,Newcastle United,21,England - Premier League
407,Patrick Bamford,96,62,34,64.58333333333334,8,5,3,62.5,60,45,15,75.0,1,1,0,100.0,10.93018264159125,4,1,3,25.0,2,0,2,2,2,2,4,Norwich City,13,England - Premier League
408,Patrick Roberts,4,4,0,100.0,0,0,0,0.0,3,3,0,100.0,0,0,0,0.0,11.7935812134,0,0,0,0.0,0,0,1,1,1,1,1,Manchester City,1,England - Premier League
409,Patrick van Aanholt,1417,1044,373,73.67678193366267,138,60,78,43.47826086956522,719,621,98,86.36995827538247,127,32,95,25.196850393700785,18.65418463038843,49,20,29,40.816326530612244,26,4,66,41,29,12,16,Sunderland,33,England - Premier League
410,Paul Dummett,880,633,247,71.93181818181819,131,65,66,49.61832061068702,335,309,26,92.23880597014926,139,43,96,30.935251798561154,19.867549192322315,17,5,12,29.411764705882355,3,0,6,6,1,1,11,Newcastle United,23,England - Premier League
411,Paulo Dino Gazzaniga,64,41,23,64.0625,13,3,10,23.076923076923077,12,12,0,100.0,42,19,23,45.23809523809524,49.6127806939125,0,0,0,0.0,0,0,0,0,0,0,0,Southampton,2,England - Premier League
412,Pedro Chirivella Burgos,31,24,7,77.41935483870968,2,1,1,50.0,24,21,3,87.5,5,2,3,40.0,17.653717175063225,0,0,0,0.0,0,0,1,0,0,0,0,Liverpool,1,England - Premier League
413,Pedro Eliezer Rodríguez Ledesma,1049,835,214,79.59961868446139,89,58,31,65.1685393258427,735,659,76,89.65986394557824,73,32,41,43.83561643835616,15.84120906046879,47,17,30,36.17021276595745,39,2,99,59,40,26,58,Chelsea,29,England - Premier League
414,Pedro Mba Obiang Avomo,478,371,107,77.61506276150628,70,37,33,52.85714285714286,284,256,28,90.14084507042254,40,18,22,45.0,18.21794886296887,4,0,4,0.0,2,1,15,9,4,3,16,West Ham United,23,England - Premier League
415,Per Mertesacker,1238,1116,122,90.14539579967689,63,42,21,66.66666666666666,813,795,18,97.7859778597786,67,23,44,34.32835820895522,19.232454883868435,0,0,0,0.0,1,0,2,2,0,0,9,Arsenal,24,England - Premier League
416,Peter Crouch,156,91,65,58.333333333333336,24,9,15,37.5,54,46,8,85.18518518518519,5,0,5,0.0,12.678453118453845,1,0,1,0.0,3,1,3,1,0,0,4,Stoke City,11,England - Premier League
417,Petr Čech,1036,654,382,63.12741312741312,193,60,133,31.088082901554404,278,278,0,100.0,636,258,378,40.56603773584906,46.094517390885635,0,0,0,0.0,2,0,2,2,0,0,5,Arsenal,34,England - Premier League
418,Phil Bardsley,382,289,93,75.6544502617801,68,32,36,47.05882352941176,175,165,10,94.28571428571428,68,28,40,41.17647058823529,20.243690088987016,16,3,13,18.75,2,1,4,2,1,1,16,Stoke City,11,England - Premier League
419,Phil Jagielka,1062,895,167,84.27495291902072,127,66,61,51.96850393700787,554,539,15,97.29241877256317,176,77,99,43.75,24.030827272303053,2,1,1,50.0,3,0,6,4,1,1,14,Everton,21,England - Premier League
420,Phil Jones,321,273,48,85.04672897196261,44,26,18,59.09090909090909,204,197,7,96.56862745098039,28,10,18,35.714285714285715,19.42151279406056,1,1,0,100.0,0,0,1,0,0,0,3,Manchester United,10,England - Premier League
421,Philipp Wollscheid,1199,1009,190,84.1534612176814,91,43,48,47.25274725274725,690,665,25,96.37681159420289,153,60,93,39.21568627450981,22.075262826186414,0,0,0,0.0,4,0,9,8,0,0,19,Stoke City,31,England - Premier League
422,Philippe Coutinho Correia,1147,872,275,76.02441150828247,182,134,48,73.62637362637363,711,621,90,87.34177215189874,114,57,57,50.0,17.644442538872745,27,7,20,25.925925925925924,43,5,93,51,54,32,38,Liverpool,26,England - Premier League
423,Radamel Falcao García Zárate,85,64,21,75.29411764705883,5,3,2,60.0,58,50,8,86.20689655172413,2,2,0,100.0,12.350229436299388,0,0,0,0.0,2,0,7,3,4,2,7,Chelsea,10,England - Premier League
424,Raheem Sterling,904,727,177,80.42035398230088,58,42,16,72.41379310344827,712,633,79,88.90449438202246,29,5,24,17.24137931034483,12.8413960643743,44,5,39,11.363636363636363,33,2,83,48,53,32,58,Manchester City,31,England - Premier League
425,Ramires Santos do Nascimento,332,261,71,78.6144578313253,41,23,18,56.09756097560976,201,177,24,88.05970149253731,28,11,17,39.285714285714285,17.482274122051084,4,1,3,25.0,1,0,15,7,7,4,19,Chelsea,12,England - Premier League
426,Reece Oxford,57,47,10,82.45614035087719,4,2,2,50.0,35,32,3,91.42857142857143,6,1,5,16.666666666666664,19.44810474233684,0,0,0,0.0,0,0,0,0,0,0,1,West Ham United,7,England - Premier League
427,Rees Greenwood,20,16,4,80.0,2,2,0,100.0,15,13,2,86.66666666666667,0,0,0,0.0,13.909669151903998,2,0,2,0.0,1,0,2,1,2,1,0,Sunderland,1,England - Premier League
428,Rhu-endly Martina,581,422,159,72.63339070567987,94,46,48,48.93617021276596,265,233,32,87.9245283018868,86,39,47,45.348837209302324,19.546504475536935,33,12,21,36.36363636363637,11,1,5,3,3,2,12,Southampton,15,England - Premier League
429,Rickie Lambert,277,190,87,68.59205776173285,40,20,20,50.0,116,108,8,93.10344827586206,26,12,14,46.15384615384615,15.392365912444419,5,1,4,20.0,8,1,5,3,1,0,10,West Bromwich Albion,19,England - Premier League
430,Ritchie De Laet,332,212,120,63.85542168674698,69,25,44,36.231884057971016,109,96,13,88.07339449541286,61,21,40,34.42622950819672,19.405623363366796,12,5,7,41.66666666666667,4,0,11,3,9,2,5,Leicester City,12,England - Premier League
431,Riyad Mahrez,1174,816,358,69.50596252129472,132,75,57,56.81818181818182,641,533,108,83.15132605304211,145,58,87,40.0,16.81456751480821,78,24,54,30.76923076923077,56,10,218,123,131,68,92,Leicester City,37,England - Premier League
432,Rob Elliot,688,382,306,55.52325581395349,137,39,98,28.467153284671532,101,101,0,100.0,534,231,303,43.258426966292134,49.678618753405466,0,0,0,0.0,1,0,0,0,0,0,5,Newcastle United,21,England - Premier League
433,Robert Brady,1608,1016,592,63.18407960199005,254,116,138,45.66929133858268,684,570,114,83.33333333333334,314,90,224,28.662420382165603,20.499820792382685,114,27,87,23.684210526315788,51,2,79,48,41,27,18,Norwich City,36,England - Premier League
434,Robert Huth,794,612,182,77.07808564231739,76,29,47,38.15789473684211,354,349,5,98.58757062146893,98,32,66,32.6530612244898,20.35332350494549,1,1,0,100.0,1,0,4,4,1,1,18,Leicester City,35,England - Premier League
435,Robert Kenedy Nunes do Nascimento,323,268,55,82.97213622291022,26,18,8,69.23076923076923,232,211,21,90.94827586206897,21,8,13,38.095238095238095,15.01850831166836,10,1,9,10.0,5,0,34,22,20,13,10,Chelsea,14,England - Premier League
436,Roberto Firmino Barbosa de Oliveira,1045,778,267,74.44976076555024,85,50,35,58.82352941176471,717,581,136,81.03207810320781,36,14,22,38.88888888888889,14.060271210290594,31,8,23,25.806451612903224,37,7,90,55,48,31,23,Liverpool,31,England - Premier League
437,Rolando Aarons,170,140,30,82.35294117647058,9,6,3,66.66666666666666,86,81,5,94.18604651162791,17,10,7,58.82352941176471,16.601273426202354,11,4,7,36.36363636363637,3,1,20,8,7,3,9,Newcastle United,10,England - Premier League
438,Romelu Lukaku Menama,1112,804,308,72.3021582733813,116,53,63,45.689655172413794,707,598,109,84.58274398868458,28,14,14,50.0,12.939272933230942,28,4,24,14.285714285714285,43,6,88,46,58,27,35,Everton,37,England - Premier League
439,Ross Barkley,1921,1593,328,82.92555960437272,227,159,68,70.04405286343612,1376,1258,118,91.42441860465115,149,57,92,38.25503355704698,17.57634425799967,36,12,24,33.33333333333333,54,8,145,94,84,55,86,Everton,38,England - Premier League
440,Ruben Loftus-Cheek,248,209,39,84.2741935483871,19,10,9,52.63157894736842,199,180,19,90.45226130653266,1,1,0,100.0,13.271285217968709,1,0,1,0.0,4,0,19,9,8,4,14,Chelsea,13,England - Premier League
441,Rudy Gestede,594,348,246,58.58585858585859,84,25,59,29.761904761904763,196,165,31,84.18367346938776,9,2,7,22.22222222222222,12.404196828705455,5,1,4,20.0,11,1,20,13,12,7,14,Aston Villa,32,England - Premier League
442,Russell Martin,1332,973,359,73.04804804804806,246,98,148,39.83739837398374,565,518,47,91.68141592920354,260,101,159,38.84615384615385,22.246556683506487,22,6,16,27.27272727272727,9,0,10,1,4,1,8,Norwich City,30,England - Premier League
443,Ryan Allsop,10,9,1,90.0,0,0,0,0.0,6,6,0,100.0,2,1,1,50.0,27.7853392476,0,0,0,0.0,0,0,0,0,0,0,0,AFC Bournemouth,1,England - Premier League
444,Ryan Bennett,606,447,159,73.76237623762376,111,42,69,37.83783783783784,244,231,13,94.67213114754098,120,42,78,35.0,24.451650861260198,0,0,0,0.0,4,0,1,1,0,0,7,Norwich City,22,England - Premier League
445,Ryan Bertrand,1565,1170,395,74.76038338658148,175,108,67,61.71428571428571,748,682,66,91.17647058823529,215,72,143,33.48837209302326,17.885902751884984,72,16,56,22.22222222222222,19,3,44,20,33,12,29,Southampton,32,England - Premier League
446,Ryan Mason,543,453,90,83.42541436464089,85,61,24,71.76470588235294,354,331,23,93.50282485875707,51,25,26,49.01960784313725,18.67248567040309,11,4,7,36.36363636363637,12,0,15,9,6,4,11,Tottenham Hotspur,22,England - Premier League
447,Ryan Shawcross,590,448,142,75.9322033898305,88,36,52,40.909090909090914,315,302,13,95.87301587301587,105,39,66,37.142857142857146,22.505540315917422,2,0,2,0.0,1,0,7,4,2,0,2,Stoke City,20,England - Premier League
448,Sadio Mané,1043,815,228,78.13998082454458,80,62,18,77.5,703,590,113,83.92603129445236,48,23,25,47.91666666666667,14.972904756631708,65,23,42,35.38461538461539,37,6,147,80,77,42,87,Southampton,37,England - Premier League
449,Saido Berahino,473,356,117,75.26427061310783,42,26,16,61.904761904761905,296,255,41,86.14864864864865,21,7,14,33.33333333333333,15.989465399967019,12,3,9,25.0,18,0,44,30,18,13,28,West Bromwich Albion,31,England - Premier League
450,Sam Field,2,1,1,50.0,0,0,0,0.0,1,1,0,100.0,0,0,0,0.0,8.4437209332,0,0,0,0.0,0,0,0,0,0,0,1,West Bromwich Albion,1,England - Premier League
451,Samir Nasri,437,398,39,91.07551487414187,34,30,4,88.23529411764706,342,323,19,94.44444444444444,18,14,4,77.77777777777779,14.444125292301692,9,3,6,33.33333333333333,7,2,18,10,9,4,7,Manchester City,12,England - Premier League
452,Samuel Mark Byram,140,96,44,68.57142857142857,31,13,18,41.935483870967744,54,50,4,92.5925925925926,29,6,23,20.689655172413794,20.091774760236,9,2,7,22.22222222222222,2,0,0,0,0,0,4,West Ham United,4,England - Premier League
453,Sandro Ranieri Guimarães Cordeiro,145,97,48,66.89655172413794,22,9,13,40.909090909090914,74,65,9,87.83783783783784,9,3,6,33.33333333333333,18.309011957240276,2,2,0,100.0,1,0,3,3,0,0,6,West Bromwich Albion,10,England - Premier League
454,Santiago Cazorla González,1300,1128,172,86.76923076923076,180,148,32,82.22222222222221,927,878,49,94.71413160733549,120,64,56,53.333333333333336,17.773093423359693,23,8,15,34.78260869565217,36,3,45,35,15,13,15,Arsenal,15,England - Premier League
455,Scott Dann,1111,837,274,75.33753375337534,209,80,129,38.27751196172249,452,437,15,96.68141592920354,236,85,151,36.016949152542374,24.627095483393845,2,1,1,50.0,8,0,11,8,1,1,15,Crystal Palace,35,England - Premier League
456,Scott Sinclair,354,285,69,80.50847457627118,21,16,5,76.19047619047619,269,235,34,87.36059479553904,5,3,2,60.0,12.362099761572201,15,2,13,13.333333333333334,4,0,62,33,37,16,23,Aston Villa,26,England - Premier League
457,Sebastian Larsson,269,187,82,69.51672862453532,38,14,24,36.84210526315789,139,126,13,90.64748201438849,45,11,34,24.444444444444443,18.589263000635242,9,0,9,0.0,6,0,5,2,3,2,6,Sunderland,18,England - Premier League
458,Sebastian Prödl,538,397,141,73.7918215613383,83,29,54,34.93975903614458,230,226,4,98.26086956521739,119,38,81,31.932773109243694,23.78436879253918,1,1,0,100.0,2,0,1,0,0,0,6,Watford,21,England - Premier League
459,Sebastián Coates Nión,417,292,125,70.02398081534771,90,26,64,28.888888888888886,166,158,8,95.18072289156626,102,28,74,27.450980392156865,25.19442322690532,1,0,1,0.0,1,1,8,6,2,1,5,Sunderland,16,England - Premier League
460,Segundo Víctor Ibarbo Guerrero,28,18,10,64.28571428571429,3,1,2,33.33333333333333,15,14,1,93.33333333333333,5,0,5,0.0,18.148423289785715,2,0,2,0.0,0,0,3,1,0,0,1,Watford,4,England - Premier League
461,Serge Gnabry,7,6,1,85.71428571428571,0,0,0,0.0,5,5,0,100.0,1,1,0,100.0,13.861465103314286,0,0,0,0.0,1,0,4,2,3,1,0,West Bromwich Albion,1,England - Premier League
462,Sergi Canós Tenes,4,3,1,75.0,1,0,1,0.0,2,1,1,50.0,0,0,0,0.0,8.8178248332,0,0,0,0.0,0,0,0,0,0,0,0,Liverpool,1,England - Premier League
463,Sergio Germán Romero,140,91,49,65.0,18,3,15,16.666666666666664,44,44,0,100.0,69,24,45,34.78260869565217,38.000239219079994,0,0,0,0.0,0,0,0,0,0,0,0,Manchester United,4,England - Premier League
464,Sergio Leonel Agüero del Castillo,740,611,129,82.56756756756756,32,26,6,81.25,544,486,58,89.33823529411765,20,8,12,40.0,12.828509442209675,19,4,15,21.052631578947366,24,2,111,64,86,45,46,Manchester City,30,England - Premier League
465,Seydou Doumbia,8,6,2,75.0,0,0,0,0.0,8,6,2,75.0,0,0,0,0.0,8.19815964759,1,0,1,0.0,0,0,0,0,0,0,1,Newcastle United,3,England - Premier League
466,Shane Long,649,418,231,64.40677966101694,55,22,33,40.0,320,256,64,80.0,31,8,23,25.806451612903224,13.478819109696666,44,13,31,29.545454545454547,30,4,29,12,14,4,45,Southampton,28,England - Premier League
467,Shaun MacDonald,19,17,2,89.47368421052632,1,1,0,100.0,13,13,0,100.0,0,0,0,0.0,15.892296991995789,1,0,1,0.0,0,0,1,1,0,0,0,AFC Bournemouth,3,England - Premier League
468,Shay Given,67,44,23,65.67164179104478,6,1,5,16.666666666666664,9,9,0,100.0,52,30,22,57.692307692307686,47.910996733325376,0,0,0,0.0,0,0,0,0,0,0,1,Stoke City,3,England - Premier League
469,Shinji Okazaki,521,389,132,74.6641074856046,36,20,16,55.55555555555556,321,285,36,88.78504672897196,10,6,4,60.0,10.66888310497884,10,1,9,10.0,17,0,45,23,21,9,57,Leicester City,36,England - Premier League
470,Siem Stefan de Jong,200,153,47,76.5,20,15,5,75.0,115,98,17,85.21739130434783,3,2,1,66.66666666666666,12.646589582919601,2,0,2,0.0,1,1,8,4,4,2,6,Newcastle United,18,England - Premier League
471,Simon Francis,2454,1921,533,78.28035859820702,275,152,123,55.27272727272727,1193,1113,80,93.29421626152556,369,150,219,40.65040650406504,20.780952085304744,86,32,54,37.2093023255814,32,4,49,34,21,9,13,AFC Bournemouth,38,England - Premier League
472,Simon Mignolet,934,616,318,65.95289079229121,111,30,81,27.027027027027028,355,354,1,99.71830985915493,468,158,310,33.76068376068376,39.533536955696526,0,0,0,0.0,0,0,4,4,0,0,3,Liverpool,34,England - Premier League
473,Stephen Ireland,176,138,38,78.4090909090909,22,13,9,59.09090909090909,105,94,11,89.52380952380953,18,8,10,44.44444444444444,17.975189602808182,2,1,1,50.0,7,1,4,4,2,2,0,Stoke City,13,England - Premier League
474,Stephen Kingsley,155,112,43,72.25806451612902,11,4,7,36.36363636363637,74,66,8,89.1891891891892,29,9,20,31.03448275862069,20.83445078608568,13,3,10,23.076923076923077,1,1,5,5,0,0,3,Swansea City,4,England - Premier League
475,Steve Cook,1641,1312,329,79.95124923826936,182,81,101,44.505494505494504,831,801,30,96.38989169675091,249,102,147,40.963855421686745,23.84003535266501,3,0,3,0.0,4,0,1,0,0,0,10,AFC Bournemouth,36,England - Premier League
476,Steve Sidwell,7,6,1,85.71428571428571,1,0,1,0.0,5,5,0,100.0,1,0,1,0.0,15.247462592571427,0,0,0,0.0,0,0,0,0,0,0,0,Stoke City,1,England - Premier League
477,Steven Berghuis,113,74,39,65.48672566371681,15,11,4,73.33333333333333,63,47,16,74.60317460317461,26,13,13,50.0,21.788240980065133,13,4,9,30.76923076923077,6,2,5,4,2,1,4,Watford,9,England - Premier League
478,Steven Caulker,80,56,24,70.0,12,4,8,33.33333333333333,33,31,2,93.93939393939394,12,3,9,25.0,18.942034230918,0,0,0,0.0,1,0,1,1,0,0,0,Southampton,6,England - Premier League
479,Steven Davis,1634,1300,334,79.5593635250918,234,149,85,63.67521367521367,947,865,82,91.34107708553326,211,95,116,45.023696682464454,18.490180439628837,47,11,36,23.404255319148938,46,2,36,23,14,8,25,Southampton,34,England - Premier League
480,Steven Fletcher,294,186,108,63.26530612244898,39,12,27,30.76923076923077,120,106,14,88.33333333333333,14,5,9,35.714285714285715,13.63380811221551,8,0,8,0.0,10,0,26,14,11,4,16,Sunderland,16,England - Premier League
481,Steven Naismith,506,371,135,73.3201581027668,50,25,25,50.0,313,273,40,87.22044728434504,9,4,5,44.44444444444444,12.817689020339763,9,5,4,55.55555555555556,18,1,31,11,19,6,43,Norwich City,23,England - Premier League
482,Steven Pienaar,80,64,16,80.0,8,6,2,75.0,64,53,11,82.8125,2,1,1,50.0,14.889478932819,2,1,1,50.0,1,0,6,4,0,0,3,Everton,4,England - Premier League
483,Steven Taylor,316,273,43,86.39240506329115,27,14,13,51.85185185185185,210,202,8,96.19047619047619,32,7,25,21.875,20.51374857772329,0,0,0,0.0,1,0,2,1,2,1,4,Newcastle United,10,England - Premier League
484,Steven Whittaker,409,294,115,71.88264058679707,73,34,39,46.57534246575342,184,161,23,87.5,59,17,42,28.8135593220339,18.319668100413885,11,2,9,18.181818181818183,3,0,11,6,3,2,3,Norwich City,8,England - Premier League
485,Stéphane Sessègnon,638,463,175,72.5705329153605,47,29,18,61.702127659574465,394,347,47,88.07106598984772,62,20,42,32.25806451612903,16.394090387922507,51,12,39,23.52941176470588,26,2,84,50,47,29,59,West Bromwich Albion,25,England - Premier League
486,Sullay Kaikai,20,14,6,70.0,0,0,0,0.0,12,11,1,91.66666666666666,5,1,4,20.0,20.736287222796,2,0,2,0.0,2,0,0,0,0,0,0,Crystal Palace,1,England - Premier League
487,Sung-Yeung Ki,1189,1074,115,90.32800672834314,141,114,27,80.85106382978722,794,756,38,95.21410579345087,58,45,13,77.58620689655173,19.075178499934466,6,3,3,50.0,21,1,20,13,9,6,26,Swansea City,28,England - Premier League
488,Sylvain Distin,479,394,85,82.25469728601253,41,28,13,68.29268292682927,261,248,13,95.01915708812261,37,14,23,37.83783783783784,20.058887281970105,0,0,0,0.0,0,0,3,3,0,0,2,AFC Bournemouth,11,England - Premier League
489,Séamus Coleman,1398,1125,273,80.47210300429185,156,102,54,65.38461538461539,791,745,46,94.18457648546145,146,48,98,32.87671232876712,17.79905644872206,72,16,56,22.22222222222222,13,2,72,41,37,17,32,Everton,28,England - Premier League
490,Sébastien Aymar Bassong Nguena,950,737,213,77.57894736842104,102,42,60,41.17647058823529,467,446,21,95.50321199143468,123,44,79,35.77235772357724,20.897822910338526,3,0,3,0.0,2,0,13,12,0,0,22,Norwich City,32,England - Premier League
491,Sébastien Pocognoli,30,19,11,63.33333333333333,5,0,5,0.0,9,9,0,100.0,8,2,6,25.0,22.582917902400002,3,2,1,66.66666666666666,1,1,0,0,0,0,0,West Bromwich Albion,1,England - Premier League
492,Tammy Bakumo-Abraham,14,7,7,50.0,1,1,0,100.0,8,4,4,50.0,0,0,0,0.0,11.163527297850857,2,0,2,0.0,0,0,2,1,2,1,0,Chelsea,2,England - Premier League
493,Tetchi Jores Charlemagne Ulrich Okore,344,277,67,80.52325581395348,29,13,16,44.827586206896555,180,163,17,90.55555555555556,35,11,24,31.428571428571427,22.786611899527674,0,0,0,0.0,1,0,4,3,0,0,10,Aston Villa,12,England - Premier League
494,Theo Walcott,333,249,84,74.77477477477478,20,15,5,75.0,229,197,32,86.02620087336244,15,2,13,13.333333333333334,14.37682351548108,20,5,15,25.0,13,2,48,26,18,9,28,Arsenal,28,England - Premier League
495,Thibaut Courtois,638,370,268,57.993730407523515,73,14,59,19.17808219178082,179,178,1,99.4413407821229,382,124,258,32.460732984293195,44.2857713705368,0,0,0,0.0,0,0,0,0,0,0,3,Chelsea,23,England - Premier League
496,Thomas Robson,56,44,12,78.57142857142857,9,5,4,55.55555555555556,21,19,2,90.47619047619048,8,3,5,37.5,18.231981063814285,1,0,1,0.0,0,0,2,1,0,0,1,Sunderland,1,England - Premier League
497,Tim Howard,805,554,251,68.81987577639752,51,9,42,17.647058823529413,322,321,1,99.68944099378882,391,150,241,38.36317135549872,38.37031056447563,0,0,0,0.0,0,0,1,1,0,0,2,Everton,25,England - Premier League
498,Timm Klose,283,188,95,66.43109540636041,40,17,23,42.5,100,90,10,90.0,68,23,45,33.82352941176471,23.75019666368396,0,0,0,0.0,0,0,1,1,0,0,6,Norwich City,10,England - Premier League
499,Timothy Evans Fosu-Mensah,144,102,42,70.83333333333334,16,5,11,31.25,71,66,5,92.95774647887323,20,4,16,20.0,20.765758979575,1,0,1,0.0,0,1,3,2,0,0,3,Manchester United,8,England - Premier League
500,Timothy Michael Krul,281,165,116,58.718861209964416,39,10,29,25.64102564102564,65,64,1,98.46153846153847,181,68,113,37.569060773480665,45.19971963602136,0,0,0,0.0,0,0,0,0,0,0,1,Newcastle United,8,England - Premier League
501,Toby Alderweireld,2122,1704,418,80.30160226201697,339,152,187,44.83775811209439,1070,1041,29,97.28971962616822,450,196,254,43.55555555555555,25.937805877790048,14,3,11,21.428571428571427,7,2,12,7,7,4,7,Tottenham Hotspur,38,England - Premier League
502,Tokelo Anthony Rantie,11,9,2,81.81818181818183,0,0,0,0.0,11,9,2,81.81818181818183,0,0,0,0.0,10.056014097643637,0,0,0,0.0,1,0,3,0,2,0,0,AFC Bournemouth,3,England - Premier League
503,Tom Carroll,361,293,68,81.16343490304709,56,42,14,75.0,240,216,24,90.0,38,18,20,47.368421052631575,18.35255070197252,10,3,7,30.0,8,0,7,4,4,3,2,Tottenham Hotspur,19,England - Premier League
504,Tom Cleverley,974,768,206,78.85010266940452,116,73,43,62.93103448275862,580,538,42,92.75862068965517,121,42,79,34.710743801652896,18.26959589082111,43,7,36,16.27906976744186,18,4,23,14,12,7,22,Everton,22,England - Premier League
505,Tom Davies,49,37,12,75.51020408163265,6,3,3,50.0,38,32,6,84.21052631578947,2,0,2,0.0,14.752916822659593,1,0,1,0.0,0,0,2,2,0,0,2,Everton,2,England - Premier League
506,Tommy Elphick,462,377,85,81.6017316017316,48,29,19,60.416666666666664,270,264,6,97.77777777777777,50,18,32,36.0,19.780969640452984,0,0,0,0.0,1,0,0,0,0,0,6,AFC Bournemouth,12,England - Premier League
507,Tony Hibbert,19,16,3,84.21052631578947,3,1,2,33.33333333333333,13,12,1,92.3076923076923,1,0,1,0.0,17.885891541221053,0,0,0,0.0,0,0,1,0,0,0,0,Everton,1,England - Premier League
508,Troy Deeney,1302,792,510,60.82949308755761,248,111,137,44.75806451612903,509,425,84,83.49705304518665,91,33,58,36.26373626373626,15.05315889489434,30,7,23,23.333333333333332,49,7,50,29,22,10,45,Watford,38,England - Premier League
509,Tyler Roberts,8,4,4,50.0,1,0,1,0.0,2,2,0,100.0,0,0,0,0.0,9.70755605856,0,0,0,0.0,0,0,2,2,1,1,0,West Bromwich Albion,1,England - Premier League
510,Tyrone Mings,2,2,0,100.0,0,0,0,0.0,2,2,0,100.0,0,0,0,0.0,14.104533132,0,0,0,0.0,0,0,0,0,0,0,0,AFC Bournemouth,1,England - Premier League
511,Vadis Odjidja-Ofoe,159,120,39,75.47169811320755,10,6,4,60.0,94,84,10,89.36170212765957,9,4,5,44.44444444444444,13.72517408899336,9,3,6,33.33333333333333,7,2,18,9,14,6,3,Norwich City,10,England - Premier League
512,Valon Behrami,519,411,108,79.1907514450867,52,29,23,55.769230769230774,346,321,25,92.77456647398844,21,5,16,23.809523809523807,14.392343916689478,1,0,1,0.0,4,1,9,3,1,0,19,Watford,21,England - Premier League
513,Victor Chinedu Anichebe,116,68,48,58.620689655172406,15,3,12,20.0,38,32,6,84.21052631578947,0,0,0,0.0,12.648332459321379,1,0,1,0.0,2,0,8,6,5,3,7,West Bromwich Albion,10,England - Premier League
514,Victor Moses,306,231,75,75.49019607843137,25,15,10,60.0,217,187,30,86.17511520737328,20,8,12,40.0,15.141167552025882,24,5,19,20.833333333333336,14,2,47,23,29,11,25,West Ham United,21,England - Premier League
515,Victor Wanyama,1389,1141,248,82.14542836573074,186,112,74,60.215053763440864,894,848,46,94.85458612975391,114,43,71,37.719298245614034,18.352856533641642,4,0,4,0.0,12,1,43,30,15,10,35,Southampton,30,England - Premier League
516,Vincent Kompany,679,572,107,84.24153166421208,84,49,35,58.333333333333336,384,369,15,96.09375,76,28,48,36.84210526315789,23.288376363327835,1,0,1,0.0,3,0,11,8,1,0,5,Manchester City,14,England - Premier League
517,Virgil van Dijk,1412,1186,226,83.9943342776204,197,115,82,58.37563451776649,726,697,29,96.00550964187327,199,99,100,49.74874371859296,22.851772963752236,4,2,2,50.0,8,0,13,10,5,2,14,Southampton,34,England - Premier League
518,Vito Mannone,633,277,356,43.75987361769352,170,48,122,28.235294117647058,85,85,0,100.0,495,145,350,29.292929292929294,52.43756042711659,0,0,0,0.0,0,0,0,0,0,0,5,Sunderland,19,England - Premier League
519,Vurnon Anita,1134,864,270,76.19047619047619,182,94,88,51.64835164835166,579,528,51,91.19170984455958,110,31,79,28.18181818181818,18.29109768288381,16,5,11,31.25,9,3,24,13,11,5,15,Newcastle United,28,England - Premier League
520,Wahbi Khazri,421,271,150,64.37054631828978,54,22,32,40.74074074074074,181,157,24,86.74033149171271,116,48,68,41.37931034482759,21.771242308453683,27,11,16,40.74074074074074,30,1,35,17,14,6,16,Sunderland,14,England - Premier League
521,Wayne Hennessey,869,431,438,49.59723820483315,292,83,209,28.424657534246577,149,149,0,100.0,644,214,430,33.22981366459628,53.03632520739645,0,0,0,0.0,0,0,0,0,0,0,0,Crystal Palace,29,England - Premier League
522,Wayne Mark Rooney,1195,955,240,79.9163179916318,150,96,54,64.0,704,638,66,90.625,149,90,59,60.40268456375839,18.890596997564867,43,9,34,20.930232558139537,35,5,50,30,22,9,22,Manchester United,28,England - Premier League
523,Wayne Routledge,722,501,221,69.39058171745152,50,23,27,46.0,436,363,73,83.25688073394495,58,23,35,39.6551724137931,15.256050673520443,42,10,32,23.809523809523807,27,1,42,24,21,11,28,Swansea City,28,England - Premier League
524,Wes Brown,198,153,45,77.27272727272727,23,9,14,39.130434782608695,101,93,8,92.07920792079209,30,13,17,43.333333333333336,20.799546332567274,0,0,0,0.0,0,0,1,1,0,0,6,Sunderland,6,England - Premier League
525,Wes Hoolahan,1180,938,242,79.49152542372882,119,81,38,68.0672268907563,809,709,100,87.63906056860321,96,45,51,46.875,15.307540978596345,49,15,34,30.612244897959183,38,7,57,33,29,14,48,Norwich City,30,England - Premier League
526,Wes Morgan,849,648,201,76.32508833922262,113,38,75,33.6283185840708,403,386,17,95.7816377171216,119,38,81,31.932773109243694,20.25627671032325,1,0,1,0.0,3,0,11,9,0,0,16,Leicester City,38,England - Premier League
527,Wilfredo Daniel Caballero,91,51,40,56.043956043956044,12,3,9,25.0,23,23,0,100.0,58,19,39,32.758620689655174,45.97343118514286,0,0,0,0.0,0,0,0,0,0,0,0,Manchester City,4,England - Premier League
528,Wilfried Guemiand Bony,398,317,81,79.64824120603015,34,22,12,64.70588235294117,262,232,30,88.54961832061069,4,1,3,25.0,12.49098642611005,3,1,2,33.33333333333333,8,3,25,15,15,8,23,Manchester City,26,England - Premier League
529,Wilfried Zaha,699,488,211,69.8140200286123,56,36,20,64.28571428571429,426,344,82,80.75117370892019,50,24,26,48.0,16.288611427983863,86,35,51,40.69767441860465,35,1,198,119,108,62,102,Crystal Palace,34,England - Premier League
530,Willian Borges da Silva,1745,1303,442,74.67048710601719,186,126,60,67.74193548387096,1061,924,137,87.08765315739868,254,114,140,44.881889763779526,18.430605660466934,99,23,76,23.232323232323232,76,7,104,70,52,35,73,Chelsea,35,England - Premier League
531,Winston Reid,826,691,135,83.65617433414043,88,45,43,51.13636363636363,443,424,19,95.71106094808127,109,41,68,37.61467889908257,23.424736944166778,0,0,0,0.0,4,1,2,2,0,0,29,West Ham United,24,England - Premier League
532,Xherdan Shaqiri,835,577,258,69.10179640718563,80,41,39,51.24999999999999,443,396,47,89.39051918735892,149,44,105,29.53020134228188,19.859998509293604,81,15,66,18.51851851851852,43,5,86,42,46,21,33,Stoke City,27,England - Premier League
533,Yann Gérard M''Vila,1799,1404,395,78.04335742078933,319,188,131,58.93416927899686,1053,966,87,91.73789173789174,247,96,151,38.8663967611336,19.90757482549554,36,4,32,11.11111111111111,43,3,38,28,11,6,55,Sunderland,37,England - Premier League
534,Yann Kermorgant,62,40,22,64.51612903225806,10,6,4,60.0,30,24,6,80.0,2,1,1,50.0,14.195147480419354,1,0,1,0.0,2,0,3,2,1,1,5,AFC Bournemouth,7,England - Premier League
535,Yannick Bolasie Yala,653,402,251,61.56202143950995,57,28,29,49.122807017543856,319,256,63,80.25078369905955,84,20,64,23.809523809523807,16.841391447609922,109,26,83,23.853211009174313,23,3,135,73,82,42,40,Crystal Palace,26,England - Premier League
536,Yoan Gouffran,94,71,23,75.53191489361703,11,5,6,45.45454545454545,53,52,1,98.11320754716981,11,3,8,27.27272727272727,19.418552950817872,3,0,3,0.0,1,0,2,0,1,0,1,Newcastle United,8,England - Premier League
537,Yohan Benalouane,18,10,8,55.55555555555556,5,1,4,20.0,1,1,0,100.0,4,1,3,25.0,22.6865740578,0,0,0,0.0,0,0,0,0,0,0,0,Leicester City,4,England - Premier League
538,Yohan Cabaye,1433,1111,322,77.52965806001396,205,121,84,59.02439024390244,772,720,52,93.26424870466322,266,109,157,40.97744360902256,20.355148898444046,43,13,30,30.23255813953488,48,1,39,19,16,7,41,Crystal Palace,33,England - Premier League
539,Younes Kaboul,692,465,227,67.1965317919075,119,38,81,31.932773109243694,304,287,17,94.4078947368421,160,42,118,26.25,24.103386631781273,7,5,2,71.42857142857143,5,1,14,12,2,2,8,Sunderland,23,England - Premier League
540,Youssouf Chafiq Mulumbu Ngangu,162,143,19,88.27160493827161,14,12,2,85.71428571428571,109,100,9,91.74311926605505,6,3,3,50.0,15.124568337431112,1,0,1,0.0,1,0,9,6,0,0,6,Norwich City,7,England - Premier League
541,Àngel Rangel Zaragoza,1584,1268,316,80.05050505050505,190,105,85,55.26315789473685,808,746,62,92.32673267326733,157,55,102,35.03184713375796,18.401719026723637,36,10,26,27.77777777777778,13,0,22,14,10,5,17,Swansea City,23,England - Premier League
542,Ádám Bogdán,49,25,24,51.02040816326531,4,1,3,25.0,13,13,0,100.0,32,9,23,28.125,43.1328958356049,0,0,0,0.0,0,0,0,0,0,0,0,Liverpool,2,England - Premier League
543,Éderzito António Macedo Lopes,85,61,24,71.76470588235294,8,2,6,25.0,48,40,8,83.33333333333334,2,0,2,0.0,15.406345135372234,3,0,3,0.0,2,0,9,6,4,2,10,Swansea City,13,England - Premier League
544,Łukasz Fabiański,1212,768,444,63.366336633663366,116,20,96,17.24137931034483,367,365,2,99.45504087193461,675,247,428,36.592592592592595,41.72143459887148,0,0,0,0.0,3,1,0,0,0,0,9,Swansea City,37,England - Premier League
