index,player,total_passes,total_completed,total_uncompleted,total_percentage%,f3_passes,f3_completed,f3_uncompleted,f3_percentage%,short_passes,short_completed,short_uncompleted,short_percentage%,long_passes,long_completed,long_uncompleted,long_percentage%,average_pass_length,crosses,crosses_completed,crosses_uncompleted,crosses_percentage%,total_shot_assists,total_goal_assists,dribbles,dribbles_completed,dribbles_f3,dribbles_f3_completed,fouls_won,team,MP,competition
0,Aaron Mattia Tabacchi,9,6,3,66.66666666666666,0,0,0,0.0,4,4,0,100.0,1,1,0,100.0,21.567552191199997,3,0,3,0.0,1,0,0,0,0,0,0,Bologna,1,Italy - Serie A
1,Abdelhamid El Kaoutari,271,223,48,82.28782287822878,36,19,17,52.77777777777778,159,152,7,95.59748427672956,28,11,17,39.285714285714285,18.349814983007825,0,0,0,0.0,2,0,4,2,0,0,5,Palermo,7,Italy - Serie A
2,Abdoulay Konko,1065,817,248,76.71361502347418,147,84,63,57.14285714285714,596,543,53,91.10738255033557,111,35,76,31.53153153153153,16.383644109026704,33,7,26,21.21212121212121,7,0,32,21,17,11,10,Lazio,18,Italy - Serie A
3,Accursio Bentivegna,6,4,2,66.66666666666666,1,1,0,100.0,5,4,1,80.0,0,0,0,0.0,11.455161986759999,1,0,1,0.0,0,0,1,1,1,1,0,Palermo,1,Italy - Serie A
4,Achraf Lazaar,1357,911,446,67.13338246131173,214,119,95,55.60747663551402,637,550,87,86.34222919937206,225,64,161,28.444444444444443,18.661941987050493,92,19,73,20.652173913043477,17,1,80,44,28,12,40,Palermo,30,Italy - Serie A
5,Adam Masina,1570,1161,409,73.94904458598725,190,85,105,44.73684210526316,793,706,87,89.02900378310214,156,51,105,32.69230769230769,17.112954882419817,44,14,30,31.818181818181817,22,3,53,27,30,11,32,Bologna,33,Italy - Serie A
6,Adem Ljajić,906,749,157,82.6710816777042,73,52,21,71.23287671232876,666,605,61,90.84084084084084,65,23,42,35.38461538461539,14.93343216171576,35,11,24,31.428571428571427,51,3,55,29,34,14,22,Inter Milan,26,Italy - Serie A
7,Adriano Russo,229,175,54,76.41921397379913,22,7,15,31.818181818181817,106,102,4,96.22641509433963,43,17,26,39.53488372093023,21.459511635120002,2,1,1,50.0,5,0,0,0,0,0,4,Frosinone,10,Italy - Serie A
8,Afriyie Acquah,702,503,199,71.65242165242165,106,62,44,58.490566037735846,420,358,62,85.23809523809524,75,32,43,42.66666666666667,18.818305216234975,39,14,25,35.8974358974359,22,3,53,28,19,10,45,Torino,29,Italy - Serie A
9,Albano Benjamín Bizzarri,1099,595,504,54.14012738853503,144,28,116,19.444444444444446,194,194,0,100.0,739,251,488,33.96481732070365,44.77147070176466,0,0,0,0.0,0,0,2,2,0,0,4,Chievo,35,Italy - Serie A
10,Alberto Brignoli,44,19,25,43.18181818181818,10,1,9,10.0,9,9,0,100.0,32,7,25,21.875,46.76642742084545,0,0,0,0.0,0,0,0,0,0,0,1,Sampdoria,1,Italy - Serie A
11,Alberto Facundo Costa,932,727,205,78.00429184549357,159,89,70,55.9748427672956,552,514,38,93.11594202898551,155,60,95,38.70967741935484,20.95778037866678,19,3,16,15.789473684210526,17,0,11,9,2,2,14,Fiorentina,19,Italy - Serie A
12,Alberto Gilardino,539,402,137,74.58256029684601,50,22,28,44.0,305,271,34,88.85245901639345,8,4,4,50.0,10.709281402641617,8,4,4,50.0,20,1,24,9,12,4,45,Palermo,33,Italy - Serie A
13,Alberto Grassi,381,294,87,77.16535433070865,40,24,16,60.0,228,206,22,90.35087719298247,26,10,16,38.46153846153847,14.929916265600001,8,2,6,25.0,8,0,17,6,8,4,26,Atalanta,13,Italy - Serie A
14,Alberto Paloschi,382,243,139,63.61256544502618,39,14,25,35.8974358974359,214,172,42,80.37383177570094,14,5,9,35.714285714285715,13.200856844556817,5,1,4,20.0,9,2,26,11,13,6,23,Chievo,21,Italy - Serie A
15,Alberto Pelagotti,181,130,51,71.8232044198895,3,0,3,0.0,80,80,0,100.0,71,21,50,29.577464788732392,33.69198754488929,0,0,0,0.0,0,0,0,0,0,0,1,Empoli,6,Italy - Serie A
16,Aleandro Rosi,950,686,264,72.21052631578947,120,53,67,44.166666666666664,354,320,34,90.3954802259887,118,37,81,31.35593220338983,18.310035943971283,51,17,34,33.33333333333333,12,0,40,13,24,4,42,Frosinone,27,Italy - Serie A
17,Alejandro Darío Gómez,1414,961,453,67.96322489391797,132,79,53,59.84848484848485,817,704,113,86.16891064871481,227,69,158,30.396475770925107,17.72142263907678,135,36,99,26.666666666666668,62,7,126,74,62,40,90,Atalanta,34,Italy - Serie A
18,Alejandro Miguel Rodriguez,3,1,2,33.33333333333333,0,0,0,0.0,1,0,1,0.0,0,0,0,0.0,8.8444279296,0,0,0,0.0,0,0,0,0,0,0,0,Sampdoria,6,Italy - Serie A
19,Aleksandar Tonev,270,171,99,63.33333333333333,20,9,11,45.0,162,114,48,70.37037037037037,33,14,19,42.42424242424242,16.862183453450665,26,11,15,42.30769230769231,10,1,21,13,10,6,8,Frosinone,22,Italy - Serie A
20,Aleksandar Trajkovski,553,410,143,74.14104882459313,32,19,13,59.375,366,325,41,88.79781420765028,54,16,38,29.629629629629626,15.31268757447624,46,13,33,28.26086956521739,22,1,47,24,21,8,39,Palermo,32,Italy - Serie A
21,Alessandro Diamanti,603,390,213,64.6766169154229,110,49,61,44.54545454545455,285,258,27,90.52631578947368,139,48,91,34.53237410071942,21.54196424879045,64,20,44,31.25,21,1,29,16,14,8,50,Atalanta,16,Italy - Serie A
22,Alessandro Florenzi,1879,1451,428,77.2219265566791,248,153,95,61.693548387096776,935,861,74,92.08556149732621,297,140,157,47.13804713804714,19.72005211035685,83,31,52,37.34939759036144,35,3,49,23,24,11,27,AS Roma,33,Italy - Serie A
23,Alessandro Frara,449,299,150,66.59242761692651,68,24,44,35.294117647058826,241,209,32,86.72199170124482,68,19,49,27.941176470588236,18.86932303242174,14,2,12,14.285714285714285,7,0,10,6,6,3,17,Frosinone,20,Italy - Serie A
24,Alessandro Gamberini,657,527,130,80.2130898021309,48,18,30,37.5,366,358,8,97.81420765027322,80,25,55,31.25,19.734999897035507,1,1,0,100.0,2,1,3,3,0,0,8,Chievo,22,Italy - Serie A
25,Alessandro Gazzi,608,512,96,84.21052631578947,63,39,24,61.904761904761905,340,324,16,95.29411764705881,42,22,20,52.38095238095239,19.170775778203183,1,1,0,100.0,10,0,4,3,0,0,8,Torino,15,Italy - Serie A
26,Alessandro Longhi,179,130,49,72.62569832402235,24,12,12,50.0,76,73,3,96.05263157894737,23,4,19,17.391304347826086,17.402898197427486,4,0,4,0.0,1,1,1,1,0,0,2,Sassuolo,6,Italy - Serie A
27,Alessandro Matri,185,109,76,58.91891891891892,24,15,9,62.5,107,79,28,73.83177570093457,14,7,7,50.0,14.270651518666378,13,2,11,15.384615384615385,6,1,13,4,5,1,15,Lazio,19,Italy - Serie A
28,Alessandro Piu,61,47,14,77.04918032786885,4,3,1,75.0,44,38,6,86.36363636363636,3,2,1,66.66666666666666,12.768298500877377,1,0,1,0.0,1,0,3,3,1,1,7,Empoli,10,Italy - Serie A
29,Alessio Cerci,463,299,164,64.57883369330453,25,18,7,72.0,260,211,49,81.15384615384616,70,21,49,30.0,16.69574668246756,53,15,38,28.30188679245283,20,2,62,26,30,15,38,AC Milan,24,Italy - Serie A
30,Alessio Romagnoli,1583,1373,210,86.73404927353127,127,79,48,62.20472440944882,977,948,29,97.0317297850563,160,79,81,49.375,20.31199229514451,4,1,3,25.0,6,0,16,11,1,1,23,AC Milan,34,Italy - Serie A
31,Alex Ferrari,674,530,144,78.63501483679525,91,59,32,64.83516483516483,343,301,42,87.75510204081633,50,18,32,36.0,16.879454014902198,15,2,13,13.333333333333334,4,0,31,18,18,9,25,Bologna,21,Italy - Serie A
32,Alex Nicolao Telles,1174,889,285,75.72402044293015,139,83,56,59.71223021582733,628,570,58,90.76433121019109,152,62,90,40.78947368421053,18.069214607641225,57,14,43,24.561403508771928,24,1,37,22,18,9,13,Inter Milan,21,Italy - Serie A
33,Alex Rodrigo Dias da Costa,943,830,113,88.01696712619301,59,34,25,57.6271186440678,574,558,16,97.21254355400697,51,17,34,33.33333333333333,19.644679379039747,1,1,0,100.0,5,1,4,4,0,0,10,AC Milan,25,Italy - Serie A
34,Alex Sandro Lobo Silva,1048,846,202,80.72519083969466,84,54,30,64.28571428571429,575,522,53,90.78260869565217,88,41,47,46.590909090909086,16.966872672090457,69,26,43,37.68115942028986,38,3,48,28,33,17,41,Juventus,22,Italy - Serie A
35,Alexander Farnerud,69,53,16,76.81159420289855,7,6,1,85.71428571428571,36,35,1,97.22222222222221,12,6,6,50.0,18.74780266069565,4,1,3,25.0,3,0,2,1,1,0,1,Torino,5,Italy - Serie A
36,Alexander Merkel,38,26,12,68.42105263157895,6,4,2,66.66666666666666,23,21,2,91.30434782608695,3,1,2,33.33333333333333,16.97297579770737,2,0,2,0.0,0,0,0,0,0,0,0,Udinese,1,Italy - Serie A
37,Ali Adnan Kadhim Al Tameemi,1002,647,355,64.57085828343313,127,73,54,57.48031496062992,392,330,62,84.18367346938776,157,39,118,24.840764331210192,18.470374344283112,87,23,64,26.436781609195403,19,1,48,33,26,16,29,Udinese,28,Italy - Serie A
38,Aljaž Struna,926,694,232,74.94600431965442,135,70,65,51.85185185185185,494,461,33,93.31983805668015,111,31,80,27.927927927927925,17.938336290439565,22,8,14,36.36363636363637,8,0,9,4,2,0,8,Palermo,22,Italy - Serie A
39,Allan Marques Loureiro,1861,1585,276,85.16926383664696,198,140,58,70.70707070707071,1425,1307,118,91.71929824561403,89,44,45,49.43820224719101,14.624029081093386,25,4,21,16.0,35,5,95,49,41,18,75,Napoli,35,Italy - Serie A
40,Amadou Diawara,1662,1387,275,83.45367027677497,235,129,106,54.8936170212766,1094,1023,71,93.51005484460696,149,45,104,30.201342281879196,19.26476286125632,3,2,1,66.66666666666666,21,1,30,23,5,1,19,Bologna,34,Italy - Serie A
41,Amauri Carvalho de Oliveira,4,3,1,75.0,0,0,0,0.0,0,0,0,0.0,0,0,0,0.0,9.1732429692,0,0,0,0.0,1,0,0,0,0,0,0,Torino,1,Italy - Serie A
42,Anderson Hernanes de Carvalho Andrade,671,592,79,88.22652757078987,78,64,14,82.05128205128204,465,440,25,94.6236559139785,48,33,15,68.75,18.836322059304322,7,3,4,42.857142857142854,12,1,22,11,9,2,12,Juventus,16,Italy - Serie A
43,Andrea Barzagli,1959,1726,233,88.10617662072487,203,135,68,66.50246305418719,1263,1230,33,97.38717339667458,179,90,89,50.27932960893855,20.100198020430874,12,2,10,16.666666666666664,11,0,14,9,2,2,22,Juventus,31,Italy - Serie A
44,Andrea Belotti,536,406,130,75.74626865671642,49,33,16,67.3469387755102,357,301,56,84.31372549019608,16,9,7,56.25,13.706163350700447,18,5,13,27.77777777777778,22,3,38,19,20,11,105,Torino,35,Italy - Serie A
45,Andrea Bertolacci,987,807,180,81.7629179331307,143,107,36,74.82517482517483,721,646,75,89.59778085991678,58,29,29,50.0,16.339841221077737,12,4,8,33.33333333333333,20,1,37,18,18,6,65,AC Milan,27,Italy - Serie A
46,Andrea Coda,70,59,11,84.28571428571429,6,1,5,16.666666666666664,47,44,3,93.61702127659575,9,3,6,33.33333333333333,22.953470783122288,0,0,0,0.0,0,0,0,0,0,0,1,Sampdoria,4,Italy - Serie A
47,Andrea Consigli,1316,928,388,70.51671732522796,85,19,66,22.35294117647059,531,528,3,99.43502824858757,665,285,380,42.857142857142854,36.43562841451167,0,0,0,0.0,0,0,1,1,0,0,7,Sassuolo,37,Italy - Serie A
48,Andrea Conti,431,325,106,75.4060324825986,31,15,16,48.38709677419355,232,206,26,88.79310344827587,38,14,24,36.84210526315789,16.18741419955935,10,4,6,40.0,3,1,13,6,6,3,18,Atalanta,14,Italy - Serie A
49,Andrea Costa,1384,1178,206,85.11560693641619,111,45,66,40.54054054054054,966,922,44,95.44513457556936,143,65,78,45.45454545454545,18.352371793379305,1,0,1,0.0,1,0,3,2,1,0,18,Empoli,24,Italy - Serie A
50,Andrea Lazzari,188,128,60,68.08510638297872,37,24,13,64.86486486486487,82,69,13,84.14634146341463,52,26,26,50.0,21.842220898558722,11,3,8,27.27272727272727,19,0,1,1,0,0,6,Carpi,8,Italy - Serie A
51,Andrea Masiello,1281,970,311,75.72209211553474,165,84,81,50.90909090909091,589,547,42,92.86926994906621,242,103,139,42.561983471074385,21.59380587454033,42,12,30,28.57142857142857,10,1,5,4,0,0,19,Atalanta,29,Italy - Serie A
52,Andrea Poli,277,237,40,85.5595667870036,32,26,6,81.25,199,186,13,93.46733668341709,7,5,2,71.42857142857143,14.957388924040721,5,1,4,20.0,7,1,7,7,3,3,15,AC Milan,18,Italy - Serie A
53,Andrea Ranocchia,668,549,119,82.18562874251496,61,25,36,40.98360655737705,365,352,13,96.43835616438356,88,30,58,34.090909090909086,22.380777437265376,0,0,0,0.0,2,0,4,3,0,0,19,Inter Milan,23,Italy - Serie A
54,Andrea Rispoli,780,541,239,69.35897435897435,93,55,38,59.13978494623656,352,303,49,86.07954545454545,99,40,59,40.4040404040404,17.364531074701848,65,18,47,27.692307692307693,13,4,17,10,7,3,12,Palermo,22,Italy - Serie A
55,Andrea Seculin,116,57,59,49.137931034482754,30,10,20,33.33333333333333,23,23,0,100.0,84,25,59,29.761904761904763,48.41523706508689,0,0,0,0.0,0,0,0,0,0,0,0,Chievo,3,Italy - Serie A
56,Andrés Fabián Ponce Núñez,3,2,1,66.66666666666666,0,0,0,0.0,2,2,0,100.0,0,0,0,0.0,11.68597786752,0,0,0,0.0,0,0,0,0,0,0,0,Sampdoria,1,Italy - Serie A
57,Angelo Esmael da Costa Júnior,149,95,54,63.758389261744966,14,1,13,7.142857142857142,49,49,0,100.0,80,26,54,32.5,40.821718422201336,0,0,0,0.0,1,0,0,0,0,0,0,Bologna,5,Italy - Serie A
58,Angelo Palombo,206,165,41,80.09708737864078,38,18,20,47.368421052631575,133,122,11,91.72932330827066,21,5,16,23.809523809523807,20.374750659774758,0,0,0,0.0,0,0,3,2,1,0,12,Sampdoria,7,Italy - Serie A
59,Ante Rebić,292,199,93,68.15068493150685,23,10,13,43.47826086956522,211,163,48,77.25118483412322,25,4,21,16.0,14.701985727997808,25,5,20,20.0,4,0,40,23,20,12,13,Hellas Verona,14,Italy - Serie A
60,Anthony Mounier,725,488,237,67.3103448275862,86,47,39,54.65116279069767,440,349,91,79.31818181818183,71,26,45,36.61971830985916,16.033905546741185,33,9,24,27.27272727272727,28,2,73,32,39,19,41,Bologna,30,Italy - Serie A
61,Anton Ciprian Tătărușanu,1128,857,271,75.97517730496453,35,6,29,17.142857142857142,564,563,1,99.822695035461,391,133,258,34.015345268542205,32.180687370942124,0,0,0,0.0,0,0,1,1,0,0,2,Fiorentina,37,Italy - Serie A
62,Antonino La Gumina,14,11,3,78.57142857142857,1,1,0,100.0,10,10,0,100.0,0,0,0,0.0,9.135233287971428,0,0,0,0.0,0,0,1,0,0,0,0,Palermo,3,Italy - Serie A
63,Antonio Candreva,1266,867,399,68.48341232227489,119,65,54,54.621848739495796,737,629,108,85.3459972862958,188,65,123,34.57446808510639,17.285740588163033,150,27,123,18.0,33,3,77,34,46,21,54,Lazio,30,Italy - Serie A
64,Antonio Cassano,814,541,273,66.46191646191646,110,53,57,48.18181818181818,488,387,101,79.30327868852459,76,29,47,38.15789473684211,15.89336929089641,29,7,22,24.137931034482758,33,3,23,10,15,5,54,Sampdoria,24,Italy - Serie A
65,Antonio Di Gaudio,392,268,124,68.36734693877551,52,28,24,53.84615384615385,232,187,45,80.60344827586206,24,7,17,29.166666666666668,14.432559701974899,28,6,22,21.428571428571427,10,3,62,33,40,21,51,Carpi,29,Italy - Serie A
66,Antonio Di Natale,345,214,131,62.02898550724638,31,13,18,41.935483870967744,135,116,19,85.92592592592592,76,31,45,40.78947368421053,19.64423985777913,27,2,25,7.4074074074074066,22,3,8,5,6,4,11,Udinese,23,Italy - Serie A
67,Antonio Floro Flores,501,328,173,65.46906187624751,65,29,36,44.61538461538462,286,229,57,80.06993006993007,62,25,37,40.32258064516129,17.154700811377726,10,1,9,10.0,16,2,54,31,30,17,48,Sassuolo,28,Italy - Serie A
68,Antonio Mirante,1111,668,443,60.12601260126013,104,23,81,22.115384615384613,252,251,1,99.60317460317461,722,290,432,40.16620498614959,42.55513111289779,0,0,0,0.0,0,0,3,3,0,0,5,Bologna,33,Italy - Serie A
69,Antonio Nocerino,38,31,7,81.57894736842105,3,1,2,33.33333333333333,29,27,2,93.10344827586206,2,2,0,100.0,16.637996361789472,1,0,1,0.0,1,0,2,1,1,1,3,AC Milan,2,Italy - Serie A
70,Antonio Rüdiger,1569,1365,204,86.9980879541109,135,74,61,54.81481481481482,1011,990,21,97.92284866468842,161,59,102,36.64596273291926,21.074703236980955,7,2,5,28.57142857142857,6,0,10,6,2,1,16,AS Roma,30,Italy - Serie A
71,Archimede Morleo,208,140,68,67.3076923076923,31,13,18,41.935483870967744,85,74,11,87.05882352941177,23,5,18,21.73913043478261,18.47977284861,12,4,8,33.33333333333333,4,0,3,2,1,0,11,Bologna,5,Italy - Serie A
72,Arlind Afrim Ajeti,329,235,94,71.42857142857143,38,13,25,34.21052631578947,137,130,7,94.8905109489051,68,25,43,36.76470588235294,24.241591993992948,0,0,0,0.0,3,0,1,1,0,0,7,Frosinone,16,Italy - Serie A
73,Armando Izzo,1449,1157,292,79.84817115251897,147,64,83,43.53741496598639,858,811,47,94.52214452214453,190,79,111,41.578947368421055,19.417419344325964,6,3,3,50.0,9,1,25,15,8,4,51,Genoa,33,Italy - Serie A
74,Artur Ioniţă,863,685,178,79.37427578215527,85,57,28,67.05882352941175,528,486,42,92.04545454545455,37,18,19,48.64864864864865,15.151178421396294,16,5,11,31.25,19,2,33,18,19,11,36,Hellas Verona,31,Italy - Serie A
75,Assane Demoya Gnoukouri,50,42,8,84.0,3,2,1,66.66666666666666,37,34,3,91.8918918918919,1,0,1,0.0,15.7364571482064,0,0,0,0.0,1,0,0,0,0,0,0,Inter Milan,2,Italy - Serie A
76,Assane Dioussé El Hadji,716,603,113,84.21787709497207,110,70,40,63.63636363636363,540,494,46,91.48148148148148,43,16,27,37.2093023255814,17.03858412154525,1,0,1,0.0,3,0,6,5,0,0,11,Empoli,15,Italy - Serie A
77,Berat Djimsiti,141,106,35,75.177304964539,12,1,11,8.333333333333332,90,86,4,95.55555555555556,19,2,17,10.526315789473683,19.738778480956597,0,0,0,0.0,0,0,1,1,0,0,5,Atalanta,3,Italy - Serie A
78,Blerim Džemaili,835,663,172,79.40119760479043,118,70,48,59.32203389830508,552,496,56,89.85507246376811,90,44,46,48.888888888888886,19.220576921425724,20,5,15,25.0,25,2,28,16,14,6,55,Genoa,27,Italy - Serie A
79,Boris Radunović,32,20,12,62.5,2,1,1,50.0,14,14,0,100.0,17,5,12,29.411764705882355,38.0421558894375,0,0,0,0.0,0,0,0,0,0,0,0,Atalanta,1,Italy - Serie A
80,Borja Valero Iglesias,2341,2018,323,86.20247757368645,316,255,61,80.69620253164557,1715,1605,110,93.58600583090379,195,107,88,54.871794871794876,17.032864084856488,54,17,37,31.48148148148148,72,6,81,53,35,22,109,Fiorentina,37,Italy - Serie A
81,Boukary Dramé,1289,1013,276,78.58805275407292,133,81,52,60.902255639097746,707,645,62,91.23055162659122,129,41,88,31.782945736434108,17.303964978616477,51,12,39,23.52941176470588,16,0,36,28,15,10,32,Atalanta,25,Italy - Serie A
82,Boško Janković,237,130,107,54.85232067510548,34,8,26,23.52941176470588,96,81,15,84.375,35,7,28,20.0,18.38042479491038,24,6,18,25.0,3,0,11,6,2,1,5,Hellas Verona,15,Italy - Serie A
83,Boštjan Cesar,1135,912,223,80.35242290748899,106,48,58,45.28301886792453,621,607,14,97.74557165861513,181,66,115,36.46408839779006,21.704826278036936,1,0,1,0.0,2,0,5,5,1,1,30,Chievo,31,Italy - Serie A
84,Bruno Miguel Borges Fernandes,1135,785,350,69.16299559471366,185,105,80,56.75675675675676,629,550,79,87.44038155802862,190,74,116,38.94736842105263,19.840662687724016,60,9,51,15.0,37,4,55,30,20,10,52,Udinese,31,Italy - Serie A
85,Bruno da Silva Peres,1262,1013,249,80.26941362916006,110,65,45,59.09090909090909,618,562,56,90.93851132686083,161,83,78,51.5527950310559,20.279288872971726,84,32,52,38.095238095238095,29,4,128,80,43,25,37,Torino,31,Italy - Serie A
86,Bryan Cristante,69,49,20,71.01449275362319,12,4,8,33.33333333333333,43,36,7,83.72093023255815,10,3,7,30.0,18.613804115206957,0,0,0,0.0,0,0,4,2,2,0,3,Palermo,4,Italy - Serie A
87,Carlos Arturo Bacca Ahumada,679,479,200,70.54491899852725,43,27,16,62.7906976744186,434,351,83,80.87557603686636,20,11,9,55.00000000000001,13.67878366614963,29,8,21,27.586206896551722,41,2,53,29,36,17,28,AC Milan,38,Italy - Serie A
88,Carlos Emilio Carmona Tello,243,209,34,86.0082304526749,18,12,6,66.66666666666666,173,164,9,94.79768786127167,14,6,8,42.857142857142854,16.310570725579257,2,1,1,50.0,3,0,4,2,1,0,9,Atalanta,8,Italy - Serie A
89,Carlos Joaquín Correa,652,524,128,80.3680981595092,71,52,19,73.23943661971832,457,391,66,85.55798687089715,44,27,17,61.36363636363637,16.25395179517399,9,2,7,22.22222222222222,20,1,70,36,43,18,43,Sampdoria,25,Italy - Serie A
90,Carlos Mario Carbonero Mancilla,544,457,87,84.00735294117648,46,35,11,76.08695652173914,379,345,34,91.02902374670184,24,11,13,45.83333333333333,14.984542973935588,11,5,6,45.45454545454545,11,2,30,17,11,5,25,Sampdoria,14,Italy - Serie A
91,Cesare Bovo,1325,1090,235,82.26415094339623,216,122,94,56.481481481481474,675,655,20,97.03703703703704,293,141,152,48.122866894197955,26.26631566528048,7,2,5,28.57142857142857,14,0,8,7,0,0,5,Torino,21,Italy - Serie A
92,Christian Abbiati,26,13,13,50.0,0,0,0,0.0,10,10,0,100.0,14,3,11,21.428571428571427,36.225144248732306,0,0,0,0.0,0,0,0,0,0,0,0,AC Milan,1,Italy - Serie A
93,Christian Maggio,274,218,56,79.56204379562044,11,5,6,45.45454545454545,131,121,10,92.36641221374046,27,7,20,25.925925925925924,16.406237215140436,10,3,7,30.0,2,0,6,3,2,1,12,Napoli,8,Italy - Serie A
94,Ciro Immobile,273,179,94,65.56776556776556,23,10,13,43.47826086956522,155,119,36,76.77419354838709,18,10,8,55.55555555555556,15.991697704734065,27,7,20,25.925925925925924,19,2,34,16,23,10,20,Torino,14,Italy - Serie A
95,Claud Adjapong,13,11,2,84.61538461538461,0,0,0,0.0,7,6,1,85.71428571428571,0,0,0,0.0,13.102352209107693,0,0,0,0.0,0,0,0,0,0,0,0,Sassuolo,2,Italy - Serie A
96,Claudio Marchisio,1509,1318,191,87.3426110006627,218,157,61,72.01834862385321,885,855,30,96.61016949152543,236,148,88,62.71186440677966,20.942176323451132,13,8,5,61.53846153846154,20,2,23,16,7,5,21,Juventus,23,Italy - Serie A
97,Cristian Daniel Ansaldi,1086,772,314,71.08655616942909,169,99,70,58.57988165680473,553,493,60,89.1500904159132,170,62,108,36.470588235294116,20.07518663136,66,16,50,24.242424242424242,19,4,52,31,26,14,48,Genoa,24,Italy - Serie A
98,Cristian Eduardo Zapata Valencia,658,539,119,81.91489361702128,53,24,29,45.28301886792453,388,372,16,95.87628865979381,83,36,47,43.373493975903614,21.28166342698541,0,0,0,0.0,3,0,6,4,0,0,12,AC Milan,16,Italy - Serie A
99,Cristian Molinaro,1093,829,264,75.8462946020128,116,60,56,51.724137931034484,486,436,50,89.7119341563786,185,80,105,43.24324324324324,20.780574061384883,70,19,51,27.142857142857142,22,0,49,26,21,13,27,Torino,27,Italy - Serie A
100,Cristian Raimondi,362,251,111,69.33701657458563,44,23,21,52.27272727272727,152,124,28,81.57894736842105,40,8,32,20.0,15.969058123158895,14,1,13,7.142857142857142,4,0,7,3,3,0,24,Atalanta,18,Italy - Serie A
101,Cristian Tello Herrera,510,395,115,77.45098039215686,27,19,8,70.37037037037037,359,303,56,84.40111420612814,28,14,14,50.0,15.590817926222117,42,19,23,45.23809523809524,18,4,59,32,47,25,17,Fiorentina,15,Italy - Serie A
102,Cristian Zaccardo,956,685,271,71.65271966527197,142,77,65,54.22535211267606,430,384,46,89.30232558139535,146,44,102,30.136986301369863,19.005381759922344,31,9,22,29.03225806451613,8,0,16,9,6,2,28,Carpi,27,Italy - Serie A
103,Cyril Théréau,1214,899,315,74.05271828665569,98,55,43,56.12244897959183,748,654,94,87.43315508021391,40,12,28,30.0,13.19283424432972,36,10,26,27.77777777777778,46,3,73,37,38,22,69,Udinese,36,Italy - Serie A
104,Daniel Ciofani,608,377,231,62.00657894736842,95,35,60,36.84210526315789,274,224,50,81.75182481751825,23,5,18,21.73913043478261,13.669806485825644,4,1,3,25.0,35,1,33,16,17,5,53,Frosinone,37,Italy - Serie A
105,Daniel Pavlovic,993,636,357,64.04833836858006,171,86,85,50.29239766081871,303,265,38,87.45874587458746,270,90,180,33.33333333333333,22.3697436102902,59,20,39,33.89830508474576,41,5,8,4,5,3,13,Frosinone,22,Italy - Serie A
106,Daniele Baselli,903,663,240,73.421926910299,99,54,45,54.54545454545454,496,443,53,89.31451612903226,159,61,98,38.36477987421384,19.559456632651695,38,9,29,23.684210526315788,50,2,76,42,30,13,41,Torino,35,Italy - Serie A
107,Daniele Croce,893,754,139,84.43449048152296,67,52,15,77.61194029850746,648,604,44,93.20987654320987,36,16,20,44.44444444444444,13.318666495321747,24,6,18,25.0,20,1,50,18,10,2,57,Empoli,28,Italy - Serie A
108,Daniele De Rossi,1462,1294,168,88.50889192886456,228,157,71,68.85964912280701,864,832,32,96.29629629629629,210,140,70,66.66666666666666,21.649964624056416,3,3,0,100.0,14,2,7,4,2,0,24,AS Roma,23,Italy - Serie A
109,Daniele Gastaldello,1075,890,185,82.7906976744186,127,64,63,50.39370078740157,530,509,21,96.0377358490566,157,80,77,50.955414012738856,22.222097779101322,1,0,1,0.0,2,2,2,2,0,0,24,Bologna,26,Italy - Serie A
110,Daniele Padelli,1073,782,291,72.87977632805219,43,13,30,30.23255813953488,462,460,2,99.56709956709958,443,163,280,36.794582392776526,34.63366485588794,0,0,0,0.0,1,0,2,2,0,0,3,Torino,35,Italy - Serie A
111,Daniele Rugani,788,707,81,89.72081218274111,70,40,30,57.14285714285714,588,575,13,97.78911564625851,41,13,28,31.70731707317073,18.93682221055127,0,0,0,0.0,1,0,6,5,1,1,14,Juventus,17,Italy - Serie A
112,Daniele Verde,44,29,15,65.9090909090909,6,3,3,50.0,25,20,5,80.0,3,0,3,0.0,15.02299171926,3,0,3,0.0,0,0,7,5,5,5,1,Frosinone,5,Italy - Serie A
113,Danilo Cataldi,931,742,189,79.69924812030075,134,77,57,57.46268656716418,609,555,54,91.13300492610837,84,32,52,38.095238095238095,18.04193677387102,18,3,15,16.666666666666664,20,3,10,4,2,1,15,Lazio,20,Italy - Serie A
114,Danilo D''Ambrosio,946,718,228,75.8985200845666,124,71,53,57.25806451612904,481,427,54,88.77338877338877,98,27,71,27.55102040816326,17.161976413251246,20,8,12,40.0,9,0,31,12,13,3,19,Inter Milan,20,Italy - Serie A
115,Danilo Fernando Avelar,192,113,79,58.854166666666664,27,11,16,40.74074074074074,63,55,8,87.3015873015873,64,22,42,34.375,23.39665375905,27,6,21,22.22222222222222,6,2,3,1,2,0,7,Torino,6,Italy - Serie A
116,Danilo Larangeira,1223,922,301,75.38838920686835,183,77,106,42.07650273224044,511,483,28,94.52054794520548,279,127,152,45.51971326164875,24.51524978036016,3,1,2,33.33333333333333,2,0,3,3,0,0,25,Udinese,34,Italy - Serie A
117,Danilo Soddimo,853,549,304,64.36107854630716,133,70,63,52.63157894736842,449,369,80,82.18262806236079,142,43,99,30.28169014084507,18.73227358364961,65,13,52,20.0,37,2,102,47,46,19,49,Frosinone,28,Italy - Serie A
118,Dario Dainelli,580,454,126,78.27586206896552,75,32,43,42.66666666666667,285,271,14,95.08771929824562,125,62,63,49.6,22.74133220995655,3,2,1,66.66666666666666,3,0,2,1,0,0,6,Chievo,18,Italy - Serie A
119,Darko Lazović,342,208,134,60.81871345029239,23,8,15,34.78260869565217,202,161,41,79.70297029702971,52,10,42,19.230769230769234,17.191184626960002,28,7,21,25.0,11,2,31,13,24,9,4,Genoa,15,Italy - Serie A
120,David López Silva,578,503,75,87.0242214532872,49,34,15,69.38775510204081,453,426,27,94.03973509933775,13,4,9,30.76923076923077,13.544265191294118,6,2,4,33.33333333333333,6,1,10,5,6,1,5,Napoli,25,Italy - Serie A
121,Davide Astori,2338,2090,248,89.39264328485885,199,116,83,58.291457286432156,1676,1632,44,97.3747016706444,244,132,112,54.09836065573771,19.799877005116475,2,2,0,100.0,5,0,23,20,0,0,30,Fiorentina,33,Italy - Serie A
122,Davide Bassi,37,18,19,48.64864864864865,4,1,3,25.0,9,9,0,100.0,25,8,17,32.0,42.26283924791351,0,0,0,0.0,0,0,0,0,0,0,0,Atalanta,1,Italy - Serie A
123,Davide Bertoncini,118,86,32,72.88135593220339,22,9,13,40.909090909090914,50,49,1,98.0,32,14,18,43.75,24.508370666391865,0,0,0,0.0,1,0,0,0,0,0,7,Frosinone,5,Italy - Serie A
124,Davide Biondini,512,356,156,69.53125,80,41,39,51.24999999999999,287,251,36,87.45644599303137,58,26,32,44.827586206896555,17.62265556859078,21,6,15,28.57142857142857,7,0,11,6,6,2,20,Sassuolo,22,Italy - Serie A
125,Davide Brivio,653,491,162,75.19142419601837,77,48,29,62.33766233766234,353,319,34,90.36827195467421,67,19,48,28.35820895522388,16.443429746068116,26,5,21,19.230769230769234,6,0,6,2,3,0,7,Atalanta,14,Italy - Serie A
126,Davide Calabria,246,179,67,72.76422764227642,32,16,16,50.0,122,113,9,92.62295081967213,41,17,24,41.46341463414634,18.62001787242439,8,4,4,50.0,6,0,6,3,1,0,7,AC Milan,6,Italy - Serie A
127,Davide Santon,646,541,105,83.74613003095975,69,42,27,60.86956521739131,396,379,17,95.70707070707071,60,27,33,45.0,17.809961504421175,26,8,18,30.76923076923077,5,1,18,8,12,5,10,Inter Milan,12,Italy - Serie A
128,Davide Zappacosta,750,542,208,72.26666666666667,64,37,27,57.8125,294,258,36,87.75510204081633,101,42,59,41.584158415841586,19.17224696193485,76,20,56,26.31578947368421,13,1,44,12,26,5,10,Torino,25,Italy - Serie A
129,Diego Falcinelli,224,172,52,76.78571428571429,16,8,8,50.0,140,124,16,88.57142857142857,7,3,4,42.857142857142854,12.293400077643215,6,2,4,33.33333333333333,15,1,17,10,11,7,34,Sassuolo,26,Italy - Serie A
130,Diego López Rodríguez,245,189,56,77.14285714285715,14,5,9,35.714285714285715,78,78,0,100.0,120,65,55,54.166666666666664,36.35625426694824,0,0,0,0.0,1,0,0,0,0,0,0,AC Milan,8,Italy - Serie A
131,Diego Perotti,1461,1099,362,75.22245037645449,151,100,51,66.22516556291392,989,877,112,88.67542972699697,148,48,100,32.432432432432435,16.133019596961315,109,37,72,33.94495412844037,58,9,89,60,53,40,64,Genoa,31,Italy - Serie A
132,Diego Sebastián Laxalt Suárez,1533,1132,401,73.84213959556425,142,72,70,50.70422535211267,893,759,134,84.99440089585666,111,35,76,31.53153153153153,15.96887399362192,66,21,45,31.818181818181817,26,4,75,31,38,17,49,Genoa,35,Italy - Serie A
133,Diego Ángel Capel Trinidad,273,218,55,79.85347985347985,25,19,6,76.0,192,170,22,88.54166666666666,29,20,9,68.96551724137932,16.39176609321758,17,6,11,35.294117647058826,9,0,12,8,4,2,46,Genoa,21,Italy - Serie A
134,Diogo José Rosário Gomes Figueiras,264,198,66,75.0,29,10,19,34.48275862068966,161,139,22,86.33540372670807,19,5,14,26.31578947368421,16.379417151853634,6,1,5,16.666666666666664,1,0,7,4,6,3,4,Genoa,9,Italy - Serie A
135,Djamel Eddine Mesbah,276,216,60,78.26086956521739,26,15,11,57.692307692307686,167,148,19,88.62275449101796,25,7,18,28.000000000000004,16.986170141626957,9,2,7,22.22222222222222,4,0,7,1,2,0,9,Sampdoria,7,Italy - Serie A
136,Domenico Berardi,1076,702,374,65.24163568773234,137,73,64,53.284671532846716,576,466,110,80.90277777777779,149,50,99,33.557046979865774,18.852049199748848,68,15,53,22.058823529411764,31,6,71,36,38,21,85,Sassuolo,29,Italy - Serie A
137,Domenico Maietta,811,694,117,85.57336621454994,101,50,51,49.504950495049506,466,450,16,96.56652360515021,109,50,59,45.87155963302752,22.09571333222116,0,0,0,0.0,1,0,11,4,4,1,11,Bologna,19,Italy - Serie A
138,Dominik Furman,17,15,2,88.23529411764706,1,0,1,0.0,14,13,1,92.85714285714286,0,0,0,0.0,19.17676714116706,0,0,0,0.0,0,0,0,0,0,0,0,Hellas Verona,1,Italy - Serie A
139,Dries Mertens,578,422,156,73.01038062283737,67,38,29,56.71641791044776,371,309,62,83.28840970350404,44,18,26,40.909090909090914,16.142924537735293,43,12,31,27.906976744186046,26,5,66,26,51,19,38,Napoli,33,Italy - Serie A
140,Duván Esteban Zapata Banguera,326,206,120,63.190184049079754,36,15,21,41.66666666666667,169,136,33,80.4733727810651,23,4,19,17.391304347826086,14.539325977380368,20,5,15,25.0,8,2,35,15,23,8,47,Udinese,25,Italy - Serie A
141,Dušan Basta,1306,1035,271,79.24961715160796,146,79,67,54.109589041095894,756,700,56,92.5925925925926,143,39,104,27.27272727272727,17.602572463126126,44,5,39,11.363636363636363,10,0,25,11,15,7,21,Lazio,23,Italy - Serie A
142,Dávid Ivan,547,451,96,82.44972577696527,36,26,10,72.22222222222221,378,344,34,91.005291005291,22,7,15,31.818181818181817,14.4467515203532,8,1,7,12.5,10,0,8,2,4,0,14,Sampdoria,21,Italy - Serie A
143,Edenílson Andrade dos Santos,1209,871,338,72.04301075268818,162,93,69,57.407407407407405,592,511,81,86.31756756756756,141,54,87,38.297872340425535,17.045087415557717,66,16,50,24.242424242424242,24,0,73,33,25,7,26,Udinese,29,Italy - Serie A
144,Eder Citadin Martins,717,555,162,77.40585774058577,55,35,20,63.63636363636363,500,436,64,87.2,46,24,22,52.17391304347826,15.199804071111965,32,11,21,34.375,20,3,56,27,32,15,53,Sampdoria,33,Italy - Serie A
145,Edin Džeko,598,384,214,64.21404682274247,77,39,38,50.649350649350644,313,245,68,78.27476038338658,31,18,13,58.06451612903226,14.309584580695786,14,3,11,21.428571428571427,15,4,41,21,25,13,53,AS Roma,31,Italy - Serie A
146,Edoardo Goldaniga,363,247,116,68.04407713498622,60,21,39,35.0,139,128,11,92.08633093525181,86,34,52,39.53488372093023,23.948719930046277,2,0,2,0.0,2,0,2,1,1,0,21,Palermo,17,Italy - Serie A
147,Edson Braafheid,162,115,47,70.98765432098766,18,7,11,38.88888888888889,70,61,9,87.14285714285714,23,6,17,26.08695652173913,16.86519714584,6,2,4,33.33333333333333,0,0,2,1,0,0,5,Lazio,5,Italy - Serie A
148,Elseid Hysaj,2525,2151,374,85.18811881188118,170,113,57,66.47058823529412,1493,1394,99,93.36905559276624,138,51,87,36.95652173913043,14.177039424800506,67,8,59,11.940298507462686,24,2,64,32,27,9,44,Napoli,37,Italy - Serie A
149,Emanuele Giaccherini,1138,840,298,73.81370826010544,116,68,48,58.620689655172406,688,592,96,86.04651162790698,137,58,79,42.33576642335766,17.23787724435817,55,23,32,41.81818181818181,43,0,74,35,54,24,50,Bologna,28,Italy - Serie A
150,Emanuele Suagher,135,104,31,77.03703703703704,19,6,13,31.57894736842105,66,63,3,95.45454545454545,22,6,16,27.27272727272727,21.664052812016,0,0,0,0.0,1,0,0,0,0,0,3,Carpi,9,Italy - Serie A
151,Emanuele Terranova,133,121,12,90.97744360902256,5,2,3,40.0,70,68,2,97.14285714285714,25,20,5,80.0,23.317710494394586,0,0,0,0.0,0,0,1,1,0,0,2,Sassuolo,6,Italy - Serie A
152,Emerson Palmieri dos Santos,101,81,20,80.19801980198021,8,4,4,50.0,65,61,4,93.84615384615384,8,2,6,25.0,15.599007846477623,4,1,3,25.0,1,0,5,1,4,1,1,AS Roma,8,Italy - Serie A
153,Emil Hallfreðsson,938,672,266,71.64179104477611,105,61,44,58.0952380952381,529,474,55,89.60302457466919,117,42,75,35.8974358974359,17.820671898933902,54,14,40,25.925925925925924,26,1,39,27,13,7,25,Udinese,27,Italy - Serie A
154,Emil Krafth,95,73,22,76.84210526315789,11,8,3,72.72727272727273,49,39,10,79.59183673469387,4,3,1,75.0,14.92596603972379,3,0,3,0.0,1,0,0,0,0,0,3,Bologna,4,Italy - Serie A
155,Emiliano Moretti,2049,1779,270,86.82284040995609,231,147,84,63.63636363636363,1326,1285,41,96.9079939668175,244,114,130,46.72131147540984,21.73293882870501,6,3,3,50.0,13,1,3,2,0,0,31,Torino,35,Italy - Serie A
156,Emiliano Viviano,1331,791,540,59.429000751314796,189,50,139,26.455026455026452,344,340,4,98.83720930232558,875,348,527,39.77142857142857,45.46611248763462,0,0,0,0.0,1,0,0,0,0,0,8,Sampdoria,37,Italy - Serie A
157,Emmanuel Agyemang-Badu,932,712,220,76.39484978540773,139,84,55,60.431654676258994,572,519,53,90.73426573426573,83,34,49,40.963855421686745,16.936716776778155,15,6,9,40.0,20,1,46,25,11,5,90,Udinese,33,Italy - Serie A
158,Enzo Maresca,675,550,125,81.48148148148148,113,65,48,57.52212389380531,405,379,26,93.58024691358024,94,45,49,47.87234042553192,19.536551705448534,6,0,6,0.0,9,0,13,6,1,0,28,Palermo,15,Italy - Serie A
159,Erick Antonio Pulgar Farfán,359,305,54,84.958217270195,46,36,10,78.26086956521739,239,227,12,94.97907949790795,22,14,8,63.63636363636363,17.627962984395545,4,0,4,0.0,2,0,16,9,5,3,6,Bologna,13,Italy - Serie A
160,Eros Pisano,1572,1071,501,68.12977099236642,258,116,142,44.96124031007752,576,513,63,89.0625,377,134,243,35.54376657824933,21.41142905074626,95,31,64,32.631578947368425,24,0,27,16,13,7,48,Hellas Verona,34,Italy - Serie A
161,Ervin Zukanović,999,823,176,82.38238238238237,132,74,58,56.060606060606055,598,573,25,95.81939799331104,134,51,83,38.059701492537314,20.360636191556033,8,3,5,37.5,5,1,3,3,0,0,9,Sampdoria,25,Italy - Serie A
162,Etrit Berisha,236,169,67,71.61016949152543,14,3,11,21.428571428571427,82,81,1,98.78048780487805,116,52,64,44.827586206896555,36.467453849213896,0,0,0,0.0,0,0,0,0,0,0,0,Lazio,11,Italy - Serie A
163,Eugenio Lamanna,355,231,124,65.07042253521126,16,6,10,37.5,116,116,0,100.0,180,58,122,32.22222222222222,38.58341882877228,0,0,0,0.0,1,0,0,0,0,0,1,Genoa,13,Italy - Serie A
164,Ezequiel Muñoz,634,510,124,80.4416403785489,41,21,20,51.21951219512195,373,347,26,93.02949061662198,54,20,34,37.03703703703704,18.59352659848959,0,0,0,0.0,1,0,4,3,0,0,12,Genoa,18,Italy - Serie A
165,Fabio Daprelà,105,79,26,75.23809523809524,21,12,9,57.14285714285714,52,48,4,92.3076923076923,18,8,10,44.44444444444444,18.799157883593143,1,0,1,0.0,0,0,1,1,0,0,3,Palermo,7,Italy - Serie A
166,Fabio Della Giovanna,5,3,2,60.0,2,1,1,50.0,3,3,0,100.0,1,0,1,0.0,21.1854620232,0,0,0,0.0,0,0,0,0,0,0,0,Inter Milan,1,Italy - Serie A
167,Fabio Quagliarella,594,391,203,65.82491582491582,61,35,26,57.377049180327866,299,244,55,81.60535117056857,52,36,16,69.23076923076923,15.447378565699394,21,7,14,33.33333333333333,17,1,30,16,14,7,49,Torino,32,Italy - Serie A
168,Fabrizio Alastra,48,39,9,81.25,1,1,0,100.0,20,20,0,100.0,23,15,8,65.21739130434783,33.573088618229995,0,0,0,0.0,0,0,0,0,0,0,0,Palermo,2,Italy - Serie A
169,Fabrizio Cacciatore,1545,1215,330,78.64077669902912,190,110,80,57.89473684210527,710,659,51,92.8169014084507,208,90,118,43.269230769230774,19.55453142315029,39,15,24,38.46153846153847,22,3,22,7,11,3,16,Chievo,29,Italy - Serie A
170,Fabrizio Poli,321,222,99,69.1588785046729,65,24,41,36.92307692307693,139,130,9,93.5251798561151,57,16,41,28.07017543859649,20.042434070903553,8,1,7,12.5,2,0,2,0,2,0,7,Carpi,10,Italy - Serie A
171,Facundo Sebastián Roncaglia,1918,1685,233,87.85192909280501,183,115,68,62.841530054644814,1261,1218,43,96.59000793021411,146,64,82,43.83561643835616,18.389323480142817,8,2,6,25.0,8,0,9,5,1,0,31,Fiorentina,30,Italy - Serie A
172,Faouzi Ghoulam,2456,2026,430,82.49185667752444,242,174,68,71.900826446281,1569,1456,113,92.79796048438496,134,44,90,32.83582089552239,15.256703035470197,113,21,92,18.58407079646018,28,3,42,19,24,8,48,Napoli,34,Italy - Serie A
173,Federico Barba,531,468,63,88.13559322033898,38,10,28,26.31578947368421,362,357,5,98.61878453038673,55,27,28,49.09090909090909,18.518018287955258,0,0,0,0.0,0,0,0,0,0,0,8,Empoli,10,Italy - Serie A
174,Federico Bernardeschi,1095,846,249,77.26027397260275,103,52,51,50.48543689320388,722,644,78,89.19667590027701,153,66,87,43.13725490196079,17.74402327774619,41,11,30,26.82926829268293,35,4,101,54,53,28,68,Fiorentina,33,Italy - Serie A
175,Federico Bonazzoli,23,21,2,91.30434782608695,1,0,1,0.0,18,18,0,100.0,0,0,0,0.0,14.905234449391305,0,0,0,0.0,1,0,1,1,1,1,3,Sampdoria,4,Italy - Serie A
176,Federico Dionisi,616,395,221,64.12337662337663,73,36,37,49.31506849315068,366,260,106,71.03825136612022,35,12,23,34.285714285714285,14.380505621726494,33,5,28,15.151515151515152,25,3,87,39,45,21,90,Frosinone,32,Italy - Serie A
177,Federico Marchetti,819,578,241,70.57387057387058,57,13,44,22.807017543859647,279,279,0,100.0,406,172,234,42.364532019704434,37.19820290769055,0,0,0,0.0,1,0,1,1,0,0,8,Lazio,29,Italy - Serie A
178,Federico Mattiello,80,56,24,70.0,19,14,5,73.68421052631578,30,25,5,83.33333333333334,9,1,8,11.11111111111111,19.672478595909,8,2,6,25.0,3,1,0,0,0,0,3,Chievo,1,Italy - Serie A
179,Federico Peluso,1653,1225,428,74.10768300060496,228,135,93,59.210526315789465,734,658,76,89.64577656675749,141,46,95,32.62411347517731,16.662522004639623,59,16,43,27.11864406779661,20,1,35,9,14,3,38,Sassuolo,34,Italy - Serie A
180,Federico Viviani,1211,935,276,77.20891824938067,220,141,79,64.0909090909091,582,536,46,92.09621993127148,284,151,133,53.16901408450704,23.562240481454268,34,10,24,29.411764705882355,38,6,14,12,4,4,35,Hellas Verona,19,Italy - Serie A
181,Felipe Anderson Pereira Gomes,1069,722,347,67.53975678203929,137,73,64,53.284671532846716,621,477,144,76.81159420289855,104,44,60,42.30769230769231,17.211860021555022,60,16,44,26.666666666666668,23,4,134,63,72,34,56,Lazio,35,Italy - Serie A
182,Felipe Dias da Silva dal Belo,879,681,198,77.47440273037543,127,58,69,45.66929133858268,458,434,24,94.75982532751091,148,62,86,41.891891891891895,20.7012684261944,7,2,5,28.57142857142857,3,1,8,6,0,0,18,Udinese,26,Italy - Serie A
183,Felipe Melo de Carvalho,1112,959,153,86.2410071942446,151,95,56,62.913907284768214,643,613,30,95.3343701399689,119,76,43,63.86554621848739,20.732457074298992,0,0,0,0.0,8,1,10,7,1,0,36,Inter Milan,26,Italy - Serie A
184,Ferdinando Coppola,42,21,21,50.0,8,1,7,12.5,9,9,0,100.0,32,11,21,34.375,43.457791218428575,0,0,0,0.0,0,0,0,0,0,0,0,Hellas Verona,1,Italy - Serie A
185,Fernando Llorente Torres,4,1,3,25.0,0,0,0,0.0,3,1,2,33.33333333333333,0,0,0,0.0,15.497322065999999,0,0,0,0.0,0,0,0,0,0,0,0,Juventus,1,Italy - Serie A
186,Fernando Lucas Martins,2190,1822,368,83.19634703196347,280,184,96,65.71428571428571,1340,1265,75,94.40298507462687,318,149,169,46.855345911949684,20.828390979096326,32,11,21,34.375,56,2,40,25,9,6,73,Sampdoria,35,Italy - Serie A
187,Filip Helander,720,583,137,80.97222222222223,71,25,46,35.2112676056338,417,404,13,96.88249400479616,90,23,67,25.555555555555554,21.11697021073,1,0,1,0.0,0,0,0,0,0,0,11,Hellas Verona,24,Italy - Serie A
188,Filip Đorđević,338,238,100,70.41420118343196,24,11,13,45.83333333333333,207,169,38,81.64251207729468,14,4,10,28.57142857142857,12.707003910795976,4,1,3,25.0,11,2,10,4,4,0,26,Lazio,27,Italy - Serie A
189,Filippo Costa,73,46,27,63.013698630136986,8,4,4,50.0,34,28,6,82.35294117647058,8,3,5,37.5,18.02236828057644,2,0,2,0.0,2,0,4,3,2,1,4,Chievo,6,Italy - Serie A
190,Filippo Falco,142,96,46,67.6056338028169,8,7,1,87.5,92,81,11,88.04347826086956,29,7,22,24.137931034482758,16.827920752502532,20,3,17,15.0,4,0,12,4,8,1,7,Bologna,9,Italy - Serie A
191,Filippo Porcari,89,70,19,78.65168539325843,21,14,7,66.66666666666666,47,41,6,87.2340425531915,14,10,4,71.42857142857143,20.065490895413934,0,0,0,0.0,3,0,0,0,0,0,3,Carpi,4,Italy - Serie A
192,Francesco Acerbi,1844,1609,235,87.25596529284165,192,121,71,63.020833333333336,1109,1085,24,97.83588818755635,222,121,101,54.5045045045045,20.79886275675176,0,0,0,0.0,3,0,16,14,2,2,29,Sassuolo,36,Italy - Serie A
193,Francesco Bardi,41,13,28,31.70731707317073,14,3,11,21.428571428571427,2,2,0,100.0,38,11,27,28.947368421052634,58.18834005084878,0,0,0,0.0,0,0,0,0,0,0,0,Frosinone,2,Italy - Serie A
194,Francesco Benussi,103,49,54,47.57281553398058,28,5,23,17.857142857142858,7,6,1,85.71428571428571,86,33,53,38.372093023255815,51.19040930127379,0,0,0,0.0,0,0,0,0,0,0,0,Carpi,4,Italy - Serie A
195,Francesco Lodi,1378,1049,329,76.12481857764877,291,193,98,66.32302405498281,765,694,71,90.71895424836602,282,127,155,45.0354609929078,21.48506057357556,33,6,27,18.181818181818183,33,1,12,8,6,3,14,Udinese,24,Italy - Serie A
196,Francesco Magnanelli,2381,1960,421,82.31835363292734,413,263,150,63.68038740920097,1440,1351,89,93.81944444444444,320,175,145,54.6875,20.288160966358234,5,1,4,20.0,29,1,16,12,1,1,96,Sassuolo,34,Italy - Serie A
197,Francesco Totti,307,229,78,74.5928338762215,56,34,22,60.71428571428571,180,158,22,87.77777777777777,50,30,20,60.0,19.286333875364953,8,2,6,25.0,10,3,8,4,6,3,13,AS Roma,13,Italy - Serie A
198,Franco Brienza,916,670,246,73.14410480349345,113,62,51,54.86725663716814,549,478,71,87.06739526411657,141,59,82,41.843971631205676,18.41192881038786,43,10,33,23.25581395348837,31,3,37,21,15,9,25,Bologna,29,Italy - Serie A
199,Franco Damián Vázquez,1555,1132,423,72.79742765273312,234,159,75,67.94871794871796,906,764,142,84.32671081677704,151,74,77,49.00662251655629,17.124238566993643,94,24,70,25.53191489361702,47,7,190,96,85,42,214,Palermo,36,Italy - Serie A
200,Franco Signorelli,15,13,2,86.66666666666667,2,1,1,50.0,8,7,1,87.5,0,0,0,0.0,14.63005697808,0,0,0,0.0,0,0,1,1,0,0,1,Empoli,1,Italy - Serie A
201,Franco Zuculini,16,14,2,87.5,2,1,1,50.0,13,12,1,92.3076923076923,0,0,0,0.0,15.8469026724,1,0,1,0.0,0,0,0,0,0,0,2,Bologna,1,Italy - Serie A
202,Fredy Alejandro Guarín Vásquez,494,355,139,71.86234817813765,90,53,37,58.88888888888889,302,263,39,87.08609271523179,60,23,37,38.333333333333336,18.728320262627367,23,2,21,8.695652173913043,13,1,33,22,11,7,10,Inter Milan,16,Italy - Serie A
203,Gabriel Alejandro Paletta,807,617,190,76.45600991325898,100,40,60,40.0,398,379,19,95.22613065326632,172,74,98,43.02325581395349,24.143241664650112,5,0,5,0.0,3,0,5,3,0,0,14,Atalanta,24,Italy - Serie A
204,Gabriel Moisés Antunes da Silva,939,623,316,66.3471778487753,122,54,68,44.26229508196721,392,333,59,84.94897959183673,142,44,98,30.985915492957744,18.127917442770094,54,13,41,24.074074074074073,9,2,30,20,10,4,49,Genoa,27,Italy - Serie A
205,Gabriel Vasconelos Ferreira,22,20,2,90.9090909090909,0,0,0,0.0,13,12,1,92.3076923076923,3,2,1,66.66666666666666,26.67556267065818,0,0,0,0.0,0,0,0,0,0,0,0,Napoli,1,Italy - Serie A
206,Gaetano Letizia,1587,1060,527,66.79269061121613,333,165,168,49.549549549549546,656,564,92,85.97560975609755,299,93,206,31.103678929765888,21.166003358134596,78,19,59,24.358974358974358,34,0,79,37,28,12,66,Carpi,35,Italy - Serie A
207,Gaetano Monachello,69,56,13,81.15942028985508,7,3,4,42.857142857142854,44,41,3,93.18181818181817,3,1,2,33.33333333333333,13.499518083349566,3,1,2,33.33333333333333,0,0,17,10,7,2,7,Atalanta,10,Italy - Serie A
208,Gary Alexis Medel Soto,1797,1590,207,88.48080133555926,194,127,67,65.4639175257732,1122,1087,35,96.88057040998217,163,90,73,55.21472392638037,19.798347525428834,8,1,7,12.5,12,1,12,7,1,0,26,Inter Milan,29,Italy - Serie A
209,Gastón Alexis Silva Perdomo,527,410,117,77.7988614800759,50,27,23,54.0,294,271,23,92.17687074829932,71,27,44,38.028169014084504,19.365819799668387,16,4,12,25.0,10,1,15,7,6,1,9,Torino,12,Italy - Serie A
210,Gastón Brugman,610,494,116,80.98360655737706,93,66,27,70.96774193548387,406,358,48,88.17733990147784,42,27,15,64.28571428571429,17.60605919596918,4,1,3,25.0,14,1,16,11,3,2,12,Palermo,14,Italy - Serie A
211,Gennaro Sardo,187,157,30,83.9572192513369,20,11,9,55.00000000000001,100,94,6,94.0,27,15,12,55.55555555555556,19.774077883561922,10,5,5,50.0,5,0,3,1,0,0,2,Chievo,6,Italy - Serie A
212,Geoffrey Kondogbia,1319,1156,163,87.64215314632298,147,103,44,70.06802721088435,1016,947,69,93.20866141732283,61,38,23,62.295081967213115,16.72338373526975,4,3,1,75.0,16,0,62,36,20,11,53,Inter Milan,25,Italy - Serie A
213,Germán Gustavo Denis,334,234,100,70.05988023952095,32,14,18,43.75,175,155,20,88.57142857142857,14,5,9,35.714285714285715,12.464176618383952,7,1,6,14.285714285714285,16,1,16,8,6,3,18,Atalanta,15,Italy - Serie A
214,Gervais Lombe Yao Kouassi,330,271,59,82.12121212121211,20,17,3,85.0,267,238,29,89.13857677902621,2,0,2,0.0,13.18573571894618,13,4,9,30.76923076923077,12,1,47,28,33,20,6,AS Roma,14,Italy - Serie A
215,Giacomo Bonaventura,1684,1250,434,74.22802850356295,171,93,78,54.385964912280706,1074,945,129,87.98882681564247,217,84,133,38.70967741935484,17.416081578009976,70,20,50,28.57142857142857,60,8,114,68,68,39,87,AC Milan,33,Italy - Serie A
216,Giampaolo Pazzini,370,238,132,64.32432432432432,40,19,21,47.5,196,166,30,84.6938775510204,22,9,13,40.909090909090914,14.221725392298161,9,0,9,0.0,11,0,19,10,14,7,61,Hellas Verona,30,Italy - Serie A
217,Giampiero Pinzi,488,403,85,82.58196721311475,62,40,22,64.51612903225806,329,304,25,92.40121580547113,49,25,24,51.02040816326531,17.57879229782213,3,2,1,66.66666666666666,5,0,6,2,3,2,14,Chievo,18,Italy - Serie A
218,Giancarlo González Castro,995,767,228,77.0854271356784,100,34,66,34.0,440,414,26,94.0909090909091,190,81,109,42.63157894736842,24.331407536183153,1,1,0,100.0,3,0,2,2,0,0,10,Palermo,35,Italy - Serie A
219,Gianluca Pegolo,62,39,23,62.903225806451616,6,1,5,16.666666666666664,7,7,0,100.0,42,21,21,50.0,42.5832343496129,0,0,0,0.0,0,0,0,0,0,0,0,Sassuolo,2,Italy - Serie A
220,Gianluigi Buffon,888,721,167,81.19369369369369,35,11,24,31.428571428571427,467,465,2,99.57173447537473,301,144,157,47.840531561461795,30.81958850719622,0,0,0,0.0,0,0,0,0,0,0,0,Juventus,35,Italy - Serie A
221,Gianluigi Donnarumma,908,632,276,69.60352422907489,71,16,55,22.535211267605636,386,383,3,99.22279792746113,400,137,263,34.25,35.744112482689424,0,0,0,0.0,0,0,0,0,0,0,6,AC Milan,30,Italy - Serie A
222,Gianpaolo Bellini,506,409,97,80.8300395256917,72,47,25,65.27777777777779,274,255,19,93.06569343065694,48,17,31,35.41666666666667,16.871648309301342,13,4,9,30.76923076923077,1,0,5,4,2,1,10,Atalanta,15,Italy - Serie A
223,Gilberto Moraes Junior,275,207,68,75.27272727272727,18,10,8,55.55555555555556,177,156,21,88.13559322033898,19,9,10,47.368421052631575,16.123786350409308,15,4,11,26.666666666666668,4,0,19,12,13,9,9,Hellas Verona,10,Italy - Serie A
224,Giorgio Chiellini,1411,1215,196,86.10914245216159,173,109,64,63.005780346820806,909,868,41,95.48954895489548,139,61,78,43.884892086330936,20.804001515785174,7,2,5,28.57142857142857,10,0,5,4,2,1,26,Juventus,24,Italy - Serie A
225,Giovanni Marchese,354,261,93,73.72881355932203,39,15,24,38.46153846153847,189,174,15,92.06349206349206,60,18,42,30.0,19.985885630194577,8,2,6,25.0,2,0,0,0,0,0,5,Genoa,11,Italy - Serie A
226,Giovanni Pasquale,124,89,35,71.7741935483871,23,17,6,73.91304347826086,52,45,7,86.53846153846155,17,5,12,29.411764705882355,19.356597841906453,10,3,7,30.0,2,0,3,1,0,0,0,Udinese,6,Italy - Serie A
227,Giulio Migliaccio,239,155,84,64.85355648535564,29,8,21,27.586206896551722,124,109,15,87.90322580645162,14,4,10,28.57142857142857,14.950302391599665,5,1,4,20.0,3,0,0,0,0,0,12,Atalanta,18,Italy - Serie A
228,Giuseppe Pezzella,288,192,96,66.66666666666666,47,25,22,53.191489361702125,124,110,14,88.70967741935483,52,13,39,25.0,18.182840231274998,19,6,13,31.57894736842105,4,0,14,10,4,2,9,Palermo,8,Italy - Serie A
229,Giuseppe Rossi,155,117,38,75.48387096774194,9,3,6,33.33333333333333,99,83,16,83.83838383838383,5,4,1,80.0,13.377967550598193,5,3,2,60.0,6,1,7,6,2,2,9,Fiorentina,11,Italy - Serie A
230,Giuseppe Vives,1438,1194,244,83.03198887343532,184,101,83,54.891304347826086,883,836,47,94.67723669309174,162,82,80,50.617283950617285,19.96628267880501,9,2,7,22.22222222222222,17,1,15,11,4,2,30,Torino,33,Italy - Serie A
231,Godfred Donsah,496,340,156,68.54838709677419,79,46,33,58.22784810126582,306,249,57,81.37254901960785,29,9,20,31.03448275862069,15.836292175746774,14,4,10,28.57142857142857,6,1,34,19,12,8,15,Bologna,20,Italy - Serie A
232,Gonzalo Gerardo Higuaín,943,721,222,76.45811240721103,84,49,35,58.333333333333336,648,554,94,85.49382716049382,66,40,26,60.60606060606061,15.592001099933318,22,7,15,31.818181818181817,47,2,65,39,41,21,38,Napoli,35,Italy - Serie A
233,Gonzalo Javier Rodríguez,2231,1931,300,86.55311519497984,178,72,106,40.44943820224719,1363,1312,51,96.2582538517975,245,104,141,42.44897959183673,22.90472237213992,1,0,1,0.0,7,0,25,14,2,0,33,Fiorentina,35,Italy - Serie A
234,Goran Pandev,273,201,72,73.62637362637363,24,16,8,66.66666666666666,196,165,31,84.18367346938776,14,11,3,78.57142857142857,15.09911389234813,6,0,6,0.0,15,0,21,13,14,8,36,Genoa,15,Italy - Serie A
235,Gregoire Defrel,583,475,108,81.47512864493997,29,18,11,62.06896551724138,444,400,44,90.09009009009009,13,2,11,15.384615384615385,12.172930913084171,11,2,9,18.181818181818183,22,4,46,21,29,14,48,Sassuolo,33,Italy - Serie A
236,Guglielmo Stendardo,407,331,76,81.32678132678133,33,11,22,33.33333333333333,266,258,8,96.99248120300751,47,17,30,36.17021276595745,20.003218733452776,1,0,1,0.0,1,0,3,3,0,0,18,Atalanta,15,Italy - Serie A
237,Guilherme dos Santos Torres,229,172,57,75.10917030567686,46,32,14,69.56521739130434,138,126,12,91.30434782608695,31,12,19,38.70967741935484,19.268950827408208,5,1,4,20.0,5,0,3,1,1,0,8,Udinese,5,Italy - Serie A
238,Iago Falqué Silva,603,487,116,80.76285240464345,58,38,20,65.51724137931035,408,382,26,93.62745098039215,73,29,44,39.726027397260275,17.62100953842746,36,10,26,27.77777777777778,17,2,15,9,10,4,10,AS Roma,22,Italy - Serie A
239,Ibrahima Mbaye,642,498,144,77.57009345794393,89,56,33,62.92134831460674,357,329,28,92.15686274509804,45,15,30,33.33333333333333,17.027949061925607,15,4,11,26.666666666666668,2,0,16,6,10,4,30,Bologna,15,Italy - Serie A
240,Ignazio Abate,1632,1254,378,76.83823529411765,275,165,110,60.0,831,761,70,91.57641395908543,225,79,146,35.11111111111111,19.356657183211325,50,15,35,30.0,18,1,38,21,19,11,18,AC Milan,27,Italy - Serie A
241,Igor Bubnjić,238,186,52,78.15126050420169,29,15,14,51.724137931034484,120,114,6,95.0,55,30,25,54.54545454545454,24.212649343540843,1,0,1,0.0,1,0,1,1,0,0,6,Carpi,9,Italy - Serie A
242,Ionuț Andrei Radu,6,3,3,50.0,0,0,0,0.0,2,2,0,100.0,3,0,3,0.0,44.22607644480001,0,0,0,0.0,0,0,0,0,0,0,0,Inter Milan,1,Italy - Serie A
243,Isaac Cofie,941,682,259,72.4760892667375,181,80,101,44.19889502762431,484,442,42,91.32231404958677,121,44,77,36.36363636363637,19.911519693105284,7,2,5,28.57142857142857,11,1,17,13,4,2,14,Carpi,29,Italy - Serie A
244,Issa Cissokho,421,343,78,81.47268408551069,51,35,16,68.62745098039215,278,247,31,88.84892086330936,26,14,12,53.84615384615385,16.64104768583943,23,7,16,30.434782608695656,7,1,6,4,0,0,8,Genoa,13,Italy - Serie A
245,Ivan Perišić,1255,902,353,71.87250996015936,112,66,46,58.92857142857143,764,649,115,84.9476439790576,85,31,54,36.470588235294116,15.69723111089957,95,17,78,17.894736842105264,21,6,61,32,38,22,18,Inter Milan,34,Italy - Serie A
246,Ivan Radovanović,1364,1085,279,79.54545454545455,184,96,88,52.17391304347826,783,730,53,93.23116219667943,170,80,90,47.05882352941176,20.07209798831349,9,3,6,33.33333333333333,8,0,14,10,4,1,32,Chievo,26,Italy - Serie A
247,Ivan Strinić,227,201,26,88.54625550660793,17,10,7,58.82352941176471,158,147,11,93.0379746835443,3,1,2,33.33333333333333,14.091152000989956,2,0,2,0.0,1,0,4,2,3,1,2,Napoli,5,Italy - Serie A
248,Ivaylo Chochev,854,649,205,75.99531615925058,100,61,39,61.0,521,477,44,91.55470249520154,48,11,37,22.916666666666664,15.085210955471663,16,5,11,31.25,10,2,13,8,4,3,19,Palermo,26,Italy - Serie A
249,Iván Rodrigo Piris Leguizamón,853,676,177,79.24970691676437,122,64,58,52.459016393442624,469,436,33,92.96375266524521,127,59,68,46.45669291338583,19.018581277388794,20,8,12,40.0,7,0,13,11,3,2,18,Udinese,27,Italy - Serie A
250,Jacopo Sala,867,615,252,70.93425605536332,106,56,50,52.83018867924528,478,404,74,84.51882845188284,102,34,68,33.33333333333333,17.86496005057661,65,18,47,27.692307692307693,17,1,38,15,23,11,23,Hellas Verona,23,Italy - Serie A
251,Jakub Błaszczykowski,464,362,102,78.01724137931035,29,18,11,62.06896551724138,328,293,35,89.32926829268293,31,8,23,25.806451612903224,14.54865831519207,17,2,15,11.76470588235294,10,1,12,4,6,3,15,Fiorentina,15,Italy - Serie A
252,Jasmin Kurtič,1069,786,283,73.5266604303087,117,66,51,56.41025641025641,690,594,96,86.08695652173914,96,37,59,38.54166666666667,16.119980523383575,55,13,42,23.636363636363637,14,0,33,24,15,10,39,Atalanta,32,Italy - Serie A
253,Jeison Fabián Murillo Cerón,1570,1360,210,86.62420382165605,123,66,57,53.65853658536586,1024,990,34,96.6796875,158,60,98,37.9746835443038,20.952667700161683,1,0,1,0.0,4,0,7,5,1,0,39,Inter Milan,34,Italy - Serie A
254,Jerry Uche Mbakogu,454,293,161,64.53744493392071,29,13,16,44.827586206896555,265,202,63,76.22641509433963,9,5,4,55.55555555555556,12.007224404624141,22,11,11,50.0,21,2,36,15,18,6,45,Carpi,24,Italy - Serie A
255,Jesús Joaquín Fernández Sáez de la Torre,691,485,206,70.18813314037627,81,45,36,55.55555555555556,418,365,53,87.32057416267942,108,31,77,28.703703703703702,17.506634307524283,50,7,43,14.000000000000002,33,1,48,30,34,23,34,Genoa,20,Italy - Serie A
256,Joan Verdú Fernández,160,147,13,91.875,10,7,3,70.0,124,120,4,96.7741935483871,6,3,3,50.0,15.3181524240225,1,0,1,0.0,4,0,1,1,0,0,5,Fiorentina,5,Italy - Serie A
257,Joel Chukwuma Obi,184,138,46,75.0,29,17,12,58.620689655172406,122,110,12,90.1639344262295,9,2,7,22.22222222222222,16.088041993159564,6,1,5,16.666666666666664,6,0,7,2,2,0,15,Torino,10,Italy - Serie A
258,Jonathan Ludovic Biabiany,372,280,92,75.26881720430107,22,16,6,72.72727272727273,227,207,20,91.18942731277532,28,13,15,46.42857142857143,15.940147675139999,39,11,28,28.205128205128204,16,1,46,27,17,11,17,Inter Milan,20,Italy - Serie A
259,Jonathan de Guzmán,37,18,19,48.64864864864865,2,0,2,0.0,13,9,4,69.23076923076923,7,1,6,14.285714285714285,18.19101297528,4,1,3,25.0,1,0,1,1,0,0,1,Carpi,5,Italy - Serie A
260,Jorge Luiz Frello Filho,3779,3327,452,88.03916379994708,492,365,127,74.1869918699187,2944,2826,118,95.99184782608695,302,119,183,39.40397350993378,15.55344994301376,32,7,25,21.875,63,4,31,18,6,3,64,Napoli,35,Italy - Serie A
261,Josef Alexander Martínez Mencia,154,122,32,79.22077922077922,13,6,7,46.15384615384615,90,82,8,91.11111111111111,11,7,4,63.63636363636363,16.415170024362077,1,0,1,0.0,13,1,10,7,8,5,16,Torino,20,Italy - Serie A
262,Joseph Alfred Duncan,1284,918,366,71.49532710280374,229,155,74,67.68558951965066,803,688,115,85.67870485678705,151,60,91,39.735099337748345,18.641736986105045,70,21,49,30.0,45,5,70,38,36,16,21,Sassuolo,33,Italy - Serie A
263,Josip Iličić,1078,830,248,76.99443413729128,124,78,46,62.903225806451616,733,643,90,87.72169167803547,133,58,75,43.609022556390975,17.26565541140638,38,9,29,23.684210526315788,41,5,63,37,34,21,50,Fiorentina,30,Italy - Serie A
264,Josip Posavec,39,22,17,56.41025641025641,3,0,3,0.0,6,6,0,100.0,29,13,16,44.827586206896555,44.30917806871384,0,0,0,0.0,0,0,0,0,0,0,0,Palermo,1,Italy - Serie A
265,José Manuel Reina Páez,1103,899,204,81.5049864007253,80,16,64,20.0,583,578,5,99.14236706689536,330,138,192,41.81818181818181,31.908052897944152,0,0,0,0.0,1,0,0,0,0,0,1,Napoli,37,Italy - Serie A
266,José Martín Cáceres Silva,300,279,21,93.0,13,12,1,92.3076923076923,222,219,3,98.64864864864865,13,5,8,38.46153846153847,17.1122886466776,5,2,3,40.0,2,0,1,1,1,1,3,Juventus,6,Italy - Serie A
267,José María Callejón Bueno,1446,1134,312,78.42323651452283,91,53,38,58.24175824175825,976,892,84,91.39344262295081,69,17,52,24.637681159420293,13.476745471527634,62,9,53,14.516129032258066,40,6,29,12,13,5,73,Napoli,38,Italy - Serie A
268,José Mauri,148,134,14,90.54054054054053,16,14,2,87.5,109,105,4,96.3302752293578,9,7,2,77.77777777777779,17.22570201174162,0,0,0,0.0,5,0,3,1,2,0,8,AC Milan,5,Italy - Serie A
269,José Rodolfo Pires Ribeiro,637,489,148,76.76609105180535,57,37,20,64.91228070175438,334,299,35,89.52095808383234,57,17,40,29.82456140350877,15.572986188794221,40,15,25,37.5,15,1,45,26,14,9,28,Sampdoria,17,Italy - Serie A
270,João Miranda de Souza Filho,1536,1268,268,82.55208333333334,159,61,98,38.36477987421384,907,879,28,96.91289966923925,231,76,155,32.900432900432904,22.687797158168436,4,2,2,50.0,2,3,15,12,1,1,41,Inter Milan,32,Italy - Serie A
271,Juan Camilo Zúñiga Mosquera,155,123,32,79.35483870967742,12,9,3,75.0,101,92,9,91.0891089108911,14,6,8,42.857142857142854,16.277763618144,5,3,2,60.0,2,1,9,4,4,1,13,Bologna,9,Italy - Serie A
272,Juan Guilherme Nunes Jesus,949,778,171,81.98103266596416,98,51,47,52.04081632653062,602,567,35,94.18604651162791,85,25,60,29.411764705882355,18.165956231608007,15,7,8,46.666666666666664,10,0,17,10,6,2,9,Inter Milan,19,Italy - Serie A
273,Juan Guillermo Cuadrado Bello,1072,885,187,82.55597014925374,70,46,24,65.71428571428571,717,644,73,89.8186889818689,90,54,36,60.0,16.444598410082683,54,22,32,40.74074074074074,39,4,99,64,65,42,95,Juventus,28,Italy - Serie A
274,Juan Ignacio Gómez Taleb,652,447,205,68.55828220858896,46,21,25,45.65217391304348,374,308,66,82.35294117647058,24,12,12,50.0,12.922601203400244,12,5,7,41.66666666666667,22,0,30,20,18,12,54,Hellas Verona,33,Italy - Serie A
275,Juan Manuel Iturbe Arévalo,99,68,31,68.68686868686868,7,4,3,57.14285714285714,58,46,12,79.3103448275862,4,2,2,50.0,15.450455220901818,2,0,2,0.0,6,0,16,8,7,3,17,AS Roma,12,Italy - Serie A
276,Juan Pablo Carrizo,45,31,14,68.88888888888889,0,0,0,0.0,20,20,0,100.0,23,9,14,39.130434782608695,36.35363220496,0,0,0,0.0,0,0,0,0,0,0,0,Inter Milan,2,Italy - Serie A
277,Jules Olivier Ntcham,535,433,102,80.93457943925235,88,62,26,70.45454545454545,377,341,36,90.45092838196287,44,24,20,54.54545454545454,18.825963284770992,13,3,10,23.076923076923077,18,0,22,16,9,7,8,Genoa,17,Italy - Serie A
278,Juraj Kucka,1074,795,279,74.02234636871509,149,83,66,55.70469798657718,667,579,88,86.80659670164917,75,31,44,41.333333333333336,16.97024790373542,27,6,21,22.22222222222222,28,2,79,40,43,20,53,AC Milan,30,Italy - Serie A
279,Jérémy Ménez,167,126,41,75.44910179640718,13,9,4,69.23076923076923,122,103,19,84.42622950819673,11,5,6,45.45454545454545,14.773726530172455,7,0,7,0.0,4,0,6,2,6,2,5,AC Milan,10,Italy - Serie A
280,Kalidou Koulibaly,2382,2068,314,86.81780016792612,189,71,118,37.56613756613756,1717,1659,58,96.62201514269074,191,54,137,28.272251308900525,18.37901181899456,3,1,2,33.33333333333333,9,0,16,12,1,1,21,Napoli,33,Italy - Serie A
281,Kamil Glik,1657,1461,196,88.17139408569705,82,36,46,43.90243902439025,1053,1024,29,97.24596391263059,179,94,85,52.513966480446925,22.557070688257475,1,0,1,0.0,3,0,6,4,1,0,50,Torino,33,Italy - Serie A
282,Kamil Wilczek,33,22,11,66.66666666666666,3,2,1,66.66666666666666,14,12,2,85.71428571428571,3,1,2,33.33333333333333,13.976848886018182,0,0,0,0.0,0,0,3,2,1,1,0,Carpi,3,Italy - Serie A
283,Karim Laribi,281,200,81,71.17437722419929,35,18,17,51.42857142857142,188,156,32,82.97872340425532,21,7,14,33.33333333333333,16.316694534421924,8,3,5,37.5,11,0,8,3,3,0,7,Sassuolo,11,Italy - Serie A
284,Keisuke Honda,981,751,230,76.55453618756371,70,48,22,68.57142857142857,664,588,76,88.55421686746988,83,32,51,38.55421686746988,15.238091527833982,49,14,35,28.57142857142857,37,3,55,32,34,19,37,AC Milan,30,Italy - Serie A
285,Keita Baldé Diao,670,501,169,74.77611940298507,24,16,8,66.66666666666666,446,387,59,86.7713004484305,50,19,31,38.0,14.600926273634865,80,22,58,27.500000000000004,38,1,85,44,55,30,48,Lazio,31,Italy - Serie A
286,Kevin Lasagna,376,232,144,61.702127659574465,49,21,28,42.857142857142854,180,138,42,76.66666666666667,23,4,19,17.391304347826086,14.79385668266234,20,4,16,20.0,20,1,26,10,18,7,18,Carpi,36,Italy - Serie A
287,Kevin Strootman,168,154,14,91.66666666666666,19,16,3,84.21052631578947,135,126,9,93.33333333333333,6,3,3,50.0,15.560048806542857,2,1,1,50.0,2,1,2,1,2,1,2,AS Roma,5,Italy - Serie A
288,Kevin-Prince Boateng,147,106,41,72.10884353741497,12,9,3,75.0,77,67,10,87.01298701298701,11,5,6,45.45454545454545,16.889499714269387,6,1,5,16.666666666666664,5,0,5,4,4,4,5,AC Milan,11,Italy - Serie A
289,Khouma El Hadji Babacar,175,126,49,72.0,18,9,9,50.0,115,95,20,82.6086956521739,3,0,3,0.0,12.300678364768457,4,1,3,25.0,5,1,11,5,9,4,19,Fiorentina,18,Italy - Serie A
290,Kingsley Coman,29,23,6,79.3103448275862,0,0,0,0.0,19,17,2,89.47368421052632,3,2,1,66.66666666666666,15.270718119219309,4,3,1,75.0,2,0,1,1,0,0,4,Juventus,1,Italy - Serie A
291,Konstantinos Manolas,1756,1524,232,86.78815489749431,136,73,63,53.67647058823529,1098,1077,21,98.08743169398907,147,59,88,40.136054421768705,19.24539952159025,2,0,2,0.0,3,1,6,4,2,1,35,AS Roma,37,Italy - Serie A
292,Kwadwo Asamoah,344,312,32,90.69767441860465,25,22,3,88.0,267,251,16,94.00749063670412,25,20,5,80.0,16.80487412692186,2,1,1,50.0,8,1,12,9,1,1,15,Juventus,11,Italy - Serie A
293,Kévin Constant,234,194,40,82.90598290598291,23,9,14,39.130434782608695,156,139,17,89.1025641025641,17,9,8,52.94117647058824,16.88254227244,5,2,3,40.0,4,0,5,2,3,2,1,Bologna,7,Italy - Serie A
294,Lazaros Christodoulopoulos,164,124,40,75.60975609756098,19,11,8,57.89473684210527,111,96,15,86.48648648648648,11,2,9,18.181818181818183,16.676637656588778,3,1,2,33.33333333333333,0,0,10,4,5,3,10,Sampdoria,10,Italy - Serie A
295,Leandro Castán da Silva,165,143,22,86.66666666666667,5,2,3,40.0,115,113,2,98.26086956521739,17,9,8,52.94117647058824,18.922719638679272,0,0,0,0.0,0,0,2,2,0,0,5,AS Roma,5,Italy - Serie A
296,Leandro Daniel Paredes,2087,1675,412,80.2587446094873,318,179,139,56.289308176100626,1419,1325,94,93.37561663143057,318,124,194,38.9937106918239,19.246623658253025,21,5,16,23.809523809523807,41,1,44,30,8,5,86,Empoli,33,Italy - Serie A
297,Leandro Greco,996,821,175,82.429718875502,130,89,41,68.46153846153847,620,577,43,93.06451612903226,98,53,45,54.08163265306123,19.01903710995036,20,2,18,10.0,20,0,36,19,10,8,45,Hellas Verona,26,Italy - Serie A
298,Leonardo Blanchard,916,635,281,69.32314410480349,236,99,137,41.94915254237288,327,310,17,94.80122324159022,276,113,163,40.94202898550724,27.420345969504364,4,1,3,25.0,5,0,8,7,1,1,18,Frosinone,28,Italy - Serie A
299,Leonardo Bonucci,2336,2022,314,86.5582191780822,251,126,125,50.199203187250994,1377,1335,42,96.94989106753813,310,158,152,50.967741935483865,23.346552351145004,3,0,3,0.0,13,1,20,15,4,2,31,Juventus,36,Italy - Serie A
300,Leonardo Pavoletti,450,317,133,70.44444444444444,47,16,31,34.04255319148936,241,212,29,87.96680497925311,20,9,11,45.0,13.3560524656928,2,1,1,50.0,18,3,13,7,8,5,38,Genoa,25,Italy - Serie A
301,Levan Mchedlidze,86,61,25,70.93023255813954,4,2,2,50.0,57,47,10,82.45614035087719,2,2,0,100.0,13.205302076386046,0,0,0,0.0,3,0,9,5,3,1,2,Empoli,13,Italy - Serie A
302,Lorenzo Ariaudo,303,262,41,86.46864686468648,16,8,8,50.0,195,191,4,97.94871794871794,33,15,18,45.45454545454545,19.123101675407526,0,0,0,0.0,0,0,0,0,0,0,9,Empoli,9,Italy - Serie A
303,Lorenzo Crisetig,194,156,38,80.41237113402062,22,11,11,50.0,143,126,17,88.11188811188812,12,4,8,33.33333333333333,17.220560245381854,1,0,1,0.0,2,0,6,4,0,0,9,Bologna,5,Italy - Serie A
304,Lorenzo De Silvestri,756,499,257,66.005291005291,96,43,53,44.79166666666667,309,278,31,89.96763754045307,107,24,83,22.429906542056074,17.30423891492381,45,11,34,24.444444444444443,11,2,9,7,5,4,20,Sampdoria,17,Italy - Serie A
305,Lorenzo Di Livio,8,8,0,100.0,1,1,0,100.0,7,7,0,100.0,0,0,0,0.0,12.05455777425,0,0,0,0.0,0,0,0,0,0,0,0,AS Roma,1,Italy - Serie A
306,Lorenzo Insigne,1718,1353,365,78.75436554132712,164,93,71,56.70731707317073,1240,1097,143,88.46774193548387,130,49,81,37.69230769230769,14.163277012314412,69,18,51,26.08695652173913,58,10,101,52,75,37,29,Napoli,37,Italy - Serie A
307,Lorenzo Lollo,700,489,211,69.85714285714286,130,64,66,49.23076923076923,389,334,55,85.8611825192802,64,21,43,32.8125,17.45195541135737,10,3,7,30.0,11,1,41,21,17,7,46,Carpi,27,Italy - Serie A
308,Lorenzo Pasciuti,844,511,333,60.54502369668246,142,61,81,42.95774647887324,301,252,49,83.72093023255815,205,64,141,31.21951219512195,20.866500690176302,61,17,44,27.86885245901639,25,3,23,14,11,6,16,Carpi,21,Italy - Serie A
309,Lorenzo Pellegrini,614,463,151,75.4071661237785,74,43,31,58.108108108108105,398,350,48,87.93969849246231,44,17,27,38.63636363636363,16.61465929864808,17,5,12,29.411764705882355,13,0,28,16,12,6,29,Sassuolo,19,Italy - Serie A
310,Lorenzo Tonelli,1353,1143,210,84.4789356984479,135,52,83,38.51851851851852,880,850,30,96.5909090909091,122,49,73,40.16393442622951,18.056906483509355,1,0,1,0.0,5,0,10,5,3,0,57,Empoli,26,Italy - Serie A
311,Luca Antei,169,136,33,80.4733727810651,13,6,7,46.15384615384615,102,97,5,95.09803921568627,21,6,15,28.57142857142857,19.91915448003181,0,0,0,0.0,0,1,0,0,0,0,5,Sassuolo,5,Italy - Serie A
312,Luca Antonelli,1555,1234,321,79.35691318327974,177,115,62,64.97175141242938,882,796,86,90.24943310657596,93,29,64,31.182795698924732,16.335189179787474,42,12,30,28.57142857142857,13,1,38,21,19,9,65,AC Milan,28,Italy - Serie A
313,Luca Bittante,381,303,78,79.52755905511812,37,20,17,54.054054054054056,221,194,27,87.78280542986425,32,12,20,37.5,16.26147837168,12,6,6,50.0,4,0,9,4,4,1,8,Empoli,16,Italy - Serie A
314,Luca Checchin,64,47,17,73.4375,5,0,5,0.0,38,35,3,92.10526315789474,7,2,5,28.57142857142857,19.6952887605375,0,0,0,0.0,0,0,0,0,0,0,1,Hellas Verona,4,Italy - Serie A
315,Luca Cigarini,1287,998,289,77.54467754467754,191,115,76,60.20942408376963,729,651,78,89.30041152263375,170,86,84,50.588235294117645,18.817281145982378,28,9,19,32.142857142857146,30,2,20,13,4,2,36,Atalanta,25,Italy - Serie A
316,Luca Lezzerini,50,32,18,64.0,2,0,2,0.0,20,20,0,100.0,25,7,18,28.000000000000004,35.839072092095996,0,0,0,0.0,0,0,1,1,0,0,0,Fiorentina,2,Italy - Serie A
317,Luca Marrone,845,656,189,77.63313609467455,131,62,69,47.32824427480916,473,434,39,91.75475687103594,123,54,69,43.90243902439025,20.484908554807383,12,5,7,41.66666666666667,21,3,21,16,6,5,25,Hellas Verona,21,Italy - Serie A
318,Luca Martinelli,48,40,8,83.33333333333334,4,1,3,25.0,24,24,0,100.0,8,4,4,50.0,23.963214137865,0,0,0,0.0,0,0,0,0,0,0,0,Empoli,1,Italy - Serie A
319,Luca Paganini,501,336,165,67.06586826347305,58,33,25,56.896551724137936,257,214,43,83.26848249027238,46,16,30,34.78260869565217,15.934800852322635,25,9,16,36.0,17,2,39,21,26,15,60,Frosinone,27,Italy - Serie A
320,Luca Rigoni,765,602,163,78.69281045751634,95,59,36,62.10526315789474,487,444,43,91.17043121149896,69,26,43,37.68115942028986,16.76665035540988,11,3,8,27.27272727272727,21,0,15,9,6,2,21,Palermo,28,Italy - Serie A
321,Luca Rizzo,549,397,152,72.31329690346084,62,43,19,69.35483870967742,380,317,63,83.42105263157895,25,10,15,40.0,14.743327171139672,27,8,19,29.629629629629626,12,2,44,19,20,9,24,Bologna,23,Italy - Serie A
322,Luca Rossettini,1310,983,327,75.0381679389313,189,80,109,42.32804232804233,635,603,32,94.96062992125984,236,72,164,30.508474576271187,21.94671491291267,14,3,11,21.428571428571427,6,1,2,0,1,0,20,Bologna,29,Italy - Serie A
323,Luca Siligardi,559,357,202,63.864042933810374,45,24,21,53.333333333333336,308,247,61,80.1948051948052,82,31,51,37.80487804878049,17.17563625781925,54,15,39,27.77777777777778,27,0,52,25,33,18,14,Hellas Verona,28,Italy - Serie A
324,Luca Toni,360,184,176,51.11111111111111,52,15,37,28.846153846153843,120,90,30,75.0,13,4,9,30.76923076923077,12.2389990305636,7,1,6,14.285714285714285,10,0,24,9,20,7,66,Hellas Verona,23,Italy - Serie A
325,Lucas Digne,2020,1564,456,77.42574257425743,160,96,64,60.0,1089,1016,73,93.29660238751147,199,61,138,30.65326633165829,15.443199940629388,102,25,77,24.509803921568626,24,2,40,22,20,11,32,AS Roma,33,Italy - Serie A
326,Lucas Nahuel Castro,1232,894,338,72.56493506493507,163,72,91,44.171779141104295,726,635,91,87.46556473829202,122,43,79,35.24590163934426,16.649759282461947,51,19,32,37.254901960784316,30,1,52,24,18,8,41,Chievo,34,Italy - Serie A
327,Lucas Rodrigo Biglia,1991,1692,299,84.98242089402311,254,183,71,72.04724409448819,1293,1232,61,95.28228924980665,243,119,124,48.971193415637856,19.511032745711482,24,6,18,25.0,49,3,21,19,2,2,58,Lazio,27,Italy - Serie A
328,Luigi Giorgi,18,17,1,94.44444444444444,1,1,0,100.0,16,16,0,100.0,1,1,0,100.0,12.93502055612,0,0,0,0.0,1,0,0,0,0,0,1,Atalanta,1,Italy - Serie A
329,Luis Fernando Muriel Fruto,512,363,149,70.8984375,60,32,28,53.333333333333336,331,269,62,81.2688821752266,20,13,7,65.0,14.354049764645156,17,5,12,29.411764705882355,21,5,94,45,64,31,41,Sampdoria,32,Italy - Serie A
330,Luiz Adriano de Souza da Silva,274,201,73,73.35766423357664,29,18,11,62.06896551724138,176,150,26,85.22727272727273,13,6,7,46.15384615384615,15.354086668588904,10,0,10,0.0,11,3,13,9,4,4,35,AC Milan,26,Italy - Serie A
331,M''Baye Babacar Niang,377,255,122,67.63925729442971,35,22,13,62.857142857142854,238,194,44,81.5126050420168,44,20,24,45.45454545454545,16.111021544989498,24,7,17,29.166666666666668,10,2,69,29,36,13,30,AC Milan,16,Italy - Serie A
332,Maicon Douglas Sisenando,840,680,160,80.95238095238095,86,49,37,56.97674418604651,515,471,44,91.45631067961165,71,27,44,38.028169014084504,16.14322577052514,35,11,24,31.428571428571427,9,2,15,13,8,7,11,AS Roma,15,Italy - Serie A
333,Manolo Gabbiadini,160,118,42,73.75,10,5,5,50.0,118,97,21,82.20338983050848,6,1,5,16.666666666666664,13.026928049342999,4,0,4,0.0,10,3,7,2,4,1,13,Napoli,23,Italy - Serie A
334,Manuel Locatelli,60,47,13,78.33333333333333,8,4,4,50.0,32,30,2,93.75,10,4,6,40.0,23.248010174447998,1,0,1,0.0,0,0,2,1,0,0,0,AC Milan,2,Italy - Serie A
335,Manuel Pasqual,759,589,170,77.60210803689066,66,36,30,54.54545454545454,442,412,30,93.21266968325791,104,23,81,22.115384615384613,18.187275049637314,51,13,38,25.49019607843137,21,2,5,2,0,0,18,Fiorentina,17,Italy - Serie A
336,Manuel Pucciarelli,1058,847,211,80.05671077504726,67,45,22,67.16417910447761,834,727,107,87.17026378896882,23,10,13,43.47826086956522,11.696565307468354,21,6,15,28.57142857142857,39,3,62,32,39,20,71,Empoli,38,Italy - Serie A
337,Manuel Rolando Iturra Urrutia,448,369,79,82.36607142857143,58,35,23,60.3448275862069,290,266,24,91.72413793103448,38,19,19,50.0,16.946378418058394,5,2,3,40.0,5,0,9,7,1,1,24,Udinese,17,Italy - Serie A
338,Marcel Büchel,886,713,173,80.47404063205418,93,51,42,54.83870967741935,620,560,60,90.32258064516128,71,27,44,38.028169014084504,15.705719277826184,14,3,11,21.428571428571427,19,1,29,18,11,7,23,Empoli,28,Italy - Serie A
339,Marcello Gazzola,222,177,45,79.72972972972973,22,12,10,54.54545454545454,102,93,9,91.17647058823529,23,11,12,47.82608695652174,17.230757449667028,9,3,6,33.33333333333333,0,1,3,2,0,0,2,Sassuolo,9,Italy - Serie A
340,Marcello Trotta,50,38,12,76.0,3,3,0,100.0,35,28,7,80.0,2,2,0,100.0,13.7679258005424,0,0,0,0.0,2,0,5,3,2,1,1,Sassuolo,8,Italy - Serie A
341,Marcelo Alejandro Estigarribia Balmori,17,10,7,58.82352941176471,0,0,0,0.0,8,6,2,75.0,1,0,1,0.0,13.867469967345883,1,0,1,0.0,0,0,1,0,0,0,4,Atalanta,4,Italy - Serie A
342,Marcelo Brozović,1841,1451,390,78.81586094513851,279,196,83,70.25089605734766,1105,988,117,89.41176470588236,230,103,127,44.78260869565218,19.162434545098023,56,20,36,35.714285714285715,48,4,77,40,32,22,37,Inter Milan,32,Italy - Serie A
343,Marco Antônio De Mattos Filho,218,162,56,74.31192660550458,32,13,19,40.625,130,116,14,89.23076923076924,22,8,14,36.36363636363637,16.307306329845137,3,0,3,0.0,6,0,11,10,4,4,7,Udinese,11,Italy - Serie A
344,Marco Benassi,661,475,186,71.86081694402421,66,38,28,57.57575757575758,369,314,55,85.09485094850947,53,26,27,49.056603773584904,16.847046069726826,30,10,20,33.33333333333333,20,2,27,15,16,9,20,Torino,32,Italy - Serie A
345,Marco Borriello,425,335,90,78.82352941176471,40,28,12,70.0,269,243,26,90.33457249070632,25,14,11,56.00000000000001,15.042448009251105,11,4,7,36.36363636363637,15,3,49,25,24,11,30,Atalanta,27,Italy - Serie A
346,Marco Crimi,364,238,126,65.38461538461539,60,31,29,51.66666666666667,187,158,29,84.49197860962568,43,21,22,48.837209302325576,16.83239891455187,7,3,4,42.857142857142854,8,1,31,12,15,7,37,Carpi,20,Italy - Serie A
347,Marco D''Alessandro,373,259,114,69.43699731903486,27,16,11,59.25925925925925,241,198,43,82.15767634854771,39,21,18,53.84615384615385,15.372745801497265,41,21,20,51.21951219512195,14,2,55,29,31,17,32,Atalanta,23,Italy - Serie A
348,Marco Parolo,1218,956,262,78.48932676518884,201,131,70,65.17412935323384,714,658,56,92.15686274509804,117,56,61,47.863247863247864,18.29823137692788,24,8,16,33.33333333333333,31,0,15,10,4,3,24,Lazio,31,Italy - Serie A
349,Marco Sportiello,1084,616,468,56.82656826568265,120,29,91,24.166666666666668,222,221,1,99.54954954954955,735,278,457,37.823129251700685,45.151088329489156,0,0,0,0.0,2,0,1,1,0,0,4,Atalanta,36,Italy - Serie A
350,Marco Zambelli,789,614,175,77.82002534854246,66,33,33,50.0,437,397,40,90.8466819221968,94,37,57,39.361702127659576,16.60257742849551,29,4,25,13.793103448275861,3,0,15,9,8,5,13,Empoli,19,Italy - Serie A
351,Marcos Alonso Mendoza,1704,1373,331,80.57511737089203,115,66,49,57.391304347826086,1006,932,74,92.6441351888668,156,62,94,39.743589743589745,17.979515553291126,93,32,61,34.40860215053764,37,4,57,32,26,14,34,Fiorentina,31,Italy - Serie A
352,Marek Hamšík,3094,2633,461,85.10019392372334,449,317,132,70.60133630289532,2277,2085,192,91.56785243741766,220,124,96,56.36363636363636,16.680352041355345,50,11,39,22.0,81,11,47,27,29,17,31,Napoli,38,Italy - Serie A
353,Mario Barwuah Balotelli,361,229,132,63.43490304709142,56,31,25,55.35714285714286,182,146,36,80.21978021978022,65,23,42,35.38461538461539,18.6040116304558,37,11,26,29.72972972972973,23,1,36,23,25,16,43,AC Milan,20,Italy - Serie A
354,Mario Lemina,462,409,53,88.52813852813853,57,43,14,75.43859649122807,329,309,20,93.9209726443769,28,14,14,50.0,19.199550114260262,2,0,2,0.0,5,0,10,9,2,2,9,Juventus,10,Italy - Serie A
355,Mario Mandžukić,562,395,167,70.2846975088968,41,27,14,65.85365853658537,307,258,49,84.03908794788273,22,8,14,36.36363636363637,13.5309772934763,24,7,17,29.166666666666668,23,4,19,11,11,6,35,Juventus,27,Italy - Serie A
356,Mario Suárez Mata,465,429,36,92.25806451612904,60,53,7,88.33333333333333,365,348,17,95.34246575342465,15,11,4,73.33333333333333,17.05288488241409,2,1,1,50.0,1,0,6,3,1,0,9,Fiorentina,9,Italy - Serie A
357,Marios Oikonomou,759,598,161,78.78787878787878,115,58,57,50.43478260869565,419,393,26,93.7947494033413,132,47,85,35.60606060606061,22.993623398732964,3,1,2,33.33333333333333,1,1,4,3,0,0,11,Bologna,20,Italy - Serie A
358,Marko Livaja,195,133,62,68.2051282051282,13,9,4,69.23076923076923,131,99,32,75.57251908396947,7,1,6,14.285714285714285,13.814240502996922,12,2,10,16.666666666666664,5,0,20,8,14,6,15,Empoli,18,Italy - Serie A
359,Marten de Roon,1669,1290,379,77.29179149191133,245,133,112,54.285714285714285,949,876,73,92.3076923076923,197,83,114,42.13197969543147,20.236671849228138,9,0,9,0.0,18,1,25,17,4,1,35,Atalanta,36,Italy - Serie A
360,Martín Montoya Torralbo,204,169,35,82.84313725490196,22,18,4,81.81818181818183,131,121,10,92.36641221374046,14,5,9,35.714285714285715,15.30876310008353,6,1,5,16.666666666666664,3,0,6,4,2,1,7,Inter Milan,3,Italy - Serie A
361,Massimiliano Carlini,135,91,44,67.4074074074074,15,11,4,73.33333333333333,72,65,7,90.27777777777779,8,2,6,25.0,14.450649413434666,11,1,10,9.090909090909092,11,0,10,4,5,1,8,Frosinone,14,Italy - Serie A
362,Massimo Gobbi,1689,1252,437,74.12670219064536,244,119,125,48.77049180327869,821,728,93,88.67235079171742,190,71,119,37.368421052631575,17.640878932003908,54,17,37,31.48148148148148,16,1,37,25,16,9,16,Chievo,34,Italy - Serie A
363,Massimo Maccarone,648,439,209,67.74691358024691,42,17,25,40.476190476190474,453,359,94,79.24944812362031,28,8,20,28.57142857142857,12.829183929253333,25,6,19,24.0,31,5,51,16,32,8,55,Empoli,37,Italy - Serie A
364,Massimo Zenildo Zappino,117,71,46,60.68376068376068,11,5,6,45.45454545454545,14,14,0,100.0,95,51,44,53.68421052631579,49.117031536553846,0,0,0,0.0,2,0,0,0,0,0,0,Frosinone,4,Italy - Serie A
365,Mato Jajalo,1077,860,217,79.85143918291551,149,90,59,60.40268456375839,661,601,60,90.92284417549168,98,38,60,38.775510204081634,18.044275985314762,6,1,5,16.666666666666664,18,0,18,13,6,3,31,Palermo,28,Italy - Serie A
366,Matteo Bianchetti,753,581,172,77.15803452855245,86,41,45,47.674418604651166,418,395,23,94.49760765550239,128,46,82,35.9375,20.8584007092349,8,2,6,25.0,4,0,4,2,0,0,16,Hellas Verona,23,Italy - Serie A
367,Matteo Brighi,608,499,109,82.07236842105263,81,58,23,71.60493827160494,425,393,32,92.47058823529412,20,9,11,45.0,14.515362109429343,6,0,6,0.0,9,0,14,7,6,2,35,Bologna,23,Italy - Serie A
368,Matteo Ciofani,539,377,162,69.9443413729128,81,41,40,50.617283950617285,203,179,24,88.17733990147784,100,39,61,39.0,19.79408314489425,18,5,13,27.77777777777778,1,1,15,7,5,1,6,Frosinone,18,Italy - Serie A
369,Matteo Fedele,226,167,59,73.89380530973452,32,18,14,56.25,122,111,11,90.98360655737704,46,21,25,45.65217391304348,22.6798863116623,10,4,6,40.0,8,0,8,4,2,0,4,Carpi,8,Italy - Serie A
370,Matteo Mancosu,191,120,71,62.82722513089005,19,6,13,31.57894736842105,103,80,23,77.66990291262135,3,1,2,33.33333333333333,13.467848746346387,9,3,6,33.33333333333333,10,0,11,6,6,3,17,Bologna,21,Italy - Serie A
371,Matteo Politano,445,318,127,71.46067415730337,46,27,19,58.69565217391305,298,246,52,82.5503355704698,43,13,30,30.23255813953488,15.798563099279999,22,5,17,22.727272727272727,16,2,51,19,31,10,20,Sassuolo,28,Italy - Serie A
372,Mattia Cassani,1130,894,236,79.11504424778761,141,79,62,56.02836879432624,626,575,51,91.85303514376997,133,41,92,30.82706766917293,19.65728174652255,27,6,21,22.22222222222222,7,1,16,10,5,3,20,Sampdoria,25,Italy - Serie A
373,Mattia De Sciglio,1172,880,292,75.0853242320819,120,73,47,60.83333333333333,572,514,58,89.86013986013987,136,54,82,39.705882352941174,18.150656489282458,56,18,38,32.142857142857146,17,1,13,7,4,3,16,AC Milan,22,Italy - Serie A
374,Mattia Destro,413,260,153,62.95399515738499,51,20,31,39.21568627450981,226,174,52,76.99115044247787,17,4,13,23.52941176470588,14.450078045955836,10,1,9,10.0,9,2,60,18,37,11,57,Bologna,27,Italy - Serie A
375,Mattia Perin,776,449,327,57.86082474226804,84,18,66,21.428571428571427,193,193,0,100.0,509,187,322,36.73870333988212,43.38250008455227,0,0,0,0.0,1,0,0,0,0,0,2,Genoa,25,Italy - Serie A
376,Mattia Zaccagni,19,12,7,63.1578947368421,2,0,2,0.0,13,11,2,84.61538461538461,0,0,0,0.0,14.457080239692633,0,0,0,0.0,0,0,0,0,0,0,2,Hellas Verona,3,Italy - Serie A
377,Matuzalém Francelino da Silva,176,147,29,83.52272727272727,33,21,12,63.63636363636363,113,109,4,96.46017699115043,22,10,12,45.45454545454545,20.39752721482773,1,0,1,0.0,1,0,2,2,1,1,4,Hellas Verona,7,Italy - Serie A
378,Matías Agustín Silvestre,1015,862,153,84.92610837438423,59,29,30,49.152542372881356,616,602,14,97.72727272727273,102,41,61,40.19607843137255,21.449549245047958,0,0,0,0.0,1,0,6,6,0,0,17,Sampdoria,25,Italy - Serie A
379,Matías Ariel Fernández Fernández,695,600,95,86.33093525179856,60,41,19,68.33333333333333,538,508,30,94.42379182156134,42,14,28,33.33333333333333,14.954298336718965,16,5,11,31.25,20,3,20,13,9,5,40,Fiorentina,22,Italy - Serie A
380,Matías Vecino Falero,1964,1722,242,87.67820773930754,220,154,66,70.0,1455,1376,79,94.57044673539518,93,53,40,56.98924731182796,16.65732108152786,6,0,6,0.0,25,1,38,27,16,10,34,Fiorentina,30,Italy - Serie A
381,Mauricio Aníbal Isla Isla,13,11,2,84.61538461538461,1,1,0,100.0,9,8,1,88.88888888888889,0,0,0,0.0,13.119953635384615,1,1,0,100.0,1,0,2,0,1,0,0,Juventus,1,Italy - Serie A
382,Mauricio Ricardo Pinilla Ferreira,351,232,119,66.0968660968661,46,21,25,45.65217391304348,152,128,24,84.21052631578947,20,10,10,50.0,15.182369863148717,18,8,10,44.44444444444444,15,2,21,8,12,5,33,Atalanta,20,Italy - Serie A
383,Maurizio Domizzi,157,122,35,77.70700636942675,23,7,16,30.434782608695656,88,87,1,98.86363636363636,24,7,17,29.166666666666668,21.619878015664206,0,0,0,0.0,2,0,0,0,0,0,1,Udinese,4,Italy - Serie A
384,Maurizio Pugliesi,28,17,11,60.71428571428571,2,0,2,0.0,11,11,0,100.0,16,5,11,31.25,41.282775963257144,0,0,0,0.0,0,0,0,0,0,0,1,Empoli,1,Italy - Serie A
385,Mauro Emanuel Icardi Rivero,558,397,161,71.14695340501792,43,19,24,44.18604651162791,332,275,57,82.83132530120481,23,10,13,43.47826086956522,14.03603896023871,24,13,11,54.166666666666664,27,4,17,7,11,5,43,Inter Milan,33,Italy - Serie A
386,Mauro Matías Zárate,265,208,57,78.49056603773586,22,17,5,77.27272727272727,202,176,26,87.12871287128714,12,3,9,25.0,14.02439455010717,8,2,6,25.0,10,0,36,20,29,17,17,Fiorentina,15,Italy - Serie A
387,Maurício dos Santos Nascimento,1024,836,188,81.640625,76,29,47,38.15789473684211,568,554,14,97.53521126760563,102,31,71,30.392156862745097,20.150197258331954,0,0,0,0.0,1,0,5,4,0,0,18,Lazio,24,Italy - Serie A
388,Maximiliano Gastón López,210,133,77,63.33333333333333,26,6,20,23.076923076923077,113,89,24,78.76106194690266,13,6,7,46.15384615384615,14.139973050132687,3,0,3,0.0,10,2,17,13,8,6,13,Torino,26,Italy - Serie A
389,Maximiliano Nicol Moralez,799,604,195,75.59449311639548,75,51,24,68.0,497,437,60,87.92756539235413,83,33,50,39.75903614457831,16.13619555903169,64,19,45,29.6875,37,4,29,14,15,6,42,Atalanta,17,Italy - Serie A
390,Michel Morganella,493,342,151,69.3711967545639,67,34,33,50.74626865671642,228,199,29,87.28070175438597,71,21,50,29.577464788732392,17.88080442565144,20,3,17,15.0,4,1,14,8,4,1,13,Palermo,14,Italy - Serie A
391,Michelangelo Albertazzi,334,237,97,70.95808383233533,69,35,34,50.72463768115942,123,106,17,86.1788617886179,62,28,34,45.16129032258064,20.02527586069006,14,6,8,42.857142857142854,3,0,4,3,2,2,3,Hellas Verona,10,Italy - Serie A
392,Michele Camporese,49,47,2,95.91836734693877,3,2,1,66.66666666666666,39,39,0,100.0,4,3,1,75.0,15.966445632994285,0,0,0,0.0,0,0,0,0,0,0,2,Empoli,2,Italy - Serie A
393,Michele Rocca,15,7,8,46.666666666666664,5,1,4,20.0,7,4,3,57.14285714285714,2,0,2,0.0,17.865849147072,0,0,0,0.0,0,0,0,0,0,0,0,Sampdoria,1,Italy - Serie A
394,Milan Badelj,1815,1567,248,86.33608815426997,275,197,78,71.63636363636363,1266,1189,77,93.91785150078988,151,87,64,57.615894039735096,17.867877015554182,6,1,5,16.666666666666664,32,1,35,23,11,6,24,Fiorentina,27,Italy - Serie A
395,Milan Biševac,450,385,65,85.55555555555556,49,30,19,61.224489795918366,279,271,8,97.1326164874552,57,27,30,47.368421052631575,20.8284794451168,0,0,0,0.0,2,0,3,3,0,0,6,Lazio,11,Italy - Serie A
396,Milan Škriniar,78,73,5,93.58974358974359,7,5,2,71.42857142857143,58,58,0,100.0,5,0,5,0.0,18.22875920798769,0,0,0,0.0,0,0,1,1,0,0,1,Sampdoria,3,Italy - Serie A
397,Miralem Pjanić,2395,1914,481,79.91649269311065,284,183,101,64.43661971830986,1526,1403,123,91.9397116644823,315,143,172,45.3968253968254,17.537733541774145,61,12,49,19.672131147540984,64,11,43,26,21,12,45,AS Roma,33,Italy - Serie A
398,Mirko Gori,973,705,268,72.4563206577595,158,75,83,47.46835443037975,516,467,49,90.50387596899225,155,53,102,34.193548387096776,19.711685937301787,27,6,21,22.22222222222222,12,0,27,16,7,3,55,Frosinone,28,Italy - Serie A
399,Mirko Valdifiori,464,384,80,82.75862068965517,92,58,34,63.04347826086957,299,287,12,95.9866220735786,71,31,40,43.66197183098591,19.156928858689653,4,2,2,50.0,12,0,4,2,1,0,7,Napoli,6,Italy - Serie A
400,Miroslav Klose,317,205,112,64.66876971608832,44,15,29,34.090909090909086,148,123,25,83.1081081081081,15,6,9,40.0,14.76008650178347,4,2,2,50.0,9,6,29,12,18,7,22,Lazio,24,Italy - Serie A
401,Modibo Diakité,726,550,176,75.75757575757575,85,24,61,28.235294117647058,383,362,21,94.51697127937337,109,28,81,25.688073394495415,21.913601836957785,4,0,4,0.0,4,0,11,10,3,2,19,Frosinone,26,Italy - Serie A
402,Mohamed Salah,1196,960,236,80.2675585284281,59,37,22,62.71186440677966,927,808,119,87.16289104638619,25,11,14,44.0,12.720607324481438,45,17,28,37.77777777777778,53,6,99,47,54,25,47,AS Roma,34,Italy - Serie A
403,Mohamed Salim Fares,281,200,81,71.17437722419929,28,12,16,42.857142857142854,110,98,12,89.0909090909091,50,18,32,36.0,19.059106107828043,18,9,9,50.0,6,1,9,8,4,3,1,Hellas Verona,11,Italy - Serie A
404,Molla Wagué,627,503,124,80.22328548644339,53,23,30,43.39622641509434,371,363,8,97.84366576819407,58,18,40,31.03448275862069,17.824023666420285,5,2,3,40.0,4,0,2,1,0,0,22,Udinese,21,Italy - Serie A
405,Morgan De Sanctis,79,59,20,74.68354430379746,2,1,1,50.0,41,41,0,100.0,32,12,20,37.5,32.25444629037266,0,0,0,0.0,0,0,0,0,0,0,0,AS Roma,4,Italy - Serie A
406,Mário Rui Silva Duarte,2368,1898,470,80.15202702702703,309,164,145,53.07443365695793,1350,1257,93,93.11111111111111,233,65,168,27.896995708154503,17.085333894271265,52,7,45,13.461538461538462,32,2,42,21,21,10,97,Empoli,36,Italy - Serie A
407,Nathaniel Chalobah,44,40,4,90.9090909090909,5,4,1,80.0,35,34,1,97.14285714285714,1,1,0,100.0,13.889966511927271,0,0,0,0.0,2,0,0,0,0,0,1,Napoli,5,Italy - Serie A
408,Nenad Krstičić,301,247,54,82.05980066445183,45,34,11,75.55555555555556,201,185,16,92.03980099502488,33,17,16,51.515151515151516,18.16673108662166,0,0,0,0.0,4,1,7,4,2,1,7,Sampdoria,10,Italy - Serie A
409,Nenad Tomović,1392,1203,189,86.42241379310344,153,91,62,59.47712418300654,970,942,28,97.11340206185567,104,38,66,36.53846153846153,17.388529962498104,10,2,8,20.0,9,0,10,5,3,0,17,Fiorentina,24,Italy - Serie A
410,Nicola Leali,981,536,445,54.638124362895,144,44,100,30.555555555555557,169,169,0,100.0,717,281,436,39.191073919107396,47.950049520788404,0,0,0,0.0,2,0,0,0,0,0,5,Frosinone,33,Italy - Serie A
411,Nicola Rigoni,989,792,197,80.0808897876643,151,99,52,65.56291390728477,608,554,54,91.11842105263158,76,30,46,39.473684210526315,17.536677173339694,5,0,5,0.0,7,1,17,8,6,2,16,Chievo,28,Italy - Serie A
412,Nicola Sansone,1026,752,274,73.2943469785575,92,48,44,52.17391304347826,741,625,116,84.34547908232119,77,14,63,18.181818181818183,15.18992848376421,45,10,35,22.22222222222222,43,4,98,47,69,36,68,Sassuolo,37,Italy - Serie A
413,Nicolas Sebastian Frey,756,552,204,73.01587301587301,134,68,66,50.74626865671642,328,311,17,94.8170731707317,131,44,87,33.587786259541986,20.806718322738096,15,4,11,26.666666666666668,4,0,1,1,1,1,8,Chievo,19,Italy - Serie A
414,Nicolás Andrés Burdisso,1080,880,200,81.48148148148148,91,30,61,32.967032967032964,497,477,20,95.97585513078471,170,87,83,51.17647058823529,24.292989989403335,1,0,1,0.0,2,0,2,2,0,0,15,Genoa,28,Italy - Serie A
415,Nicolás Federico Spolli,351,290,61,82.62108262108262,25,12,13,48.0,197,188,9,95.43147208121827,39,13,26,33.33333333333333,19.989590138947694,4,0,4,0.0,2,0,3,3,1,1,13,Chievo,14,Italy - Serie A
416,Nicolás Ignacio Castillo Mora,74,60,14,81.08108108108108,7,5,2,71.42857142857143,39,35,4,89.74358974358975,5,2,3,40.0,15.11812597496108,0,0,0,0.0,1,0,4,2,3,1,16,Frosinone,6,Italy - Serie A
417,Nicolò Cherubin,344,254,90,73.83720930232558,30,8,22,26.666666666666668,168,163,5,97.02380952380952,63,21,42,33.33333333333333,22.219492237832092,0,0,0,0.0,1,0,3,1,1,0,13,Atalanta,14,Italy - Serie A
418,Nigel de Jong,184,152,32,82.6086956521739,29,20,9,68.96551724137932,113,107,6,94.69026548672566,15,6,9,40.0,18.540183655663043,1,0,1,0.0,2,0,2,0,1,0,3,AC Milan,5,Italy - Serie A
419,Niklas Moisander,863,737,126,85.39976825028968,75,45,30,60.0,538,524,14,97.39776951672863,106,43,63,40.56603773584906,20.259647109846394,2,1,1,50.0,5,0,5,5,0,0,9,Sampdoria,22,Italy - Serie A
420,Nikola Kalinić,566,445,121,78.62190812720848,35,20,15,57.14285714285714,384,335,49,87.23958333333334,4,2,2,50.0,11.98314650542147,5,0,5,0.0,15,3,24,14,17,9,85,Fiorentina,36,Italy - Serie A
421,Nikola Maksimović,832,681,151,81.85096153846155,145,85,60,58.620689655172406,502,472,30,94.02390438247012,116,44,72,37.93103448275862,22.69156886709144,6,2,4,33.33333333333333,14,1,23,15,5,3,15,Torino,16,Italy - Serie A
422,Nikola Ninković,5,3,2,60.0,0,0,0,0.0,2,2,0,100.0,0,0,0,0.0,21.05726936112,1,0,1,0.0,0,0,1,0,0,0,0,Chievo,1,Italy - Serie A
423,Norbert Gyömbér,52,42,10,80.76923076923077,6,4,2,66.66666666666666,26,25,1,96.15384615384616,7,3,4,42.857142857142854,18.49953896302154,1,0,1,0.0,2,0,2,2,0,0,1,AS Roma,6,Italy - Serie A
424,Norbert Sándor Balogh,22,16,6,72.72727272727273,2,1,1,50.0,14,12,2,85.71428571428571,0,0,0,0.0,10.532564854887271,1,1,0,100.0,1,0,5,2,2,1,0,Palermo,4,Italy - Serie A
425,Norberto Murara Neto,49,47,2,95.91836734693877,0,0,0,0.0,26,26,0,100.0,9,7,2,77.77777777777779,27.078321034138778,0,0,0,0.0,0,0,0,0,0,0,0,Juventus,3,Italy - Serie A
426,Ogenyi Eddy Onazi,689,555,134,80.55152394775035,102,62,40,60.78431372549019,443,412,31,93.00225733634312,81,36,45,44.44444444444444,18.01657074514206,7,1,6,14.285714285714285,9,1,17,11,5,3,18,Lazio,15,Italy - Serie A
427,Oliver Kragl,293,175,118,59.72696245733788,52,24,28,46.15384615384615,126,104,22,82.53968253968253,52,16,36,30.76923076923077,19.15748047574662,27,7,20,25.925925925925924,11,0,20,8,15,6,23,Frosinone,15,Italy - Serie A
428,Omar El Kaddouri,171,146,25,85.38011695906432,23,18,5,78.26086956521739,129,116,13,89.92248062015504,6,3,3,50.0,13.620774481322105,5,3,2,60.0,7,2,9,4,4,2,9,Napoli,20,Italy - Serie A
429,Orestis Karnezis,1095,594,501,54.24657534246575,169,46,123,27.218934911242602,237,237,0,100.0,788,292,496,37.055837563451774,47.042389271904,0,0,0,0.0,0,0,0,0,0,0,5,Udinese,38,Italy - Serie A
430,Oscar Hiljemark,1311,968,343,73.83676582761251,108,70,38,64.81481481481481,777,694,83,89.31788931788932,151,52,99,34.437086092715234,16.832013907723937,57,14,43,24.561403508771928,36,5,34,19,19,11,17,Palermo,38,Italy - Serie A
431,Pablo Estífer Armero,176,121,55,68.75,27,16,11,59.25925925925925,69,60,9,86.95652173913044,28,8,20,28.57142857142857,18.64651678406182,11,4,7,36.36363636363637,2,0,4,2,0,0,6,Udinese,5,Italy - Serie A
432,Panagiotis Giorgios Kone,123,104,19,84.5528455284553,17,11,6,64.70588235294117,67,64,3,95.52238805970148,15,10,5,66.66666666666666,19.366267085239024,3,2,1,66.66666666666666,3,1,5,2,4,1,6,Udinese,6,Italy - Serie A
433,Panagiotis Tachtsidis,531,370,161,69.6798493408663,84,47,37,55.952380952380956,308,246,62,79.87012987012987,59,31,28,52.54237288135594,18.63487778792271,8,1,7,12.5,8,2,15,7,8,4,12,Genoa,24,Italy - Serie A
434,Paolo Cannavaro,1085,865,220,79.72350230414746,140,58,82,41.42857142857143,592,565,27,95.4391891891892,187,73,114,39.037433155080215,22.597457591588352,1,0,1,0.0,4,1,9,7,3,1,31,Sassuolo,31,Italy - Serie A
435,Paolo Sammarco,914,681,233,74.50765864332604,159,97,62,61.0062893081761,497,455,42,91.54929577464789,113,43,70,38.05309734513274,18.154761617193085,14,4,10,28.57142857142857,19,1,17,14,7,7,37,Frosinone,28,Italy - Serie A
436,Patrice Evra,1324,1093,231,82.55287009063444,119,76,43,63.86554621848739,819,759,60,92.67399267399267,73,25,48,34.24657534246575,15.426575487814077,46,10,36,21.73913043478261,24,3,20,7,9,3,16,Juventus,26,Italy - Serie A
437,Patricio Gabarrón Gil,454,372,82,81.93832599118943,34,16,18,47.05882352941176,256,234,22,91.40625,35,12,23,34.285714285714285,17.14707440139489,12,4,8,33.33333333333333,3,0,4,2,2,1,3,Lazio,9,Italy - Serie A
438,Paul Pogba,1786,1431,355,80.12318029115342,232,141,91,60.775862068965516,1179,1065,114,90.33078880407125,163,90,73,55.21472392638037,18.222500018420828,51,10,41,19.607843137254903,43,10,144,84,74,41,66,Juventus,35,Italy - Serie A
439,Paul-José M''Poku Ebunge,380,276,104,72.63157894736842,55,32,23,58.18181818181818,255,220,35,86.27450980392157,28,7,21,25.0,16.020950958528633,10,5,5,50.0,17,0,30,19,12,6,40,Chievo,20,Italy - Serie A
440,Paulo Bruno Exequiel Dybala,1230,927,303,75.36585365853658,128,97,31,75.78125,743,657,86,88.42530282637954,206,87,119,42.23300970873786,18.669196339521953,75,19,56,25.333333333333336,63,9,127,62,66,32,78,Juventus,34,Italy - Serie A
441,Paweł Wszołek,623,435,188,69.82343499197432,46,21,25,45.65217391304348,390,337,53,86.41025641025641,59,23,36,38.983050847457626,14.917840274270947,71,27,44,38.028169014084504,29,5,62,43,34,23,30,Hellas Verona,28,Italy - Serie A
442,Pedro Miguel Almeida Lopes Pereira,296,230,66,77.7027027027027,36,24,12,66.66666666666666,160,144,16,90.0,24,8,16,33.33333333333333,18.534316924763512,10,4,6,40.0,1,1,16,6,14,5,5,Sampdoria,9,Italy - Serie A
443,Perparim Hetemaj,1106,834,272,75.40687160940325,151,81,70,53.64238410596026,712,641,71,90.02808988764045,138,45,93,32.608695652173914,17.66691713018018,53,15,38,28.30188679245283,19,0,48,26,14,4,101,Chievo,28,Italy - Serie A
444,Philippe Mexès,227,192,35,84.58149779735683,41,25,16,60.97560975609756,128,125,3,97.65625,37,17,20,45.94594594594595,21.671734777847046,0,0,0,0.0,2,0,1,0,1,0,1,AC Milan,5,Italy - Serie A
445,Pierluigi Gollini,843,467,376,55.39739027283511,174,45,129,25.862068965517242,192,191,1,99.47916666666666,583,213,370,36.53516295025729,47.79646964050932,0,0,0,0.0,0,0,0,0,0,0,7,Hellas Verona,26,Italy - Serie A
446,Piotr Zieliński,1753,1407,346,80.2624073017684,220,142,78,64.54545454545455,1262,1125,137,89.14421553090332,134,60,74,44.776119402985074,15.311340073279405,32,13,19,40.625,48,4,122,74,53,29,35,Empoli,35,Italy - Serie A
447,Pontus Jansson,351,325,26,92.5925925925926,12,4,8,33.33333333333333,262,261,1,99.61832061068702,16,6,10,37.5,19.98919075455795,0,0,0,0.0,2,0,1,1,0,0,2,Torino,7,Italy - Serie A
448,Rade Krunić,168,128,40,76.19047619047619,11,6,5,54.54545454545454,115,96,19,83.47826086956522,5,3,2,60.0,12.332125577181428,1,1,0,100.0,6,0,12,5,7,2,26,Empoli,15,Italy - Serie A
449,Radja Nainggolan,1793,1505,288,83.93753485778026,254,185,69,72.83464566929135,1187,1100,87,92.67059814658803,162,103,59,63.580246913580254,18.429436526557012,27,10,17,37.03703703703704,41,1,40,24,14,7,57,AS Roma,35,Italy - Serie A
450,Rafael Márquez Álvarez,430,338,92,78.6046511627907,74,30,44,40.54054054054054,232,224,8,96.55172413793103,87,30,57,34.48275862068966,23.356628179042605,3,0,3,0.0,3,0,2,1,1,0,11,Hellas Verona,9,Italy - Serie A
451,Rafael Tolói,721,561,160,77.80859916782246,90,31,59,34.44444444444444,365,338,27,92.6027397260274,130,47,83,36.15384615384615,23.811746988598504,2,1,1,50.0,2,0,9,7,0,0,10,Atalanta,24,Italy - Serie A
452,Rafael de Andrade Bittencourt Pinheiro,313,189,124,60.383386581469644,13,1,12,7.6923076923076925,66,66,0,100.0,211,93,118,44.07582938388626,43.9104568485761,0,0,0,0.0,1,0,0,0,0,0,3,Hellas Verona,12,Italy - Serie A
453,Raffaele Bianco,859,647,212,75.32013969732246,126,65,61,51.587301587301596,466,420,46,90.12875536480686,112,52,60,46.42857142857143,19.488267446217275,16,5,11,31.25,14,2,30,16,15,8,32,Carpi,26,Italy - Serie A
454,Raffaele Maiello,378,309,69,81.74603174603175,70,42,28,60.0,261,237,24,90.80459770114942,39,18,21,46.15384615384615,17.493670621161904,2,1,1,50.0,7,0,4,2,2,2,25,Empoli,12,Italy - Serie A
455,Raphael Martinho Alves de Lima,233,156,77,66.95278969957081,38,19,19,50.0,125,108,17,86.4,33,4,29,12.121212121212121,18.981222069028327,7,1,6,14.285714285714285,4,0,20,9,9,6,4,Carpi,11,Italy - Serie A
456,Ravel Morrison,48,46,2,95.83333333333334,5,5,0,100.0,42,40,2,95.23809523809523,2,2,0,100.0,15.873915869580001,0,0,0,0.0,1,0,4,2,4,2,1,Lazio,4,Italy - Serie A
457,Raúl Albiol i Tortajada,2574,2281,293,88.61693861693861,213,119,94,55.86854460093896,1647,1623,24,98.54280510018215,231,125,106,54.112554112554115,19.286084821697344,2,1,1,50.0,4,1,5,5,0,0,22,Napoli,36,Italy - Serie A
458,Remo Freuler,159,125,34,78.61635220125787,16,8,8,50.0,110,99,11,90.0,9,5,4,55.55555555555556,13.828988700366791,6,4,2,66.66666666666666,2,0,3,1,0,0,5,Atalanta,6,Italy - Serie A
459,Rey Manaj,8,7,1,87.5,0,0,0,0.0,6,6,0,100.0,0,0,0,0.0,15.22997065125,0,0,0,0.0,1,0,0,0,0,0,3,Inter Milan,4,Italy - Serie A
460,Ricardo Gabriel Álvarez,415,329,86,79.27710843373494,52,36,16,69.23076923076923,279,254,25,91.0394265232975,61,23,38,37.704918032786885,18.269507866699954,24,8,16,33.33333333333333,14,1,44,28,29,18,23,Sampdoria,13,Italy - Serie A
461,Ricardo Kishna,254,153,101,60.23622047244095,35,12,23,34.285714285714285,125,98,27,78.4,51,14,37,27.450980392156865,18.55450086912,26,3,23,11.538461538461538,11,0,17,7,11,5,4,Lazio,11,Italy - Serie A
462,Riccardo Fiamozzi,220,173,47,78.63636363636364,27,19,8,70.37037037037037,116,101,15,87.06896551724138,21,8,13,38.095238095238095,16.83449037182291,8,3,5,37.5,4,0,4,1,2,0,4,Genoa,8,Italy - Serie A
463,Riccardo Gagliolo,1133,770,363,67.96116504854369,243,101,142,41.56378600823045,540,482,58,89.25925925925927,221,60,161,27.149321266968325,21.335825426136275,10,2,8,20.0,10,0,22,14,9,4,72,Carpi,31,Italy - Serie A
464,Riccardo Meggiorini,446,268,178,60.0896860986547,53,19,34,35.84905660377358,191,156,35,81.67539267015707,24,9,15,37.5,13.70472022329062,31,13,18,41.935483870967744,17,6,32,12,23,10,63,Chievo,26,Italy - Serie A
465,Riccardo Montolivo,1984,1607,377,80.99798387096774,336,190,146,56.547619047619044,1152,1087,65,94.35763888888889,297,144,153,48.484848484848484,21.309485394736814,10,2,8,20.0,18,1,31,20,9,6,45,AC Milan,31,Italy - Serie A
466,Riccardo Saponara,1202,875,327,72.79534109816971,176,109,67,61.93181818181818,855,699,156,81.75438596491227,77,37,40,48.05194805194805,15.08576949839441,30,7,23,23.333333333333332,62,10,120,63,57,26,81,Empoli,33,Italy - Serie A
467,Robert Acquafresca,51,37,14,72.54901960784314,3,0,3,0.0,35,28,7,80.0,1,1,0,100.0,10.34369316755294,1,0,1,0.0,1,0,6,4,3,2,2,Bologna,6,Italy - Serie A
468,Robert Gucher,612,426,186,69.6078431372549,149,73,76,48.99328859060403,280,258,22,92.14285714285714,156,55,101,35.256410256410255,22.46877618593647,12,1,11,8.333333333333332,21,0,20,13,8,3,23,Frosinone,24,Italy - Serie A
469,Roberto Crivello,628,473,155,75.31847133757962,81,44,37,54.32098765432099,252,220,32,87.3015873015873,89,30,59,33.70786516853933,19.196297281149935,13,6,7,46.15384615384615,11,1,13,6,7,3,15,Frosinone,17,Italy - Serie A
470,Roberto Gagliardini,36,28,8,77.77777777777779,4,2,2,50.0,27,25,2,92.5925925925926,0,0,0,0.0,14.338208336480001,1,0,1,0.0,0,0,0,0,0,0,0,Atalanta,1,Italy - Serie A
471,Roberto Inglese,307,207,100,67.42671009771986,28,14,14,50.0,159,136,23,85.53459119496856,12,7,5,58.333333333333336,13.259067610329382,10,2,8,20.0,11,1,23,14,11,6,40,Chievo,26,Italy - Serie A
472,Roberto Maximiliano Pereyra,442,390,52,88.23529411764706,34,28,6,82.35294117647058,317,298,19,94.00630914826499,18,14,4,77.77777777777779,15.917353223862625,16,5,11,31.25,26,1,21,8,16,5,22,Juventus,13,Italy - Serie A
473,Roberto Soriano,1354,1127,227,83.23485967503693,155,110,45,70.96774193548387,1040,923,117,88.75,34,20,14,58.82352941176471,14.472932883645376,17,6,11,35.294117647058826,23,4,59,32,27,15,52,Sampdoria,37,Italy - Serie A
474,Roberto Vitiello,301,247,54,82.05980066445183,29,13,16,44.827586206896555,163,151,12,92.63803680981594,38,21,17,55.26315789473685,19.488322861396146,2,0,2,0.0,1,0,0,0,0,0,4,Palermo,10,Italy - Serie A
475,Robin Quaison,563,400,163,71.04795737122558,61,29,32,47.540983606557376,338,290,48,85.79881656804734,58,19,39,32.758620689655174,16.87132093537816,36,11,25,30.555555555555557,21,2,44,29,36,23,24,Palermo,30,Italy - Serie A
476,Rodrigo Ely,60,43,17,71.66666666666667,10,3,7,30.0,32,27,5,84.375,12,4,8,33.33333333333333,22.452040292172,0,0,0,0.0,0,0,1,1,0,0,0,AC Milan,3,Italy - Serie A
477,Rodrigo Sebastián Aguirre Soto,68,41,27,60.29411764705882,5,3,2,60.0,44,36,8,81.81818181818183,7,2,5,28.57142857142857,15.76902018402,9,3,6,33.33333333333333,4,1,8,5,7,4,12,Udinese,10,Italy - Serie A
478,Rodrigo Sebastián Palacio,581,430,151,74.01032702237521,42,23,19,54.761904761904766,384,334,50,86.97916666666666,37,9,28,24.324324324324326,15.53591440534802,52,17,35,32.69230769230769,25,4,41,24,19,10,56,Inter Milan,27,Italy - Serie A
479,Ronaldo Pompeu da Silva,123,102,21,82.92682926829268,25,19,6,76.0,84,74,10,88.09523809523809,15,7,8,46.666666666666664,20.288363227996097,0,0,0,0.0,1,0,3,2,3,2,10,Empoli,3,Italy - Serie A
480,Ryder Matos Santos,499,375,124,75.1503006012024,35,19,16,54.285714285714285,372,321,51,86.29032258064517,17,3,14,17.647058823529413,12.77564573252056,28,9,19,32.142857142857146,23,2,37,24,29,17,45,Udinese,26,Italy - Serie A
481,Rômulo Souza Orestes Caldeira,162,127,35,78.39506172839506,8,4,4,50.0,110,101,9,91.81818181818183,12,5,7,41.66666666666667,14.552194502924443,7,2,5,28.57142857142857,5,1,7,3,2,1,4,Hellas Verona,9,Italy - Serie A
482,Salih Uçan,23,20,3,86.95652173913044,1,1,0,100.0,17,15,2,88.23529411764706,1,1,0,100.0,15.615407057822608,1,1,0,100.0,0,1,1,1,1,1,1,AS Roma,3,Italy - Serie A
483,Salvador Ichazo Fernández,98,59,39,60.204081632653065,1,1,0,100.0,32,31,1,96.875,47,12,35,25.53191489361702,36.601266728791835,0,0,0,0.0,0,0,0,0,0,0,0,Torino,3,Italy - Serie A
484,Sami Khedira,816,688,128,84.31372549019608,81,65,16,80.24691358024691,587,537,50,91.48211243611584,44,22,22,50.0,15.826381648769118,19,8,11,42.10526315789473,8,3,20,13,8,4,19,Juventus,20,Italy - Serie A
485,Samir Caetano de Souza Santos,85,66,19,77.64705882352942,10,0,10,0.0,50,49,1,98.0,13,1,12,7.6923076923076925,23.140346535004237,0,0,0,0.0,0,0,0,0,0,0,2,Hellas Verona,3,Italy - Serie A
486,Samir Handanovič,984,738,246,75.0,31,8,23,25.806451612903224,427,426,1,99.76580796252928,440,200,240,45.45454545454545,35.03727301296878,0,0,0,0.0,0,0,1,0,0,0,5,Inter Milan,36,Italy - Serie A
487,Samuel Souprayen,961,738,223,76.79500520291363,126,65,61,51.587301587301596,517,471,46,91.10251450676982,113,35,78,30.973451327433626,17.47107897096849,37,10,27,27.027027027027028,14,0,18,13,11,7,23,Hellas Verona,20,Italy - Serie A
488,Samuele Longo,58,36,22,62.06896551724138,10,5,5,50.0,33,25,8,75.75757575757575,3,1,2,33.33333333333333,13.454708667591724,2,0,2,0.0,3,1,6,4,4,3,3,Frosinone,18,Italy - Serie A
489,Sanjin Prcić,18,14,4,77.77777777777779,5,2,3,40.0,6,6,0,100.0,4,4,0,100.0,21.6192926516,0,0,0,0.0,2,0,1,1,0,0,0,Torino,2,Italy - Serie A
490,Santiago Juan Gentiletti Selak,1129,961,168,85.11957484499557,81,46,35,56.79012345679012,694,665,29,95.82132564841498,142,73,69,51.40845070422535,20.679604123223385,0,0,0,0.0,0,0,11,7,0,0,9,Lazio,19,Italy - Serie A
491,Saphir Sliti Taïder,1086,905,181,83.33333333333334,111,74,37,66.66666666666666,769,714,55,92.8478543563069,70,30,40,42.857142857142854,16.64645094331094,17,3,14,17.647058823529413,18,1,20,9,6,1,62,Bologna,29,Italy - Serie A
492,Sebastian De Maio,1098,878,220,79.96357012750455,129,64,65,49.6124031007752,652,623,29,95.5521472392638,128,41,87,32.03125,19.68898586518623,6,2,4,33.33333333333333,1,1,10,7,5,3,12,Genoa,28,Italy - Serie A
493,Segundo Víctor Ibarbo Guerrero,3,1,2,33.33333333333333,1,0,1,0.0,1,0,1,0.0,0,0,0,0.0,16.6172881776,0,0,0,0.0,0,0,0,0,0,0,1,AS Roma,2,Italy - Serie A
494,Senad Lulić,1546,1171,375,75.74385510996119,186,96,90,51.61290322580645,841,731,110,86.92033293697978,201,86,115,42.78606965174129,19.334423235685694,70,17,53,24.285714285714285,33,3,74,37,28,13,22,Lazio,30,Italy - Serie A
495,Serge Gakpé,218,153,65,70.18348623853211,25,15,10,60.0,142,115,27,80.98591549295774,15,5,10,33.33333333333333,14.63176724653321,11,6,5,54.54545454545454,10,1,25,9,19,7,11,Atalanta,18,Italy - Serie A
496,Sergej Milinković-Savić,826,574,252,69.49152542372882,111,50,61,45.04504504504504,480,406,74,84.58333333333333,62,22,40,35.483870967741936,15.616570989395942,31,7,24,22.58064516129032,19,0,47,23,31,12,41,Lazio,25,Italy - Serie A
497,Sergio Floccari,452,343,109,75.88495575221239,31,18,13,58.06451612903226,285,256,29,89.82456140350877,16,8,8,50.0,13.774380370414248,8,3,5,37.5,13,1,42,27,24,14,38,Bologna,25,Italy - Serie A
498,Sergio Pellissier,194,141,53,72.68041237113401,20,11,9,55.00000000000001,127,107,20,84.25196850393701,7,3,4,42.857142857142854,13.106784675039588,7,2,5,28.57142857142857,13,0,2,0,2,0,24,Chievo,19,Italy - Serie A
499,Seydou Kéita,800,690,110,86.25,133,88,45,66.16541353383458,536,513,23,95.7089552238806,55,21,34,38.18181818181819,17.955911762844302,1,0,1,0.0,5,0,8,6,3,2,30,AS Roma,20,Italy - Serie A
500,Silvan Widmer,905,589,316,65.0828729281768,99,56,43,56.56565656565656,374,310,64,82.88770053475936,125,46,79,36.8,18.194549705240224,71,15,56,21.12676056338028,15,2,37,18,29,14,30,Udinese,27,Italy - Serie A
501,Simone Colombi,46,22,24,47.82608695652174,4,1,3,25.0,11,11,0,100.0,32,8,24,25.0,45.42021430786957,0,0,0,0.0,0,0,0,0,0,0,0,Carpi,2,Italy - Serie A
502,Simone Edera,1,1,0,100.0,0,0,0,0.0,1,1,0,100.0,0,0,0,0.0,18.5136089976,0,0,0,0.0,0,0,0,0,0,0,2,Torino,2,Italy - Serie A
503,Simone Missiroli,992,743,249,74.8991935483871,152,82,70,53.94736842105263,565,506,59,89.5575221238938,79,30,49,37.9746835443038,16.90976381657153,10,3,7,30.0,16,0,27,13,2,1,48,Sassuolo,24,Italy - Serie A
504,Simone Padoin,292,254,38,86.98630136986301,25,21,4,84.0,194,185,9,95.36082474226805,19,11,8,57.89473684210527,16.53946669901096,9,4,5,44.44444444444444,5,0,2,1,1,0,10,Juventus,12,Italy - Serie A
505,Simone Pepe,509,357,152,70.13752455795678,53,32,21,60.37735849056604,261,230,31,88.12260536398468,84,28,56,33.33333333333333,18.620349459680156,30,9,21,30.0,19,3,13,4,6,3,13,Chievo,22,Italy - Serie A
506,Simone Romagnoli,781,547,234,70.03841229193341,91,30,61,32.967032967032964,329,308,21,93.61702127659575,129,41,88,31.782945736434108,21.057012166040664,2,1,1,50.0,2,0,1,1,0,0,2,Carpi,30,Italy - Serie A
507,Simone Verdi,107,67,40,62.616822429906534,19,7,12,36.84210526315789,46,35,11,76.08695652173914,27,14,13,51.85185185185185,23.02830700381009,7,2,5,28.57142857142857,5,0,16,10,10,4,8,Carpi,8,Italy - Serie A
508,Simone Zaza,171,129,42,75.43859649122807,10,5,5,50.0,113,94,19,83.1858407079646,4,2,2,50.0,14.06377248547579,3,1,2,33.33333333333333,6,0,20,8,16,5,11,Juventus,19,Italy - Serie A
509,Siniša Anđelković,591,462,129,78.1725888324873,47,20,27,42.5531914893617,300,285,15,95.0,61,17,44,27.86885245901639,19.711135430826396,1,0,1,0.0,2,1,2,1,1,0,21,Palermo,23,Italy - Serie A
510,Stefan de Vrij,113,98,15,86.72566371681415,8,6,2,75.0,70,69,1,98.57142857142858,12,7,5,58.333333333333336,21.74817995162124,0,0,0,0.0,0,0,1,1,0,0,1,Lazio,2,Italy - Serie A
511,Stefano Mauri,203,146,57,71.92118226600985,32,14,18,43.75,112,96,16,85.71428571428571,22,6,16,27.27272727272727,16.397625351731232,6,1,5,16.666666666666664,4,1,5,2,2,1,14,Lazio,12,Italy - Serie A
512,Stefano Sabelli,211,116,95,54.976303317535546,45,21,24,46.666666666666664,65,48,17,73.84615384615385,38,11,27,28.947368421052634,20.953240070498957,13,1,12,7.6923076923076925,5,0,2,0,1,0,9,Carpi,7,Italy - Serie A
513,Stefano Sorrentino,1068,603,465,56.46067415730337,107,22,85,20.5607476635514,208,206,2,99.03846153846155,771,315,456,40.856031128404666,43.97120710850966,0,0,0,0.0,1,0,1,1,0,0,2,Palermo,35,Italy - Serie A
514,Stefano Sturaro,502,373,129,74.30278884462152,45,27,18,60.0,333,290,43,87.08708708708708,37,10,27,27.027027027027028,16.789611019334345,18,5,13,27.77777777777778,12,0,15,6,8,4,25,Juventus,19,Italy - Serie A
515,Stephan El Shaarawy,536,426,110,79.47761194029852,43,29,14,67.44186046511628,382,344,38,90.0523560209424,23,10,13,43.47826086956522,13.29246607860806,13,3,10,23.076923076923077,11,2,31,14,20,10,11,AS Roma,16,Italy - Serie A
516,Stephan Lichtsteiner,1067,806,261,75.53889409559513,132,78,54,59.09090909090909,538,472,66,87.73234200743495,106,37,69,34.90566037735849,16.787853230478277,43,11,32,25.581395348837212,17,1,22,9,14,7,22,Juventus,26,Italy - Serie A
517,Stevan Jovetić,892,640,252,71.74887892376681,91,56,35,61.53846153846154,538,449,89,83.45724907063197,54,23,31,42.592592592592595,14.041940550827086,30,3,27,10.0,30,2,64,31,49,23,58,Inter Milan,26,Italy - Serie A
518,Stipe Perica,91,61,30,67.03296703296702,9,3,6,33.33333333333333,55,48,7,87.27272727272727,0,0,0,0.0,11.150032507840878,0,0,0,0.0,3,0,20,10,17,8,11,Udinese,11,Italy - Serie A
519,Thiago Rangel Cionek,144,117,27,81.25,16,6,10,37.5,69,68,1,98.55072463768117,27,11,16,40.74074074074074,20.642006458475,0,0,0,0.0,0,0,2,2,0,0,8,Palermo,5,Italy - Serie A
520,Thomas Heurtaux,389,304,85,78.1491002570694,57,28,29,49.122807017543856,242,235,7,97.10743801652893,60,15,45,25.0,20.16140985963393,2,0,2,0.0,1,0,5,2,0,0,14,Udinese,15,Italy - Serie A
521,Tim Matavž,105,63,42,60.0,17,4,13,23.52941176470588,50,40,10,80.0,6,1,5,16.666666666666664,13.57169144896457,2,1,1,50.0,4,0,3,3,1,1,4,Genoa,7,Italy - Serie A
522,Tomás Eduardo Rincón Hernández,1712,1453,259,84.8714953271028,219,161,58,73.51598173515981,1225,1142,83,93.22448979591836,117,66,51,56.41025641025641,17.614496398892467,27,14,13,51.85185185185185,32,6,72,50,25,20,63,Genoa,33,Italy - Serie A
523,Umar Sadiq Mesbah,46,31,15,67.3913043478261,5,0,5,0.0,30,26,4,86.66666666666667,2,0,2,0.0,12.809655901768696,1,0,1,0.0,1,0,3,2,2,1,8,AS Roma,6,Italy - Serie A
524,Urby Emanuelson,366,293,73,80.05464480874316,39,27,12,69.23076923076923,225,209,16,92.88888888888889,44,19,25,43.18181818181818,18.41751130682754,18,4,14,22.22222222222222,10,1,15,3,9,1,14,Hellas Verona,11,Italy - Serie A
525,Uroš Ćosić,560,464,96,82.85714285714286,55,26,29,47.27272727272727,368,358,10,97.28260869565217,73,30,43,41.0958904109589,19.85867257157357,0,0,0,0.0,2,0,1,1,0,0,7,Empoli,9,Italy - Serie A
526,Uroš Đurđević,87,66,21,75.86206896551724,4,2,2,50.0,58,48,10,82.75862068965517,3,2,1,66.66666666666666,11.850292695012413,2,0,2,0.0,3,1,9,4,4,1,6,Palermo,14,Italy - Serie A
527,Valter Birsa,1082,719,363,66.45101663585952,149,93,56,62.41610738255034,591,499,92,84.4331641285956,184,61,123,33.15217391304348,18.25059342994403,65,20,45,30.76923076923077,52,7,84,49,44,24,38,Chievo,35,Italy - Serie A
528,Vangelis Moras,1176,956,220,81.29251700680273,135,73,62,54.074074074074076,644,611,33,94.87577639751554,150,58,92,38.666666666666664,21.164294609635103,4,1,3,25.0,5,1,9,8,1,1,35,Hellas Verona,31,Italy - Serie A
529,Vasco Regini,609,502,107,82.43021346469622,51,34,17,66.66666666666666,402,371,31,92.28855721393035,27,11,16,40.74074074074074,15.694732680786208,4,0,4,0.0,1,0,12,5,5,1,15,Sampdoria,15,Italy - Serie A
530,Vassilis Torosidis,370,303,67,81.89189189189189,32,18,14,56.25,197,188,9,95.43147208121827,29,10,19,34.48275862068966,16.86956379760411,7,3,4,42.857142857142854,4,0,4,2,2,1,13,AS Roma,11,Italy - Serie A
531,Vasyl Pryyma,99,72,27,72.72727272727273,12,5,7,41.66666666666667,43,40,3,93.02325581395348,17,7,10,41.17647058823529,20.69291140509818,0,0,0,0.0,0,0,1,1,0,0,7,Frosinone,5,Italy - Serie A
532,Vid Belec,853,360,493,42.20398593200469,151,25,126,16.55629139072848,120,119,1,99.16666666666667,673,183,490,27.191679049034175,48.37508920851573,0,0,0,0.0,0,0,1,1,0,0,5,Carpi,30,Italy - Serie A
533,Vincent Laurini,1132,951,181,84.01060070671377,117,73,44,62.39316239316239,625,583,42,93.28,87,32,55,36.7816091954023,16.07180237185866,11,1,10,9.090909090909092,5,0,16,9,10,6,32,Empoli,25,Italy - Serie A
534,Vlad Iulian Chiricheș,501,465,36,92.81437125748504,25,13,12,52.0,370,361,9,97.56756756756756,25,12,13,48.0,17.3817123775703,0,0,0,0.0,0,0,5,3,0,0,3,Napoli,8,Italy - Serie A
535,Wallace Oliveira dos Santos,85,62,23,72.94117647058823,14,11,3,78.57142857142857,44,36,8,81.81818181818183,15,6,9,40.0,19.855274510710586,3,1,2,33.33333333333333,3,1,9,7,5,4,3,Carpi,6,Italy - Serie A
536,Wesley Hoedt,1080,901,179,83.42592592592592,123,57,66,46.34146341463415,547,536,11,97.9890310786106,189,87,102,46.03174603174603,24.774817633992665,1,0,1,0.0,0,0,9,7,2,1,11,Lazio,25,Italy - Serie A
537,William Vainqueur,386,358,28,92.74611398963731,29,20,9,68.96551724137932,274,266,8,97.08029197080292,17,10,7,58.82352941176471,17.373380658655336,2,1,1,50.0,3,2,14,11,4,2,5,AS Roma,16,Italy - Serie A
538,Wojciech Szczęsny,1242,892,350,71.81964573268921,68,14,54,20.588235294117645,516,512,4,99.2248062015504,541,207,334,38.262476894639555,35.590689233346666,0,0,0,0.0,1,0,2,2,0,0,2,AS Roma,34,Italy - Serie A
539,Yussif Raman Chibsah,436,332,104,76.14678899082568,79,40,39,50.63291139240506,290,253,37,87.24137931034483,30,8,22,26.666666666666668,17.792645188025723,3,0,3,0.0,13,2,29,16,10,4,27,Frosinone,22,Italy - Serie A
540,Yuto Nagatomo,1044,823,221,78.83141762452107,89,60,29,67.41573033707866,585,546,39,93.33333333333333,105,32,73,30.476190476190478,15.7631903684,57,11,46,19.298245614035086,12,0,20,8,9,2,21,Inter Milan,22,Italy - Serie A
541,Zdravko Kuzmanović,578,475,103,82.17993079584775,84,60,24,71.42857142857143,362,340,22,93.92265193370166,68,39,29,57.35294117647059,19.35591278393149,9,2,7,22.22222222222222,8,0,11,6,1,0,12,Udinese,16,Italy - Serie A
542,Álvaro Borja Morata Martín,518,388,130,74.9034749034749,19,13,6,68.42105263157895,341,294,47,86.21700879765396,22,13,9,59.09090909090909,14.029390764810486,24,7,17,29.166666666666668,20,6,57,23,32,15,60,Juventus,34,Italy - Serie A
543,Édgar Osvaldo Barreto Cáceres,1025,843,182,82.24390243902438,147,82,65,55.78231292517006,668,621,47,92.96407185628742,99,42,57,42.42424242424242,17.687121397535766,11,3,8,27.27272727272727,12,1,10,4,3,1,26,Sampdoria,30,Italy - Serie A
544,Łukasz Skorupski,886,651,235,73.47629796839729,27,5,22,18.51851851851852,400,399,1,99.75,318,94,224,29.559748427672954,33.35531054961779,0,0,0,0.0,0,0,0,0,0,0,7,Empoli,31,Italy - Serie A
545,Ştefan Daniel Radu,761,627,134,82.3915900131406,119,84,35,70.58823529411765,460,434,26,94.34782608695652,58,24,34,41.37931034482759,17.40386810039653,18,5,13,27.77777777777778,14,1,16,11,7,3,12,Lazio,13,Italy - Serie A
546,Šime Vrsaljko,2055,1525,530,74.20924574209245,208,128,80,61.53846153846154,956,876,80,91.63179916317992,253,78,175,30.8300395256917,17.582792910514335,162,47,115,29.01234567901235,35,3,38,24,19,13,56,Sassuolo,35,Italy - Serie A
547,Željko Brkić,87,45,42,51.724137931034484,6,1,5,16.666666666666664,25,25,0,100.0,59,17,42,28.8135593220339,42.927690518896554,0,0,0,0.0,0,0,0,0,0,0,1,Carpi,4,Italy - Serie A
